Cat_Namee,Can_Name,Name,C_Votes,ab_c_votes,ab_p_votes,ab_emer_votes1,rtot,Textbox5,Textbox7,Textbox11,ab_emer_votes,Textbox13
AUDITOR  EAST HANOVER,Carol  SOWERS,East Hanover Township--1st Precinct,331,9,0,0,340,710,13,0,0,723
AUDITOR  EAST HANOVER,Carol  SOWERS,East Hanover Township--2nd Precinct,379,4,0,0,383,710,13,0,0,723
AUDITOR  EAST HANOVER,Write In  ,East Hanover Township--1st Precinct,1,0,0,0,1,3,0,0,0,3
AUDITOR  EAST HANOVER,Write In  ,East Hanover Township--2nd Precinct,2,0,0,0,2,3,0,0,0,3
AUDITOR  LONDONDERRY,Ralph  HECK,Londonderry Twp--1st Precinct,254,0,0,0,254,596,4,0,0,600
AUDITOR  LONDONDERRY,Ralph  HECK,Londonderry Twp--2nd Precinct,233,3,0,0,236,596,4,0,0,600
AUDITOR  LONDONDERRY,Ralph  HECK,Londonderry Twp--3rd Precinct,109,1,0,0,110,596,4,0,0,600
AUDITOR  LONDONDERRY,Write In  ,Londonderry Twp--1st Precinct,0,0,0,0,0,1,0,0,0,1
AUDITOR  LONDONDERRY,Write In  ,Londonderry Twp--2nd Precinct,1,0,0,0,1,1,0,0,0,1
AUDITOR  LONDONDERRY,Write In  ,Londonderry Twp--3rd Precinct,0,0,0,0,0,1,0,0,0,1
AUDITOR 2YR DERRY,Joseph A. MIERSKI,Derry Township--1st Precinct,149,1,0,0,150,1430,32,0,0,1462
AUDITOR 2YR DERRY,Joseph A. MIERSKI,Derry Township--2nd Precinct,104,4,0,0,108,1430,32,0,0,1462
AUDITOR 2YR DERRY,Joseph A. MIERSKI,Derry Township--3rd Precinct,118,3,0,0,121,1430,32,0,0,1462
AUDITOR 2YR DERRY,Joseph A. MIERSKI,Derry Township--4th Precinct,71,1,0,0,72,1430,32,0,0,1462
AUDITOR 2YR DERRY,Joseph A. MIERSKI,Derry Township--5th Precinct,54,0,0,0,54,1430,32,0,0,1462
AUDITOR 2YR DERRY,Joseph A. MIERSKI,Derry Township--6th Precinct,67,1,0,0,68,1430,32,0,0,1462
AUDITOR 2YR DERRY,Joseph A. MIERSKI,Derry Township--7th Precinct,115,6,0,0,121,1430,32,0,0,1462
AUDITOR 2YR DERRY,Joseph A. MIERSKI,Derry Township--8th Precinct,76,0,0,0,76,1430,32,0,0,1462
AUDITOR 2YR DERRY,Joseph A. MIERSKI,Derry Township--9th Precinct,55,2,0,0,57,1430,32,0,0,1462
AUDITOR 2YR DERRY,Joseph A. MIERSKI,Derry Township--10th Precinct,86,2,0,0,88,1430,32,0,0,1462
AUDITOR 2YR DERRY,Joseph A. MIERSKI,Derry Township--11th Precinct,140,2,0,0,142,1430,32,0,0,1462
AUDITOR 2YR DERRY,Joseph A. MIERSKI,Derry Township--12th Precinct,77,2,0,0,79,1430,32,0,0,1462
AUDITOR 2YR DERRY,Joseph A. MIERSKI,Derry Township--13th Precinct,101,1,0,0,102,1430,32,0,0,1462
AUDITOR 2YR DERRY,Joseph A. MIERSKI,Derry Township--14th Precinct,78,3,0,0,81,1430,32,0,0,1462
AUDITOR 2YR DERRY,Joseph A. MIERSKI,Derry Township--15th Precinct,139,4,0,0,143,1430,32,0,0,1462
AUDITOR 2YR DERRY,Matthew P. DAVIES,Derry Township--1st Precinct,245,4,0,0,249,2528,55,2,0,2585
AUDITOR 2YR DERRY,Matthew P. DAVIES,Derry Township--2nd Precinct,180,3,0,0,183,2528,55,2,0,2585
AUDITOR 2YR DERRY,Matthew P. DAVIES,Derry Township--3rd Precinct,143,2,0,0,145,2528,55,2,0,2585
AUDITOR 2YR DERRY,Matthew P. DAVIES,Derry Township--4th Precinct,131,5,0,0,136,2528,55,2,0,2585
AUDITOR 2YR DERRY,Matthew P. DAVIES,Derry Township--5th Precinct,107,3,0,0,110,2528,55,2,0,2585
AUDITOR 2YR DERRY,Matthew P. DAVIES,Derry Township--6th Precinct,126,1,1,0,128,2528,55,2,0,2585
AUDITOR 2YR DERRY,Matthew P. DAVIES,Derry Township--7th Precinct,291,11,0,0,302,2528,55,2,0,2585
AUDITOR 2YR DERRY,Matthew P. DAVIES,Derry Township--8th Precinct,121,0,0,0,121,2528,55,2,0,2585
AUDITOR 2YR DERRY,Matthew P. DAVIES,Derry Township--9th Precinct,83,3,0,0,86,2528,55,2,0,2585
AUDITOR 2YR DERRY,Matthew P. DAVIES,Derry Township--10th Precinct,187,2,0,0,189,2528,55,2,0,2585
AUDITOR 2YR DERRY,Matthew P. DAVIES,Derry Township--11th Precinct,234,7,0,0,241,2528,55,2,0,2585
AUDITOR 2YR DERRY,Matthew P. DAVIES,Derry Township--12th Precinct,140,1,0,0,141,2528,55,2,0,2585
AUDITOR 2YR DERRY,Matthew P. DAVIES,Derry Township--13th Precinct,186,7,0,0,193,2528,55,2,0,2585
AUDITOR 2YR DERRY,Matthew P. DAVIES,Derry Township--14th Precinct,116,3,0,0,119,2528,55,2,0,2585
AUDITOR 2YR DERRY,Matthew P. DAVIES,Derry Township--15th Precinct,238,3,1,0,242,2528,55,2,0,2585
AUDITOR 2YR DERRY,Write In  ,Derry Township--1st Precinct,0,0,0,0,0,0,0,0,0,0
AUDITOR 2YR DERRY,Write In  ,Derry Township--2nd Precinct,0,0,0,0,0,0,0,0,0,0
AUDITOR 2YR DERRY,Write In  ,Derry Township--3rd Precinct,0,0,0,0,0,0,0,0,0,0
AUDITOR 2YR DERRY,Write In  ,Derry Township--4th Precinct,0,0,0,0,0,0,0,0,0,0
AUDITOR 2YR DERRY,Write In  ,Derry Township--5th Precinct,0,0,0,0,0,0,0,0,0,0
AUDITOR 2YR DERRY,Write In  ,Derry Township--6th Precinct,0,0,0,0,0,0,0,0,0,0
AUDITOR 2YR DERRY,Write In  ,Derry Township--7th Precinct,0,0,0,0,0,0,0,0,0,0
AUDITOR 2YR DERRY,Write In  ,Derry Township--8th Precinct,0,0,0,0,0,0,0,0,0,0
AUDITOR 2YR DERRY,Write In  ,Derry Township--9th Precinct,0,0,0,0,0,0,0,0,0,0
AUDITOR 2YR DERRY,Write In  ,Derry Township--10th Precinct,0,0,0,0,0,0,0,0,0,0
AUDITOR 2YR DERRY,Write In  ,Derry Township--11th Precinct,0,0,0,0,0,0,0,0,0,0
AUDITOR 2YR DERRY,Write In  ,Derry Township--12th Precinct,0,0,0,0,0,0,0,0,0,0
AUDITOR 2YR DERRY,Write In  ,Derry Township--13th Precinct,0,0,0,0,0,0,0,0,0,0
AUDITOR 2YR DERRY,Write In  ,Derry Township--14th Precinct,0,0,0,0,0,0,0,0,0,0
AUDITOR 2YR DERRY,Write In  ,Derry Township--15th Precinct,0,0,0,0,0,0,0,0,0,0
AUDITOR 2YR MID PAX,Marita J. KELLEY,Middle Paxton Twp--1st Precinct,212,0,0,0,212,615,2,0,0,617
AUDITOR 2YR MID PAX,Marita J. KELLEY,Middle Paxton Twp--2nd Precinct,192,0,0,0,192,615,2,0,0,617
AUDITOR 2YR MID PAX,Marita J. KELLEY,Middle Paxton Twp--3rd Precinct,211,2,0,0,213,615,2,0,0,617
AUDITOR 2YR MID PAX,Write In  ,Middle Paxton Twp--1st Precinct,0,0,0,0,0,1,0,0,0,1
AUDITOR 2YR MID PAX,Write In  ,Middle Paxton Twp--2nd Precinct,0,0,0,0,0,1,0,0,0,1
AUDITOR 2YR MID PAX,Write In  ,Middle Paxton Twp--3rd Precinct,1,0,0,0,1,1,0,0,0,1
AUDITOR 2YR PAXTANG,Write In  ,Paxtang Borough,3,0,0,0,3,3,0,0,0,3
AUDITOR 2YR REED,Write In  ,Reed Township,0,0,0,0,0,0,0,0,0,0
AUDITOR 2YR WASHINGTON,Write In  ,Washington Township,2,0,0,0,2,2,0,0,0,2
AUDITOR 2YR WEST HAN,Write In  ,West Hanover Twp--1st Precinct,5,0,0,0,5,19,0,0,0,19
AUDITOR 2YR WEST HAN,Write In  ,West Hanover Twp--2nd Precinct,3,0,0,0,3,19,0,0,0,19
AUDITOR 2YR WEST HAN,Write In  ,West Hanover Twp--3rd Precinct,4,0,0,0,4,19,0,0,0,19
AUDITOR 2YR WEST HAN,Write In  ,West Hanover Twp--4th Precinct,7,0,0,0,7,19,0,0,0,19
AUDITOR 4 YR ROYALTON,Write In  ,Royalton Borough--1st Ward,0,0,0,0,0,2,0,0,0,2
AUDITOR 4 YR ROYALTON,Write In  ,Royalton Borough--2nd Ward,2,0,0,0,2,2,0,0,0,2
AUDITOR 4YR BERRYSBURG,Write In  ,Berrysburg Borough,0,0,0,0,0,0,0,0,0,0
AUDITOR 4YR CONEWAGO,Write In  ,Conewago Twp--1st Precinct,2,0,0,0,2,5,0,0,0,5
AUDITOR 4YR CONEWAGO,Write In  ,Conewago Twp--2nd Precinct,3,0,0,0,3,5,0,0,0,5
AUDITOR 4YR GRATZ,Write In  ,Gratz Borough,1,0,0,0,1,1,0,0,0,1
AUDITOR 4YR HALIFAX BORO,Write In  ,Halifax Borough,12,0,0,0,12,12,0,0,0,12
AUDITOR 4YR LOW PAXTON,Jason  SKRINAK,Lower Paxton Twp--1st Precinct,156,1,0,0,157,4673,93,4,0,4770
AUDITOR 4YR LOW PAXTON,Jason  SKRINAK,Lower Paxton Twp--2nd Precinct,137,4,0,0,141,4673,93,4,0,4770
AUDITOR 4YR LOW PAXTON,Jason  SKRINAK,Lower Paxton Twp--3rd precinct,284,6,0,0,290,4673,93,4,0,4770
AUDITOR 4YR LOW PAXTON,Jason  SKRINAK,Lower Paxton Twp--4th Precinct,197,2,0,0,199,4673,93,4,0,4770
AUDITOR 4YR LOW PAXTON,Jason  SKRINAK,Lower Paxton Twp--5th Precinct,163,2,1,0,166,4673,93,4,0,4770
AUDITOR 4YR LOW PAXTON,Jason  SKRINAK,Lower Paxton Twp--6th Precinct,114,2,0,0,116,4673,93,4,0,4770
AUDITOR 4YR LOW PAXTON,Jason  SKRINAK,Lower Paxton Twp--7th Precinct,263,5,0,0,268,4673,93,4,0,4770
AUDITOR 4YR LOW PAXTON,Jason  SKRINAK,Lower Paxton Twp--8th Precinct,102,2,0,0,104,4673,93,4,0,4770
AUDITOR 4YR LOW PAXTON,Jason  SKRINAK,Lower Paxton Twp--9th Precinct,156,4,0,0,160,4673,93,4,0,4770
AUDITOR 4YR LOW PAXTON,Jason  SKRINAK,Lower Paxton Twp--10th Precinct,73,2,0,0,75,4673,93,4,0,4770
AUDITOR 4YR LOW PAXTON,Jason  SKRINAK,Lower Paxton Twp--11th Precinct,135,1,1,0,137,4673,93,4,0,4770
AUDITOR 4YR LOW PAXTON,Jason  SKRINAK,Lower Paxton Twp--12th Precinct,209,5,1,0,215,4673,93,4,0,4770
AUDITOR 4YR LOW PAXTON,Jason  SKRINAK,Lower Paxton Twp--13th Precinct,186,1,0,0,187,4673,93,4,0,4770
AUDITOR 4YR LOW PAXTON,Jason  SKRINAK,Lower Paxton Twp--14th Precinct,99,4,1,0,104,4673,93,4,0,4770
AUDITOR 4YR LOW PAXTON,Jason  SKRINAK,Lower Paxton Twp--15th Precinct,178,3,0,0,181,4673,93,4,0,4770
AUDITOR 4YR LOW PAXTON,Jason  SKRINAK,Lower Paxton Twp--16th Precinct,296,6,0,0,302,4673,93,4,0,4770
AUDITOR 4YR LOW PAXTON,Jason  SKRINAK,Lower Paxton Twp--17th Precinct,135,3,0,0,138,4673,93,4,0,4770
AUDITOR 4YR LOW PAXTON,Jason  SKRINAK,Lower Paxton Twp--18th Precinct,132,2,0,0,134,4673,93,4,0,4770
AUDITOR 4YR LOW PAXTON,Jason  SKRINAK,Lower Paxton Twp--19th Precinct,233,13,0,0,246,4673,93,4,0,4770
AUDITOR 4YR LOW PAXTON,Jason  SKRINAK,Lower Paxton Twp--20th Precinct,202,4,0,0,206,4673,93,4,0,4770
AUDITOR 4YR LOW PAXTON,Jason  SKRINAK,Lower Paxton Twp--21st Precinct,222,2,0,0,224,4673,93,4,0,4770
AUDITOR 4YR LOW PAXTON,Jason  SKRINAK,Lower Paxton Twp--22nd Precinct,201,4,0,0,205,4673,93,4,0,4770
AUDITOR 4YR LOW PAXTON,Jason  SKRINAK,Lower Paxton Twp--23rd Precinct,193,3,0,0,196,4673,93,4,0,4770
AUDITOR 4YR LOW PAXTON,Jason  SKRINAK,Lower Paxton Twp--24th Precinct,179,6,0,0,185,4673,93,4,0,4770
AUDITOR 4YR LOW PAXTON,Jason  SKRINAK,Lower Paxton Twp--25th Precinct,110,2,0,0,112,4673,93,4,0,4770
AUDITOR 4YR LOW PAXTON,Jason  SKRINAK,Lower Paxton Twp--26th Precinct,171,4,0,0,175,4673,93,4,0,4770
AUDITOR 4YR LOW PAXTON,Jason  SKRINAK,Lower Paxton Twp--27th Precinct,147,0,0,0,147,4673,93,4,0,4770
AUDITOR 4YR LOW PAXTON,Lauren  ROONEY,Lower Paxton Twp--1st Precinct,98,1,0,0,99,3395,78,2,0,3475
AUDITOR 4YR LOW PAXTON,Lauren  ROONEY,Lower Paxton Twp--2nd Precinct,116,7,0,0,123,3395,78,2,0,3475
AUDITOR 4YR LOW PAXTON,Lauren  ROONEY,Lower Paxton Twp--3rd precinct,170,6,0,0,176,3395,78,2,0,3475
AUDITOR 4YR LOW PAXTON,Lauren  ROONEY,Lower Paxton Twp--4th Precinct,144,2,0,0,146,3395,78,2,0,3475
AUDITOR 4YR LOW PAXTON,Lauren  ROONEY,Lower Paxton Twp--5th Precinct,138,2,0,0,140,3395,78,2,0,3475
AUDITOR 4YR LOW PAXTON,Lauren  ROONEY,Lower Paxton Twp--6th Precinct,118,3,0,0,121,3395,78,2,0,3475
AUDITOR 4YR LOW PAXTON,Lauren  ROONEY,Lower Paxton Twp--7th Precinct,142,2,0,0,144,3395,78,2,0,3475
AUDITOR 4YR LOW PAXTON,Lauren  ROONEY,Lower Paxton Twp--8th Precinct,94,2,0,0,96,3395,78,2,0,3475
AUDITOR 4YR LOW PAXTON,Lauren  ROONEY,Lower Paxton Twp--9th Precinct,82,3,0,0,85,3395,78,2,0,3475
AUDITOR 4YR LOW PAXTON,Lauren  ROONEY,Lower Paxton Twp--10th Precinct,103,5,0,0,108,3395,78,2,0,3475
AUDITOR 4YR LOW PAXTON,Lauren  ROONEY,Lower Paxton Twp--11th Precinct,99,3,0,0,102,3395,78,2,0,3475
AUDITOR 4YR LOW PAXTON,Lauren  ROONEY,Lower Paxton Twp--12th Precinct,129,3,0,0,132,3395,78,2,0,3475
AUDITOR 4YR LOW PAXTON,Lauren  ROONEY,Lower Paxton Twp--13th Precinct,144,5,0,0,149,3395,78,2,0,3475
AUDITOR 4YR LOW PAXTON,Lauren  ROONEY,Lower Paxton Twp--14th Precinct,93,1,2,0,96,3395,78,2,0,3475
AUDITOR 4YR LOW PAXTON,Lauren  ROONEY,Lower Paxton Twp--15th Precinct,125,3,0,0,128,3395,78,2,0,3475
AUDITOR 4YR LOW PAXTON,Lauren  ROONEY,Lower Paxton Twp--16th Precinct,192,4,0,0,196,3395,78,2,0,3475
AUDITOR 4YR LOW PAXTON,Lauren  ROONEY,Lower Paxton Twp--17th Precinct,122,3,0,0,125,3395,78,2,0,3475
AUDITOR 4YR LOW PAXTON,Lauren  ROONEY,Lower Paxton Twp--18th Precinct,106,0,0,0,106,3395,78,2,0,3475
AUDITOR 4YR LOW PAXTON,Lauren  ROONEY,Lower Paxton Twp--19th Precinct,180,4,0,0,184,3395,78,2,0,3475
AUDITOR 4YR LOW PAXTON,Lauren  ROONEY,Lower Paxton Twp--20th Precinct,103,1,0,0,104,3395,78,2,0,3475
AUDITOR 4YR LOW PAXTON,Lauren  ROONEY,Lower Paxton Twp--21st Precinct,185,9,0,0,194,3395,78,2,0,3475
AUDITOR 4YR LOW PAXTON,Lauren  ROONEY,Lower Paxton Twp--22nd Precinct,114,1,0,0,115,3395,78,2,0,3475
AUDITOR 4YR LOW PAXTON,Lauren  ROONEY,Lower Paxton Twp--23rd Precinct,101,0,0,0,101,3395,78,2,0,3475
AUDITOR 4YR LOW PAXTON,Lauren  ROONEY,Lower Paxton Twp--24th Precinct,126,1,0,0,127,3395,78,2,0,3475
AUDITOR 4YR LOW PAXTON,Lauren  ROONEY,Lower Paxton Twp--25th Precinct,104,1,0,0,105,3395,78,2,0,3475
AUDITOR 4YR LOW PAXTON,Lauren  ROONEY,Lower Paxton Twp--26th Precinct,146,4,0,0,150,3395,78,2,0,3475
AUDITOR 4YR LOW PAXTON,Lauren  ROONEY,Lower Paxton Twp--27th Precinct,121,2,0,0,123,3395,78,2,0,3475
AUDITOR 4YR LOW PAXTON,Write In  ,Lower Paxton Twp--1st Precinct,0,0,0,0,0,2,0,0,0,2
AUDITOR 4YR LOW PAXTON,Write In  ,Lower Paxton Twp--2nd Precinct,0,0,0,0,0,2,0,0,0,2
AUDITOR 4YR LOW PAXTON,Write In  ,Lower Paxton Twp--3rd precinct,0,0,0,0,0,2,0,0,0,2
AUDITOR 4YR LOW PAXTON,Write In  ,Lower Paxton Twp--4th Precinct,0,0,0,0,0,2,0,0,0,2
AUDITOR 4YR LOW PAXTON,Write In  ,Lower Paxton Twp--5th Precinct,1,0,0,0,1,2,0,0,0,2
AUDITOR 4YR LOW PAXTON,Write In  ,Lower Paxton Twp--6th Precinct,0,0,0,0,0,2,0,0,0,2
AUDITOR 4YR LOW PAXTON,Write In  ,Lower Paxton Twp--7th Precinct,0,0,0,0,0,2,0,0,0,2
AUDITOR 4YR LOW PAXTON,Write In  ,Lower Paxton Twp--8th Precinct,0,0,0,0,0,2,0,0,0,2
AUDITOR 4YR LOW PAXTON,Write In  ,Lower Paxton Twp--9th Precinct,0,0,0,0,0,2,0,0,0,2
AUDITOR 4YR LOW PAXTON,Write In  ,Lower Paxton Twp--10th Precinct,0,0,0,0,0,2,0,0,0,2
AUDITOR 4YR LOW PAXTON,Write In  ,Lower Paxton Twp--11th Precinct,0,0,0,0,0,2,0,0,0,2
AUDITOR 4YR LOW PAXTON,Write In  ,Lower Paxton Twp--12th Precinct,0,0,0,0,0,2,0,0,0,2
AUDITOR 4YR LOW PAXTON,Write In  ,Lower Paxton Twp--13th Precinct,0,0,0,0,0,2,0,0,0,2
AUDITOR 4YR LOW PAXTON,Write In  ,Lower Paxton Twp--14th Precinct,0,0,0,0,0,2,0,0,0,2
AUDITOR 4YR LOW PAXTON,Write In  ,Lower Paxton Twp--15th Precinct,0,0,0,0,0,2,0,0,0,2
AUDITOR 4YR LOW PAXTON,Write In  ,Lower Paxton Twp--16th Precinct,0,0,0,0,0,2,0,0,0,2
AUDITOR 4YR LOW PAXTON,Write In  ,Lower Paxton Twp--17th Precinct,0,0,0,0,0,2,0,0,0,2
AUDITOR 4YR LOW PAXTON,Write In  ,Lower Paxton Twp--18th Precinct,0,0,0,0,0,2,0,0,0,2
AUDITOR 4YR LOW PAXTON,Write In  ,Lower Paxton Twp--19th Precinct,0,0,0,0,0,2,0,0,0,2
AUDITOR 4YR LOW PAXTON,Write In  ,Lower Paxton Twp--20th Precinct,0,0,0,0,0,2,0,0,0,2
AUDITOR 4YR LOW PAXTON,Write In  ,Lower Paxton Twp--21st Precinct,0,0,0,0,0,2,0,0,0,2
AUDITOR 4YR LOW PAXTON,Write In  ,Lower Paxton Twp--22nd Precinct,0,0,0,0,0,2,0,0,0,2
AUDITOR 4YR LOW PAXTON,Write In  ,Lower Paxton Twp--23rd Precinct,0,0,0,0,0,2,0,0,0,2
AUDITOR 4YR LOW PAXTON,Write In  ,Lower Paxton Twp--24th Precinct,1,0,0,0,1,2,0,0,0,2
AUDITOR 4YR LOW PAXTON,Write In  ,Lower Paxton Twp--25th Precinct,0,0,0,0,0,2,0,0,0,2
AUDITOR 4YR LOW PAXTON,Write In  ,Lower Paxton Twp--26th Precinct,0,0,0,0,0,2,0,0,0,2
AUDITOR 4YR LOW PAXTON,Write In  ,Lower Paxton Twp--27th Precinct,0,0,0,0,0,2,0,0,0,2
AUDITOR 4YR LYKENS,Write In  ,Lykens Township,0,0,0,0,0,0,0,0,0,0
AUDITOR 4YR PAXTANG,Write In  ,Paxtang Borough,4,0,0,0,4,4,0,0,0,4
AUDITOR 4YR REED,Write In  ,Reed Township,0,0,0,0,0,0,0,0,0,0
AUDITOR 4YR UPP PAX,Write In  ,Upper Paxton Twp--1st Precinct,3,0,0,0,3,3,0,0,0,3
AUDITOR 4YR UPP PAX,Write In  ,Upper Paxton Twp--2nd Precinct,0,0,0,0,0,3,0,0,0,3
AUDITOR 4YR WEST HAN,Write In  ,West Hanover Twp--1st Precinct,3,0,0,0,3,14,0,0,0,14
AUDITOR 4YR WEST HAN,Write In  ,West Hanover Twp--2nd Precinct,4,0,0,0,4,14,0,0,0,14
AUDITOR 4YR WEST HAN,Write In  ,West Hanover Twp--3rd Precinct,4,0,0,0,4,14,0,0,0,14
AUDITOR 4YR WEST HAN,Write In  ,West Hanover Twp--4th Precinct,3,0,0,0,3,14,0,0,0,14
AUDITOR 6YR BERRYSBURG,Write In  ,Berrysburg Borough,0,0,0,0,0,0,0,0,0,0
AUDITOR 6YR CONEWAGO,Write In  ,Conewago Twp--1st Precinct,4,0,0,0,4,7,0,0,0,7
AUDITOR 6YR CONEWAGO,Write In  ,Conewago Twp--2nd Precinct,3,0,0,0,3,7,0,0,0,7
AUDITOR 6YR DERRY,Gabe  PLEBANI,Derry Township--1st Precinct,267,4,0,0,271,2966,69,1,0,3036
AUDITOR 6YR DERRY,Gabe  PLEBANI,Derry Township--2nd Precinct,235,6,0,0,241,2966,69,1,0,3036
AUDITOR 6YR DERRY,Gabe  PLEBANI,Derry Township--3rd Precinct,178,5,0,0,183,2966,69,1,0,3036
AUDITOR 6YR DERRY,Gabe  PLEBANI,Derry Township--4th Precinct,150,5,0,0,155,2966,69,1,0,3036
AUDITOR 6YR DERRY,Gabe  PLEBANI,Derry Township--5th Precinct,115,3,0,0,118,2966,69,1,0,3036
AUDITOR 6YR DERRY,Gabe  PLEBANI,Derry Township--6th Precinct,145,1,0,0,146,2966,69,1,0,3036
AUDITOR 6YR DERRY,Gabe  PLEBANI,Derry Township--7th Precinct,314,14,0,0,328,2966,69,1,0,3036
AUDITOR 6YR DERRY,Gabe  PLEBANI,Derry Township--8th Precinct,151,0,0,0,151,2966,69,1,0,3036
AUDITOR 6YR DERRY,Gabe  PLEBANI,Derry Township--9th Precinct,102,3,0,0,105,2966,69,1,0,3036
AUDITOR 6YR DERRY,Gabe  PLEBANI,Derry Township--10th Precinct,214,3,0,0,217,2966,69,1,0,3036
AUDITOR 6YR DERRY,Gabe  PLEBANI,Derry Township--11th Precinct,293,7,0,0,300,2966,69,1,0,3036
AUDITOR 6YR DERRY,Gabe  PLEBANI,Derry Township--12th Precinct,156,1,0,0,157,2966,69,1,0,3036
AUDITOR 6YR DERRY,Gabe  PLEBANI,Derry Township--13th Precinct,216,7,0,0,223,2966,69,1,0,3036
AUDITOR 6YR DERRY,Gabe  PLEBANI,Derry Township--14th Precinct,154,5,0,0,159,2966,69,1,0,3036
AUDITOR 6YR DERRY,Gabe  PLEBANI,Derry Township--15th Precinct,276,5,1,0,282,2966,69,1,0,3036
AUDITOR 6YR DERRY,Write In  ,Derry Township--1st Precinct,1,0,0,0,1,6,0,0,0,6
AUDITOR 6YR DERRY,Write In  ,Derry Township--2nd Precinct,0,0,0,0,0,6,0,0,0,6
AUDITOR 6YR DERRY,Write In  ,Derry Township--3rd Precinct,1,0,0,0,1,6,0,0,0,6
AUDITOR 6YR DERRY,Write In  ,Derry Township--4th Precinct,1,0,0,0,1,6,0,0,0,6
AUDITOR 6YR DERRY,Write In  ,Derry Township--5th Precinct,0,0,0,0,0,6,0,0,0,6
AUDITOR 6YR DERRY,Write In  ,Derry Township--6th Precinct,0,0,0,0,0,6,0,0,0,6
AUDITOR 6YR DERRY,Write In  ,Derry Township--7th Precinct,0,0,0,0,0,6,0,0,0,6
AUDITOR 6YR DERRY,Write In  ,Derry Township--8th Precinct,0,0,0,0,0,6,0,0,0,6
AUDITOR 6YR DERRY,Write In  ,Derry Township--9th Precinct,1,0,0,0,1,6,0,0,0,6
AUDITOR 6YR DERRY,Write In  ,Derry Township--10th Precinct,0,0,0,0,0,6,0,0,0,6
AUDITOR 6YR DERRY,Write In  ,Derry Township--11th Precinct,0,0,0,0,0,6,0,0,0,6
AUDITOR 6YR DERRY,Write In  ,Derry Township--12th Precinct,0,0,0,0,0,6,0,0,0,6
AUDITOR 6YR DERRY,Write In  ,Derry Township--13th Precinct,0,0,0,0,0,6,0,0,0,6
AUDITOR 6YR DERRY,Write In  ,Derry Township--14th Precinct,0,0,0,0,0,6,0,0,0,6
AUDITOR 6YR DERRY,Write In  ,Derry Township--15th Precinct,2,0,0,0,2,6,0,0,0,6
AUDITOR 6YR GRATZ,Write In  ,Gratz Borough,1,0,0,0,1,1,0,0,0,1
AUDITOR 6YR HALIFAX BORO,Write In  ,Halifax Borough,10,0,0,0,10,10,0,0,0,10
AUDITOR 6YR LOW PAXTON,Jamie M. LEBER,Lower Paxton Twp--1st Precinct,202,2,0,0,204,6609,139,6,0,6754
AUDITOR 6YR LOW PAXTON,Jamie M. LEBER,Lower Paxton Twp--2nd Precinct,209,8,0,0,217,6609,139,6,0,6754
AUDITOR 6YR LOW PAXTON,Jamie M. LEBER,Lower Paxton Twp--3rd precinct,388,12,0,0,400,6609,139,6,0,6754
AUDITOR 6YR LOW PAXTON,Jamie M. LEBER,Lower Paxton Twp--4th Precinct,282,3,0,0,285,6609,139,6,0,6754
AUDITOR 6YR LOW PAXTON,Jamie M. LEBER,Lower Paxton Twp--5th Precinct,243,4,1,0,248,6609,139,6,0,6754
AUDITOR 6YR LOW PAXTON,Jamie M. LEBER,Lower Paxton Twp--6th Precinct,175,4,0,0,179,6609,139,6,0,6754
AUDITOR 6YR LOW PAXTON,Jamie M. LEBER,Lower Paxton Twp--7th Precinct,348,7,0,0,355,6609,139,6,0,6754
AUDITOR 6YR LOW PAXTON,Jamie M. LEBER,Lower Paxton Twp--8th Precinct,149,1,0,0,150,6609,139,6,0,6754
AUDITOR 6YR LOW PAXTON,Jamie M. LEBER,Lower Paxton Twp--9th Precinct,201,4,0,0,205,6609,139,6,0,6754
AUDITOR 6YR LOW PAXTON,Jamie M. LEBER,Lower Paxton Twp--10th Precinct,121,2,0,0,123,6609,139,6,0,6754
AUDITOR 6YR LOW PAXTON,Jamie M. LEBER,Lower Paxton Twp--11th Precinct,195,2,1,0,198,6609,139,6,0,6754
AUDITOR 6YR LOW PAXTON,Jamie M. LEBER,Lower Paxton Twp--12th Precinct,290,8,1,0,299,6609,139,6,0,6754
AUDITOR 6YR LOW PAXTON,Jamie M. LEBER,Lower Paxton Twp--13th Precinct,271,5,0,0,276,6609,139,6,0,6754
AUDITOR 6YR LOW PAXTON,Jamie M. LEBER,Lower Paxton Twp--14th Precinct,157,3,3,0,163,6609,139,6,0,6754
AUDITOR 6YR LOW PAXTON,Jamie M. LEBER,Lower Paxton Twp--15th Precinct,242,5,0,0,247,6609,139,6,0,6754
AUDITOR 6YR LOW PAXTON,Jamie M. LEBER,Lower Paxton Twp--16th Precinct,425,9,0,0,434,6609,139,6,0,6754
AUDITOR 6YR LOW PAXTON,Jamie M. LEBER,Lower Paxton Twp--17th Precinct,192,7,0,0,199,6609,139,6,0,6754
AUDITOR 6YR LOW PAXTON,Jamie M. LEBER,Lower Paxton Twp--18th Precinct,181,2,0,0,183,6609,139,6,0,6754
AUDITOR 6YR LOW PAXTON,Jamie M. LEBER,Lower Paxton Twp--19th Precinct,320,13,0,0,333,6609,139,6,0,6754
AUDITOR 6YR LOW PAXTON,Jamie M. LEBER,Lower Paxton Twp--20th Precinct,274,5,0,0,279,6609,139,6,0,6754
AUDITOR 6YR LOW PAXTON,Jamie M. LEBER,Lower Paxton Twp--21st Precinct,324,8,0,0,332,6609,139,6,0,6754
AUDITOR 6YR LOW PAXTON,Jamie M. LEBER,Lower Paxton Twp--22nd Precinct,276,4,0,0,280,6609,139,6,0,6754
AUDITOR 6YR LOW PAXTON,Jamie M. LEBER,Lower Paxton Twp--23rd Precinct,262,3,0,0,265,6609,139,6,0,6754
AUDITOR 6YR LOW PAXTON,Jamie M. LEBER,Lower Paxton Twp--24th Precinct,253,6,0,0,259,6609,139,6,0,6754
AUDITOR 6YR LOW PAXTON,Jamie M. LEBER,Lower Paxton Twp--25th Precinct,164,3,0,0,167,6609,139,6,0,6754
AUDITOR 6YR LOW PAXTON,Jamie M. LEBER,Lower Paxton Twp--26th Precinct,255,7,0,0,262,6609,139,6,0,6754
AUDITOR 6YR LOW PAXTON,Jamie M. LEBER,Lower Paxton Twp--27th Precinct,210,2,0,0,212,6609,139,6,0,6754
AUDITOR 6YR LOW PAXTON,Write In  ,Lower Paxton Twp--1st Precinct,1,0,0,0,1,6,0,0,0,6
AUDITOR 6YR LOW PAXTON,Write In  ,Lower Paxton Twp--2nd Precinct,0,0,0,0,0,6,0,0,0,6
AUDITOR 6YR LOW PAXTON,Write In  ,Lower Paxton Twp--3rd precinct,0,0,0,0,0,6,0,0,0,6
AUDITOR 6YR LOW PAXTON,Write In  ,Lower Paxton Twp--4th Precinct,0,0,0,0,0,6,0,0,0,6
AUDITOR 6YR LOW PAXTON,Write In  ,Lower Paxton Twp--5th Precinct,0,0,0,0,0,6,0,0,0,6
AUDITOR 6YR LOW PAXTON,Write In  ,Lower Paxton Twp--6th Precinct,1,0,0,0,1,6,0,0,0,6
AUDITOR 6YR LOW PAXTON,Write In  ,Lower Paxton Twp--7th Precinct,0,0,0,0,0,6,0,0,0,6
AUDITOR 6YR LOW PAXTON,Write In  ,Lower Paxton Twp--8th Precinct,0,0,0,0,0,6,0,0,0,6
AUDITOR 6YR LOW PAXTON,Write In  ,Lower Paxton Twp--9th Precinct,0,0,0,0,0,6,0,0,0,6
AUDITOR 6YR LOW PAXTON,Write In  ,Lower Paxton Twp--10th Precinct,1,0,0,0,1,6,0,0,0,6
AUDITOR 6YR LOW PAXTON,Write In  ,Lower Paxton Twp--11th Precinct,0,0,0,0,0,6,0,0,0,6
AUDITOR 6YR LOW PAXTON,Write In  ,Lower Paxton Twp--12th Precinct,1,0,0,0,1,6,0,0,0,6
AUDITOR 6YR LOW PAXTON,Write In  ,Lower Paxton Twp--13th Precinct,0,0,0,0,0,6,0,0,0,6
AUDITOR 6YR LOW PAXTON,Write In  ,Lower Paxton Twp--14th Precinct,0,0,0,0,0,6,0,0,0,6
AUDITOR 6YR LOW PAXTON,Write In  ,Lower Paxton Twp--15th Precinct,0,0,0,0,0,6,0,0,0,6
AUDITOR 6YR LOW PAXTON,Write In  ,Lower Paxton Twp--16th Precinct,0,0,0,0,0,6,0,0,0,6
AUDITOR 6YR LOW PAXTON,Write In  ,Lower Paxton Twp--17th Precinct,0,0,0,0,0,6,0,0,0,6
AUDITOR 6YR LOW PAXTON,Write In  ,Lower Paxton Twp--18th Precinct,0,0,0,0,0,6,0,0,0,6
AUDITOR 6YR LOW PAXTON,Write In  ,Lower Paxton Twp--19th Precinct,0,0,0,0,0,6,0,0,0,6
AUDITOR 6YR LOW PAXTON,Write In  ,Lower Paxton Twp--20th Precinct,0,0,0,0,0,6,0,0,0,6
AUDITOR 6YR LOW PAXTON,Write In  ,Lower Paxton Twp--21st Precinct,0,0,0,0,0,6,0,0,0,6
AUDITOR 6YR LOW PAXTON,Write In  ,Lower Paxton Twp--22nd Precinct,1,0,0,0,1,6,0,0,0,6
AUDITOR 6YR LOW PAXTON,Write In  ,Lower Paxton Twp--23rd Precinct,0,0,0,0,0,6,0,0,0,6
AUDITOR 6YR LOW PAXTON,Write In  ,Lower Paxton Twp--24th Precinct,1,0,0,0,1,6,0,0,0,6
AUDITOR 6YR LOW PAXTON,Write In  ,Lower Paxton Twp--25th Precinct,0,0,0,0,0,6,0,0,0,6
AUDITOR 6YR LOW PAXTON,Write In  ,Lower Paxton Twp--26th Precinct,0,0,0,0,0,6,0,0,0,6
AUDITOR 6YR LOW PAXTON,Write In  ,Lower Paxton Twp--27th Precinct,0,0,0,0,0,6,0,0,0,6
AUDITOR 6YR LYKENS,Darlene M. NOVINGER,Lykens Township,99,0,0,0,99,99,0,0,0,99
AUDITOR 6YR LYKENS,Write In  ,Lykens Township,0,0,0,0,0,0,0,0,0,0
AUDITOR 6YR MID PAX,Write In  ,Middle Paxton Twp--1st Precinct,3,0,0,0,3,6,0,0,0,6
AUDITOR 6YR MID PAX,Write In  ,Middle Paxton Twp--2nd Precinct,1,0,0,0,1,6,0,0,0,6
AUDITOR 6YR MID PAX,Write In  ,Middle Paxton Twp--3rd Precinct,2,0,0,0,2,6,0,0,0,6
AUDITOR 6YR PAXTANG,Write In  ,Paxtang Borough,3,0,0,0,3,3,0,0,0,3
AUDITOR 6YR REED,Write In  ,Reed Township,1,0,0,0,1,1,0,0,0,1
AUDITOR 6YR ROYALTON,Write In  ,Royalton Borough--1st Ward,0,0,0,0,0,3,0,0,0,3
AUDITOR 6YR ROYALTON,Write In  ,Royalton Borough--2nd Ward,3,0,0,0,3,3,0,0,0,3
AUDITOR 6YR UPP PAX,Write In  ,Upper Paxton Twp--1st Precinct,3,0,0,0,3,3,0,0,0,3
AUDITOR 6YR UPP PAX,Write In  ,Upper Paxton Twp--2nd Precinct,0,0,0,0,0,3,0,0,0,3
AUDITOR 6YR WASHINGTON,"Wildon C. RENN, III",Washington Township,250,6,0,0,256,250,6,0,0,256
AUDITOR 6YR WASHINGTON,Write In  ,Washington Township,1,0,0,0,1,1,0,0,0,1
AUDITOR 6YR WEST HAN,Write In  ,West Hanover Twp--1st Precinct,4,0,0,0,4,18,0,0,0,18
AUDITOR 6YR WEST HAN,Write In  ,West Hanover Twp--2nd Precinct,3,0,0,0,3,18,0,0,0,18
AUDITOR 6YR WEST HAN,Write In  ,West Hanover Twp--3rd Precinct,7,0,0,0,7,18,0,0,0,18
AUDITOR 6YR WEST HAN,Write In  ,West Hanover Twp--4th Precinct,4,0,0,0,4,18,0,0,0,18
AUDITOR DAUPHIN,Write In  ,Dauphin Borough,3,0,0,0,3,3,0,0,0,3
AUDITOR HALIFAX TWP,Write In  ,Halifax Twp--1st Precinct,2,0,0,0,2,3,0,0,0,3
AUDITOR HALIFAX TWP,Write In  ,Halifax Twp--2nd Precinct,1,0,0,0,1,3,0,0,0,3
AUDITOR JACKSON,Elaine  STEIGMAN,Jackson Township,224,1,0,0,225,224,1,0,0,225
AUDITOR JACKSON,Write In  ,Jackson Township,1,0,0,0,1,1,0,0,0,1
AUDITOR JEFFERSON,Lynette E. SCHELL,Jefferson Township,60,0,0,0,60,60,0,0,0,60
AUDITOR JEFFERSON,Write In  ,Jefferson Township,1,0,0,0,1,1,0,0,0,1
AUDITOR MIFFLIN,Joan M. STRAUB,Mifflin Township,89,0,0,0,89,89,0,0,0,89
AUDITOR MIFFLIN,Write In  ,Mifflin Township,0,0,0,0,0,0,0,0,0,0
AUDITOR PENBROOK,Write In  ,Penbrook Borough--1st Ward,2,0,0,0,2,9,0,0,0,9
AUDITOR PENBROOK,Write In  ,Penbrook Borough--2nd Ward,2,0,0,0,2,9,0,0,0,9
AUDITOR PENBROOK,Write In  ,Penbrook Borough--3rd Ward,2,0,0,0,2,9,0,0,0,9
AUDITOR PENBROOK,Write In  ,Penbrook Borough--4th Ward,3,0,0,0,3,9,0,0,0,9
AUDITOR PILLOW,Joan  WILLIARD,Pillow Borough,55,0,0,0,55,55,0,0,0,55
AUDITOR PILLOW,Write In  ,Pillow Borough,0,0,0,0,0,0,0,0,0,0
AUDITOR RUSH,Write In  ,Rush Township,0,0,0,0,0,0,0,0,0,0
AUDITOR SOU HANOVER,Tom  SCOTT,South Hanover Twp--1st Precinct,271,5,0,0,276,851,14,0,0,865
AUDITOR SOU HANOVER,Tom  SCOTT,South Hanover Twp--2nd Precinct,359,8,0,0,367,851,14,0,0,865
AUDITOR SOU HANOVER,Tom  SCOTT,South Hanover Twp--3rd Precinct,221,1,0,0,222,851,14,0,0,865
AUDITOR SOU HANOVER,Write In  ,South Hanover Twp--1st Precinct,0,0,0,0,0,2,0,0,0,2
AUDITOR SOU HANOVER,Write In  ,South Hanover Twp--2nd Precinct,0,0,0,0,0,2,0,0,0,2
AUDITOR SOU HANOVER,Write In  ,South Hanover Twp--3rd Precinct,2,0,0,0,2,2,0,0,0,2
AUDITOR WAYNE,Vicki L. BOYER,Wayne Township,244,0,0,0,244,244,0,0,0,244
AUDITOR WAYNE,Write In  ,Wayne Township,0,0,0,0,0,0,0,0,0,0
AUDITOR WILLIAMS,John C. BOYER,Williams Twp,149,1,0,0,150,149,1,0,0,150
AUDITOR WILLIAMS,Write In  ,Williams Twp,0,0,0,0,0,0,0,0,0,0
CITY COUNCIL,Brad  KOPLINSKI,"City--1st Ward, 1st Precinct",100,3,0,0,103,3766,59,2,0,3827
CITY COUNCIL,Brad  KOPLINSKI,"City--1st Ward, 2nd Precinct",156,1,1,0,158,3766,59,2,0,3827
CITY COUNCIL,Brad  KOPLINSKI,"City--1st Ward, 3rd Precinct",58,0,0,0,58,3766,59,2,0,3827
CITY COUNCIL,Brad  KOPLINSKI,"City--2nd Ward, 1st Precinct",48,0,0,0,48,3766,59,2,0,3827
CITY COUNCIL,Brad  KOPLINSKI,"City--2nd Ward, 2nd Precinct",75,1,0,0,76,3766,59,2,0,3827
CITY COUNCIL,Brad  KOPLINSKI,City--3rd Ward,120,0,0,0,120,3766,59,2,0,3827
CITY COUNCIL,Brad  KOPLINSKI,City--4th Ward,164,1,0,0,165,3766,59,2,0,3827
CITY COUNCIL,Brad  KOPLINSKI,City--5th Ward,304,7,0,0,311,3766,59,2,0,3827
CITY COUNCIL,Brad  KOPLINSKI,City--6th Ward,153,2,1,0,156,3766,59,2,0,3827
CITY COUNCIL,Brad  KOPLINSKI,"City--7th Ward, 1st Precinct",56,1,0,0,57,3766,59,2,0,3827
CITY COUNCIL,Brad  KOPLINSKI,"City--7th Ward, 2nd Precinct",103,2,0,0,105,3766,59,2,0,3827
CITY COUNCIL,Brad  KOPLINSKI,City--8th Ward,91,0,0,0,91,3766,59,2,0,3827
CITY COUNCIL,Brad  KOPLINSKI,"City--9th Ward, 1st Precinct",42,1,0,0,43,3766,59,2,0,3827
CITY COUNCIL,Brad  KOPLINSKI,"City--9th Ward, 2nd Precinct",73,0,0,0,73,3766,59,2,0,3827
CITY COUNCIL,Brad  KOPLINSKI,"City--9th Ward, 3rd Precinct",114,0,0,0,114,3766,59,2,0,3827
CITY COUNCIL,Brad  KOPLINSKI,"City--9th Ward, 4th Precinct",207,3,0,0,210,3766,59,2,0,3827
CITY COUNCIL,Brad  KOPLINSKI,"City--9th Ward, 5th Precinct",121,6,0,0,127,3766,59,2,0,3827
CITY COUNCIL,Brad  KOPLINSKI,"City--10th Ward, 1st Precinct",200,3,0,0,203,3766,59,2,0,3827
CITY COUNCIL,Brad  KOPLINSKI,"City--10th Ward, 2nd Precinct",72,0,0,0,72,3766,59,2,0,3827
CITY COUNCIL,Brad  KOPLINSKI,"City--10th Ward, 3rd Precinct",110,1,0,0,111,3766,59,2,0,3827
CITY COUNCIL,Brad  KOPLINSKI,"City--10th Ward, 4th Precinct",102,0,0,0,102,3766,59,2,0,3827
CITY COUNCIL,Brad  KOPLINSKI,City--11th Ward,93,14,0,0,107,3766,59,2,0,3827
CITY COUNCIL,Brad  KOPLINSKI,City--12th Ward,257,7,0,0,264,3766,59,2,0,3827
CITY COUNCIL,Brad  KOPLINSKI,"City--13th Ward, 1st Precinct",131,0,0,0,131,3766,59,2,0,3827
CITY COUNCIL,Brad  KOPLINSKI,"City--13th Ward, 2nd Precinct",172,2,0,0,174,3766,59,2,0,3827
CITY COUNCIL,Brad  KOPLINSKI,"City--13th Ward, 3rd Precinct",208,0,0,0,208,3766,59,2,0,3827
CITY COUNCIL,Brad  KOPLINSKI,City--14th Ward,372,4,0,0,376,3766,59,2,0,3827
CITY COUNCIL,Brad  KOPLINSKI,City--15th Ward,64,0,0,0,64,3766,59,2,0,3827
CITY COUNCIL,"Calobe Jackie JACKSON, JR.","City--1st Ward, 1st Precinct",73,2,0,0,75,2272,49,0,0,2321
CITY COUNCIL,"Calobe Jackie JACKSON, JR.","City--1st Ward, 2nd Precinct",112,1,0,0,113,2272,49,0,0,2321
CITY COUNCIL,"Calobe Jackie JACKSON, JR.","City--1st Ward, 3rd Precinct",29,0,0,0,29,2272,49,0,0,2321
CITY COUNCIL,"Calobe Jackie JACKSON, JR.","City--2nd Ward, 1st Precinct",33,0,0,0,33,2272,49,0,0,2321
CITY COUNCIL,"Calobe Jackie JACKSON, JR.","City--2nd Ward, 2nd Precinct",40,1,0,0,41,2272,49,0,0,2321
CITY COUNCIL,"Calobe Jackie JACKSON, JR.",City--3rd Ward,65,0,0,0,65,2272,49,0,0,2321
CITY COUNCIL,"Calobe Jackie JACKSON, JR.",City--4th Ward,81,0,0,0,81,2272,49,0,0,2321
CITY COUNCIL,"Calobe Jackie JACKSON, JR.",City--5th Ward,199,6,0,0,205,2272,49,0,0,2321
CITY COUNCIL,"Calobe Jackie JACKSON, JR.",City--6th Ward,91,1,0,0,92,2272,49,0,0,2321
CITY COUNCIL,"Calobe Jackie JACKSON, JR.","City--7th Ward, 1st Precinct",34,1,0,0,35,2272,49,0,0,2321
CITY COUNCIL,"Calobe Jackie JACKSON, JR.","City--7th Ward, 2nd Precinct",40,0,0,0,40,2272,49,0,0,2321
CITY COUNCIL,"Calobe Jackie JACKSON, JR.",City--8th Ward,38,1,0,0,39,2272,49,0,0,2321
CITY COUNCIL,"Calobe Jackie JACKSON, JR.","City--9th Ward, 1st Precinct",19,0,0,0,19,2272,49,0,0,2321
CITY COUNCIL,"Calobe Jackie JACKSON, JR.","City--9th Ward, 2nd Precinct",29,1,0,0,30,2272,49,0,0,2321
CITY COUNCIL,"Calobe Jackie JACKSON, JR.","City--9th Ward, 3rd Precinct",44,1,0,0,45,2272,49,0,0,2321
CITY COUNCIL,"Calobe Jackie JACKSON, JR.","City--9th Ward, 4th Precinct",153,4,0,0,157,2272,49,0,0,2321
CITY COUNCIL,"Calobe Jackie JACKSON, JR.","City--9th Ward, 5th Precinct",78,4,0,0,82,2272,49,0,0,2321
CITY COUNCIL,"Calobe Jackie JACKSON, JR.","City--10th Ward, 1st Precinct",108,3,0,0,111,2272,49,0,0,2321
CITY COUNCIL,"Calobe Jackie JACKSON, JR.","City--10th Ward, 2nd Precinct",23,0,0,0,23,2272,49,0,0,2321
CITY COUNCIL,"Calobe Jackie JACKSON, JR.","City--10th Ward, 3rd Precinct",88,1,0,0,89,2272,49,0,0,2321
CITY COUNCIL,"Calobe Jackie JACKSON, JR.","City--10th Ward, 4th Precinct",53,0,0,0,53,2272,49,0,0,2321
CITY COUNCIL,"Calobe Jackie JACKSON, JR.",City--11th Ward,52,6,0,0,58,2272,49,0,0,2321
CITY COUNCIL,"Calobe Jackie JACKSON, JR.",City--12th Ward,143,7,0,0,150,2272,49,0,0,2321
CITY COUNCIL,"Calobe Jackie JACKSON, JR.","City--13th Ward, 1st Precinct",80,0,0,0,80,2272,49,0,0,2321
CITY COUNCIL,"Calobe Jackie JACKSON, JR.","City--13th Ward, 2nd Precinct",114,5,0,0,119,2272,49,0,0,2321
CITY COUNCIL,"Calobe Jackie JACKSON, JR.","City--13th Ward, 3rd Precinct",137,1,0,0,138,2272,49,0,0,2321
CITY COUNCIL,"Calobe Jackie JACKSON, JR.",City--14th Ward,284,3,0,0,287,2272,49,0,0,2321
CITY COUNCIL,"Calobe Jackie JACKSON, JR.",City--15th Ward,32,0,0,0,32,2272,49,0,0,2321
CITY COUNCIL,Eugenia  SMITH,"City--1st Ward, 1st Precinct",73,3,0,0,76,2437,47,0,0,2484
CITY COUNCIL,Eugenia  SMITH,"City--1st Ward, 2nd Precinct",142,1,0,0,143,2437,47,0,0,2484
CITY COUNCIL,Eugenia  SMITH,"City--1st Ward, 3rd Precinct",31,0,0,0,31,2437,47,0,0,2484
CITY COUNCIL,Eugenia  SMITH,"City--2nd Ward, 1st Precinct",36,0,0,0,36,2437,47,0,0,2484
CITY COUNCIL,Eugenia  SMITH,"City--2nd Ward, 2nd Precinct",48,1,0,0,49,2437,47,0,0,2484
CITY COUNCIL,Eugenia  SMITH,City--3rd Ward,67,0,0,0,67,2437,47,0,0,2484
CITY COUNCIL,Eugenia  SMITH,City--4th Ward,85,0,0,0,85,2437,47,0,0,2484
CITY COUNCIL,Eugenia  SMITH,City--5th Ward,200,6,0,0,206,2437,47,0,0,2484
CITY COUNCIL,Eugenia  SMITH,City--6th Ward,103,1,0,0,104,2437,47,0,0,2484
CITY COUNCIL,Eugenia  SMITH,"City--7th Ward, 1st Precinct",31,1,0,0,32,2437,47,0,0,2484
CITY COUNCIL,Eugenia  SMITH,"City--7th Ward, 2nd Precinct",48,2,0,0,50,2437,47,0,0,2484
CITY COUNCIL,Eugenia  SMITH,City--8th Ward,44,0,0,0,44,2437,47,0,0,2484
CITY COUNCIL,Eugenia  SMITH,"City--9th Ward, 1st Precinct",21,0,0,0,21,2437,47,0,0,2484
CITY COUNCIL,Eugenia  SMITH,"City--9th Ward, 2nd Precinct",28,0,0,0,28,2437,47,0,0,2484
CITY COUNCIL,Eugenia  SMITH,"City--9th Ward, 3rd Precinct",65,0,0,0,65,2437,47,0,0,2484
CITY COUNCIL,Eugenia  SMITH,"City--9th Ward, 4th Precinct",156,4,0,0,160,2437,47,0,0,2484
CITY COUNCIL,Eugenia  SMITH,"City--9th Ward, 5th Precinct",81,4,0,0,85,2437,47,0,0,2484
CITY COUNCIL,Eugenia  SMITH,"City--10th Ward, 1st Precinct",105,3,0,0,108,2437,47,0,0,2484
CITY COUNCIL,Eugenia  SMITH,"City--10th Ward, 2nd Precinct",28,0,0,0,28,2437,47,0,0,2484
CITY COUNCIL,Eugenia  SMITH,"City--10th Ward, 3rd Precinct",82,1,0,0,83,2437,47,0,0,2484
CITY COUNCIL,Eugenia  SMITH,"City--10th Ward, 4th Precinct",63,0,0,0,63,2437,47,0,0,2484
CITY COUNCIL,Eugenia  SMITH,City--11th Ward,45,4,0,0,49,2437,47,0,0,2484
CITY COUNCIL,Eugenia  SMITH,City--12th Ward,153,7,0,0,160,2437,47,0,0,2484
CITY COUNCIL,Eugenia  SMITH,"City--13th Ward, 1st Precinct",88,0,0,0,88,2437,47,0,0,2484
CITY COUNCIL,Eugenia  SMITH,"City--13th Ward, 2nd Precinct",125,4,0,0,129,2437,47,0,0,2484
CITY COUNCIL,Eugenia  SMITH,"City--13th Ward, 3rd Precinct",158,2,0,0,160,2437,47,0,0,2484
CITY COUNCIL,Eugenia  SMITH,City--14th Ward,297,3,0,0,300,2437,47,0,0,2484
CITY COUNCIL,Eugenia  SMITH,City--15th Ward,34,0,0,0,34,2437,47,0,0,2484
CITY COUNCIL,Gloria  MARTIN-ROBERTS,"City--1st Ward, 1st Precinct",37,1,0,0,38,3106,45,3,0,3154
CITY COUNCIL,Gloria  MARTIN-ROBERTS,"City--1st Ward, 2nd Precinct",121,1,1,0,123,3106,45,3,0,3154
CITY COUNCIL,Gloria  MARTIN-ROBERTS,"City--1st Ward, 3rd Precinct",76,1,0,0,77,3106,45,3,0,3154
CITY COUNCIL,Gloria  MARTIN-ROBERTS,"City--2nd Ward, 1st Precinct",29,0,0,0,29,3106,45,3,0,3154
CITY COUNCIL,Gloria  MARTIN-ROBERTS,"City--2nd Ward, 2nd Precinct",64,0,0,0,64,3106,45,3,0,3154
CITY COUNCIL,Gloria  MARTIN-ROBERTS,City--3rd Ward,64,1,0,0,65,3106,45,3,0,3154
CITY COUNCIL,Gloria  MARTIN-ROBERTS,City--4th Ward,104,5,0,0,109,3106,45,3,0,3154
CITY COUNCIL,Gloria  MARTIN-ROBERTS,City--5th Ward,163,5,0,0,168,3106,45,3,0,3154
CITY COUNCIL,Gloria  MARTIN-ROBERTS,City--6th Ward,105,1,2,0,108,3106,45,3,0,3154
CITY COUNCIL,Gloria  MARTIN-ROBERTS,"City--7th Ward, 1st Precinct",52,0,0,0,52,3106,45,3,0,3154
CITY COUNCIL,Gloria  MARTIN-ROBERTS,"City--7th Ward, 2nd Precinct",205,0,0,0,205,3106,45,3,0,3154
CITY COUNCIL,Gloria  MARTIN-ROBERTS,City--8th Ward,181,3,0,0,184,3106,45,3,0,3154
CITY COUNCIL,Gloria  MARTIN-ROBERTS,"City--9th Ward, 1st Precinct",49,2,0,0,51,3106,45,3,0,3154
CITY COUNCIL,Gloria  MARTIN-ROBERTS,"City--9th Ward, 2nd Precinct",102,2,0,0,104,3106,45,3,0,3154
CITY COUNCIL,Gloria  MARTIN-ROBERTS,"City--9th Ward, 3rd Precinct",217,1,0,0,218,3106,45,3,0,3154
CITY COUNCIL,Gloria  MARTIN-ROBERTS,"City--9th Ward, 4th Precinct",112,0,0,0,112,3106,45,3,0,3154
CITY COUNCIL,Gloria  MARTIN-ROBERTS,"City--9th Ward, 5th Precinct",83,1,0,0,84,3106,45,3,0,3154
CITY COUNCIL,Gloria  MARTIN-ROBERTS,"City--10th Ward, 1st Precinct",197,1,0,0,198,3106,45,3,0,3154
CITY COUNCIL,Gloria  MARTIN-ROBERTS,"City--10th Ward, 2nd Precinct",125,0,0,0,125,3106,45,3,0,3154
CITY COUNCIL,Gloria  MARTIN-ROBERTS,"City--10th Ward, 3rd Precinct",44,0,0,0,44,3106,45,3,0,3154
CITY COUNCIL,Gloria  MARTIN-ROBERTS,"City--10th Ward, 4th Precinct",165,0,0,0,165,3106,45,3,0,3154
CITY COUNCIL,Gloria  MARTIN-ROBERTS,City--11th Ward,95,14,0,0,109,3106,45,3,0,3154
CITY COUNCIL,Gloria  MARTIN-ROBERTS,City--12th Ward,134,0,0,0,134,3106,45,3,0,3154
CITY COUNCIL,Gloria  MARTIN-ROBERTS,"City--13th Ward, 1st Precinct",94,0,0,0,94,3106,45,3,0,3154
CITY COUNCIL,Gloria  MARTIN-ROBERTS,"City--13th Ward, 2nd Precinct",110,1,0,0,111,3106,45,3,0,3154
CITY COUNCIL,Gloria  MARTIN-ROBERTS,"City--13th Ward, 3rd Precinct",134,1,0,0,135,3106,45,3,0,3154
CITY COUNCIL,Gloria  MARTIN-ROBERTS,City--14th Ward,149,3,0,0,152,3106,45,3,0,3154
CITY COUNCIL,Gloria  MARTIN-ROBERTS,City--15th Ward,95,1,0,0,96,3106,45,3,0,3154
CITY COUNCIL,Kelly D. SUMMERFORD,"City--1st Ward, 1st Precinct",19,2,0,0,21,1117,27,0,0,1144
CITY COUNCIL,Kelly D. SUMMERFORD,"City--1st Ward, 2nd Precinct",28,1,0,0,29,1117,27,0,0,1144
CITY COUNCIL,Kelly D. SUMMERFORD,"City--1st Ward, 3rd Precinct",18,0,0,0,18,1117,27,0,0,1144
CITY COUNCIL,Kelly D. SUMMERFORD,"City--2nd Ward, 1st Precinct",8,0,0,0,8,1117,27,0,0,1144
CITY COUNCIL,Kelly D. SUMMERFORD,"City--2nd Ward, 2nd Precinct",16,0,0,0,16,1117,27,0,0,1144
CITY COUNCIL,Kelly D. SUMMERFORD,City--3rd Ward,15,1,0,0,16,1117,27,0,0,1144
CITY COUNCIL,Kelly D. SUMMERFORD,City--4th Ward,39,0,0,0,39,1117,27,0,0,1144
CITY COUNCIL,Kelly D. SUMMERFORD,City--5th Ward,66,5,0,0,71,1117,27,0,0,1144
CITY COUNCIL,Kelly D. SUMMERFORD,City--6th Ward,42,1,0,0,43,1117,27,0,0,1144
CITY COUNCIL,Kelly D. SUMMERFORD,"City--7th Ward, 1st Precinct",20,1,0,0,21,1117,27,0,0,1144
CITY COUNCIL,Kelly D. SUMMERFORD,"City--7th Ward, 2nd Precinct",60,1,0,0,61,1117,27,0,0,1144
CITY COUNCIL,Kelly D. SUMMERFORD,City--8th Ward,69,0,0,0,69,1117,27,0,0,1144
CITY COUNCIL,Kelly D. SUMMERFORD,"City--9th Ward, 1st Precinct",20,0,0,0,20,1117,27,0,0,1144
CITY COUNCIL,Kelly D. SUMMERFORD,"City--9th Ward, 2nd Precinct",38,2,0,0,40,1117,27,0,0,1144
CITY COUNCIL,Kelly D. SUMMERFORD,"City--9th Ward, 3rd Precinct",93,2,0,0,95,1117,27,0,0,1144
CITY COUNCIL,Kelly D. SUMMERFORD,"City--9th Ward, 4th Precinct",36,2,0,0,38,1117,27,0,0,1144
CITY COUNCIL,Kelly D. SUMMERFORD,"City--9th Ward, 5th Precinct",29,1,0,0,30,1117,27,0,0,1144
CITY COUNCIL,Kelly D. SUMMERFORD,"City--10th Ward, 1st Precinct",81,2,0,0,83,1117,27,0,0,1144
CITY COUNCIL,Kelly D. SUMMERFORD,"City--10th Ward, 2nd Precinct",42,0,0,0,42,1117,27,0,0,1144
CITY COUNCIL,Kelly D. SUMMERFORD,"City--10th Ward, 3rd Precinct",13,0,0,0,13,1117,27,0,0,1144
CITY COUNCIL,Kelly D. SUMMERFORD,"City--10th Ward, 4th Precinct",62,0,0,0,62,1117,27,0,0,1144
CITY COUNCIL,Kelly D. SUMMERFORD,City--11th Ward,33,1,0,0,34,1117,27,0,0,1144
CITY COUNCIL,Kelly D. SUMMERFORD,City--12th Ward,64,2,0,0,66,1117,27,0,0,1144
CITY COUNCIL,Kelly D. SUMMERFORD,"City--13th Ward, 1st Precinct",31,0,0,0,31,1117,27,0,0,1144
CITY COUNCIL,Kelly D. SUMMERFORD,"City--13th Ward, 2nd Precinct",24,1,0,0,25,1117,27,0,0,1144
CITY COUNCIL,Kelly D. SUMMERFORD,"City--13th Ward, 3rd Precinct",69,1,0,0,70,1117,27,0,0,1144
CITY COUNCIL,Kelly D. SUMMERFORD,City--14th Ward,60,1,0,0,61,1117,27,0,0,1144
CITY COUNCIL,Kelly D. SUMMERFORD,City--15th Ward,22,0,0,0,22,1117,27,0,0,1144
CITY COUNCIL,Susan B. WILSON,"City--1st Ward, 1st Precinct",39,1,0,0,40,3013,44,3,0,3060
CITY COUNCIL,Susan B. WILSON,"City--1st Ward, 2nd Precinct",120,1,1,0,122,3013,44,3,0,3060
CITY COUNCIL,Susan B. WILSON,"City--1st Ward, 3rd Precinct",71,1,0,0,72,3013,44,3,0,3060
CITY COUNCIL,Susan B. WILSON,"City--2nd Ward, 1st Precinct",27,0,0,0,27,3013,44,3,0,3060
CITY COUNCIL,Susan B. WILSON,"City--2nd Ward, 2nd Precinct",58,0,0,0,58,3013,44,3,0,3060
CITY COUNCIL,Susan B. WILSON,City--3rd Ward,69,1,0,0,70,3013,44,3,0,3060
CITY COUNCIL,Susan B. WILSON,City--4th Ward,93,3,0,0,96,3013,44,3,0,3060
CITY COUNCIL,Susan B. WILSON,City--5th Ward,153,3,0,0,156,3013,44,3,0,3060
CITY COUNCIL,Susan B. WILSON,City--6th Ward,98,1,2,0,101,3013,44,3,0,3060
CITY COUNCIL,Susan B. WILSON,"City--7th Ward, 1st Precinct",49,0,0,0,49,3013,44,3,0,3060
CITY COUNCIL,Susan B. WILSON,"City--7th Ward, 2nd Precinct",190,0,0,0,190,3013,44,3,0,3060
CITY COUNCIL,Susan B. WILSON,City--8th Ward,182,3,0,0,185,3013,44,3,0,3060
CITY COUNCIL,Susan B. WILSON,"City--9th Ward, 1st Precinct",53,2,0,0,55,3013,44,3,0,3060
CITY COUNCIL,Susan B. WILSON,"City--9th Ward, 2nd Precinct",98,1,0,0,99,3013,44,3,0,3060
CITY COUNCIL,Susan B. WILSON,"City--9th Ward, 3rd Precinct",216,0,0,0,216,3013,44,3,0,3060
CITY COUNCIL,Susan B. WILSON,"City--9th Ward, 4th Precinct",112,0,0,0,112,3013,44,3,0,3060
CITY COUNCIL,Susan B. WILSON,"City--9th Ward, 5th Precinct",81,1,0,0,82,3013,44,3,0,3060
CITY COUNCIL,Susan B. WILSON,"City--10th Ward, 1st Precinct",200,3,0,0,203,3013,44,3,0,3060
CITY COUNCIL,Susan B. WILSON,"City--10th Ward, 2nd Precinct",125,0,0,0,125,3013,44,3,0,3060
CITY COUNCIL,Susan B. WILSON,"City--10th Ward, 3rd Precinct",46,0,0,0,46,3013,44,3,0,3060
CITY COUNCIL,Susan B. WILSON,"City--10th Ward, 4th Precinct",168,1,0,0,169,3013,44,3,0,3060
CITY COUNCIL,Susan B. WILSON,City--11th Ward,90,14,0,0,104,3013,44,3,0,3060
CITY COUNCIL,Susan B. WILSON,City--12th Ward,130,1,0,0,131,3013,44,3,0,3060
CITY COUNCIL,Susan B. WILSON,"City--13th Ward, 1st Precinct",78,0,0,0,78,3013,44,3,0,3060
CITY COUNCIL,Susan B. WILSON,"City--13th Ward, 2nd Precinct",104,1,0,0,105,3013,44,3,0,3060
CITY COUNCIL,Susan B. WILSON,"City--13th Ward, 3rd Precinct",128,1,0,0,129,3013,44,3,0,3060
CITY COUNCIL,Susan B. WILSON,City--14th Ward,147,4,0,0,151,3013,44,3,0,3060
CITY COUNCIL,Susan B. WILSON,City--15th Ward,88,1,0,0,89,3013,44,3,0,3060
CITY COUNCIL,Write In  ,"City--1st Ward, 1st Precinct",0,0,0,0,0,19,0,0,0,19
CITY COUNCIL,Write In  ,"City--1st Ward, 2nd Precinct",0,0,0,0,0,19,0,0,0,19
CITY COUNCIL,Write In  ,"City--1st Ward, 3rd Precinct",0,0,0,0,0,19,0,0,0,19
CITY COUNCIL,Write In  ,"City--2nd Ward, 1st Precinct",0,0,0,0,0,19,0,0,0,19
CITY COUNCIL,Write In  ,"City--2nd Ward, 2nd Precinct",0,0,0,0,0,19,0,0,0,19
CITY COUNCIL,Write In  ,City--3rd Ward,0,0,0,0,0,19,0,0,0,19
CITY COUNCIL,Write In  ,City--4th Ward,0,0,0,0,0,19,0,0,0,19
CITY COUNCIL,Write In  ,City--5th Ward,6,0,0,0,6,19,0,0,0,19
CITY COUNCIL,Write In  ,City--6th Ward,0,0,0,0,0,19,0,0,0,19
CITY COUNCIL,Write In  ,"City--7th Ward, 1st Precinct",0,0,0,0,0,19,0,0,0,19
CITY COUNCIL,Write In  ,"City--7th Ward, 2nd Precinct",1,0,0,0,1,19,0,0,0,19
CITY COUNCIL,Write In  ,City--8th Ward,0,0,0,0,0,19,0,0,0,19
CITY COUNCIL,Write In  ,"City--9th Ward, 1st Precinct",0,0,0,0,0,19,0,0,0,19
CITY COUNCIL,Write In  ,"City--9th Ward, 2nd Precinct",1,0,0,0,1,19,0,0,0,19
CITY COUNCIL,Write In  ,"City--9th Ward, 3rd Precinct",0,0,0,0,0,19,0,0,0,19
CITY COUNCIL,Write In  ,"City--9th Ward, 4th Precinct",0,0,0,0,0,19,0,0,0,19
CITY COUNCIL,Write In  ,"City--9th Ward, 5th Precinct",1,0,0,0,1,19,0,0,0,19
CITY COUNCIL,Write In  ,"City--10th Ward, 1st Precinct",0,0,0,0,0,19,0,0,0,19
CITY COUNCIL,Write In  ,"City--10th Ward, 2nd Precinct",1,0,0,0,1,19,0,0,0,19
CITY COUNCIL,Write In  ,"City--10th Ward, 3rd Precinct",0,0,0,0,0,19,0,0,0,19
CITY COUNCIL,Write In  ,"City--10th Ward, 4th Precinct",0,0,0,0,0,19,0,0,0,19
CITY COUNCIL,Write In  ,City--11th Ward,0,0,0,0,0,19,0,0,0,19
CITY COUNCIL,Write In  ,City--12th Ward,2,0,0,0,2,19,0,0,0,19
CITY COUNCIL,Write In  ,"City--13th Ward, 1st Precinct",4,0,0,0,4,19,0,0,0,19
CITY COUNCIL,Write In  ,"City--13th Ward, 2nd Precinct",0,0,0,0,0,19,0,0,0,19
CITY COUNCIL,Write In  ,"City--13th Ward, 3rd Precinct",2,0,0,0,2,19,0,0,0,19
CITY COUNCIL,Write In  ,City--14th Ward,1,0,0,0,1,19,0,0,0,19
CITY COUNCIL,Write In  ,City--15th Ward,0,0,0,0,0,19,0,0,0,19
CITY TREASURER,Paul  WAMBACH,"City--1st Ward, 1st Precinct",67,2,0,0,69,3376,87,3,0,3466
CITY TREASURER,Paul  WAMBACH,"City--1st Ward, 2nd Precinct",138,2,1,0,141,3376,87,3,0,3466
CITY TREASURER,Paul  WAMBACH,"City--1st Ward, 3rd Precinct",58,1,0,0,59,3376,87,3,0,3466
CITY TREASURER,Paul  WAMBACH,"City--2nd Ward, 1st Precinct",30,0,0,0,30,3376,87,3,0,3466
CITY TREASURER,Paul  WAMBACH,"City--2nd Ward, 2nd Precinct",66,1,0,0,67,3376,87,3,0,3466
CITY TREASURER,Paul  WAMBACH,City--3rd Ward,89,1,0,0,90,3376,87,3,0,3466
CITY TREASURER,Paul  WAMBACH,City--4th Ward,137,4,0,0,141,3376,87,3,0,3466
CITY TREASURER,Paul  WAMBACH,City--5th Ward,278,10,0,0,288,3376,87,3,0,3466
CITY TREASURER,Paul  WAMBACH,City--6th Ward,148,2,2,0,152,3376,87,3,0,3466
CITY TREASURER,Paul  WAMBACH,"City--7th Ward, 1st Precinct",45,4,0,0,49,3376,87,3,0,3466
CITY TREASURER,Paul  WAMBACH,"City--7th Ward, 2nd Precinct",130,2,0,0,132,3376,87,3,0,3466
CITY TREASURER,Paul  WAMBACH,City--8th Ward,130,1,0,0,131,3376,87,3,0,3466
CITY TREASURER,Paul  WAMBACH,"City--9th Ward, 1st Precinct",47,2,0,0,49,3376,87,3,0,3466
CITY TREASURER,Paul  WAMBACH,"City--9th Ward, 2nd Precinct",91,1,0,0,92,3376,87,3,0,3466
CITY TREASURER,Paul  WAMBACH,"City--9th Ward, 3rd Precinct",142,2,0,0,144,3376,87,3,0,3466
CITY TREASURER,Paul  WAMBACH,"City--9th Ward, 4th Precinct",147,4,0,0,151,3376,87,3,0,3466
CITY TREASURER,Paul  WAMBACH,"City--9th Ward, 5th Precinct",103,5,0,0,108,3376,87,3,0,3466
CITY TREASURER,Paul  WAMBACH,"City--10th Ward, 1st Precinct",194,3,0,0,197,3376,87,3,0,3466
CITY TREASURER,Paul  WAMBACH,"City--10th Ward, 2nd Precinct",85,0,0,0,85,3376,87,3,0,3466
CITY TREASURER,Paul  WAMBACH,"City--10th Ward, 3rd Precinct",76,1,0,0,77,3376,87,3,0,3466
CITY TREASURER,Paul  WAMBACH,"City--10th Ward, 4th Precinct",99,0,0,0,99,3376,87,3,0,3466
CITY TREASURER,Paul  WAMBACH,City--11th Ward,82,20,0,0,102,3376,87,3,0,3466
CITY TREASURER,Paul  WAMBACH,City--12th Ward,201,6,0,0,207,3376,87,3,0,3466
CITY TREASURER,Paul  WAMBACH,"City--13th Ward, 1st Precinct",105,0,0,0,105,3376,87,3,0,3466
CITY TREASURER,Paul  WAMBACH,"City--13th Ward, 2nd Precinct",140,4,0,0,144,3376,87,3,0,3466
CITY TREASURER,Paul  WAMBACH,"City--13th Ward, 3rd Precinct",173,2,0,0,175,3376,87,3,0,3466
CITY TREASURER,Paul  WAMBACH,City--14th Ward,293,7,0,0,300,3376,87,3,0,3466
CITY TREASURER,Paul  WAMBACH,City--15th Ward,82,0,0,0,82,3376,87,3,0,3466
CITY TREASURER,Write In  ,"City--1st Ward, 1st Precinct",0,0,0,0,0,7,0,0,0,7
CITY TREASURER,Write In  ,"City--1st Ward, 2nd Precinct",0,0,0,0,0,7,0,0,0,7
CITY TREASURER,Write In  ,"City--1st Ward, 3rd Precinct",0,0,0,0,0,7,0,0,0,7
CITY TREASURER,Write In  ,"City--2nd Ward, 1st Precinct",0,0,0,0,0,7,0,0,0,7
CITY TREASURER,Write In  ,"City--2nd Ward, 2nd Precinct",0,0,0,0,0,7,0,0,0,7
CITY TREASURER,Write In  ,City--3rd Ward,0,0,0,0,0,7,0,0,0,7
CITY TREASURER,Write In  ,City--4th Ward,1,0,0,0,1,7,0,0,0,7
CITY TREASURER,Write In  ,City--5th Ward,1,0,0,0,1,7,0,0,0,7
CITY TREASURER,Write In  ,City--6th Ward,0,0,0,0,0,7,0,0,0,7
CITY TREASURER,Write In  ,"City--7th Ward, 1st Precinct",0,0,0,0,0,7,0,0,0,7
CITY TREASURER,Write In  ,"City--7th Ward, 2nd Precinct",0,0,0,0,0,7,0,0,0,7
CITY TREASURER,Write In  ,City--8th Ward,0,0,0,0,0,7,0,0,0,7
CITY TREASURER,Write In  ,"City--9th Ward, 1st Precinct",0,0,0,0,0,7,0,0,0,7
CITY TREASURER,Write In  ,"City--9th Ward, 2nd Precinct",0,0,0,0,0,7,0,0,0,7
CITY TREASURER,Write In  ,"City--9th Ward, 3rd Precinct",0,0,0,0,0,7,0,0,0,7
CITY TREASURER,Write In  ,"City--9th Ward, 4th Precinct",0,0,0,0,0,7,0,0,0,7
CITY TREASURER,Write In  ,"City--9th Ward, 5th Precinct",1,0,0,0,1,7,0,0,0,7
CITY TREASURER,Write In  ,"City--10th Ward, 1st Precinct",0,0,0,0,0,7,0,0,0,7
CITY TREASURER,Write In  ,"City--10th Ward, 2nd Precinct",0,0,0,0,0,7,0,0,0,7
CITY TREASURER,Write In  ,"City--10th Ward, 3rd Precinct",0,0,0,0,0,7,0,0,0,7
CITY TREASURER,Write In  ,"City--10th Ward, 4th Precinct",0,0,0,0,0,7,0,0,0,7
CITY TREASURER,Write In  ,City--11th Ward,0,0,0,0,0,7,0,0,0,7
CITY TREASURER,Write In  ,City--12th Ward,1,0,0,0,1,7,0,0,0,7
CITY TREASURER,Write In  ,"City--13th Ward, 1st Precinct",0,0,0,0,0,7,0,0,0,7
CITY TREASURER,Write In  ,"City--13th Ward, 2nd Precinct",1,0,0,0,1,7,0,0,0,7
CITY TREASURER,Write In  ,"City--13th Ward, 3rd Precinct",1,0,0,0,1,7,0,0,0,7
CITY TREASURER,Write In  ,City--14th Ward,0,0,0,0,0,7,0,0,0,7
CITY TREASURER,Write In  ,City--15th Ward,1,0,0,0,1,7,0,0,0,7
CLERK OF COURTS,Lowell A. WITMER,"City--1st Ward, 1st Precinct",61,2,0,0,63,30787,647,18,0,31452
CLERK OF COURTS,Lowell A. WITMER,"City--1st Ward, 2nd Precinct",114,1,1,0,116,30787,647,18,0,31452
CLERK OF COURTS,Lowell A. WITMER,"City--1st Ward, 3rd Precinct",28,0,0,0,28,30787,647,18,0,31452
CLERK OF COURTS,Lowell A. WITMER,"City--2nd Ward, 1st Precinct",31,0,0,0,31,30787,647,18,0,31452
CLERK OF COURTS,Lowell A. WITMER,"City--2nd Ward, 2nd Precinct",42,1,0,0,43,30787,647,18,0,31452
CLERK OF COURTS,Lowell A. WITMER,City--3rd Ward,62,1,0,0,63,30787,647,18,0,31452
CLERK OF COURTS,Lowell A. WITMER,City--4th Ward,96,4,0,0,100,30787,647,18,0,31452
CLERK OF COURTS,Lowell A. WITMER,City--5th Ward,178,9,0,0,187,30787,647,18,0,31452
CLERK OF COURTS,Lowell A. WITMER,City--6th Ward,109,1,2,0,112,30787,647,18,0,31452
CLERK OF COURTS,Lowell A. WITMER,"City--7th Ward, 1st Precinct",34,1,0,0,35,30787,647,18,0,31452
CLERK OF COURTS,Lowell A. WITMER,"City--7th Ward, 2nd Precinct",55,2,0,0,57,30787,647,18,0,31452
CLERK OF COURTS,Lowell A. WITMER,City--8th Ward,51,1,0,0,52,30787,647,18,0,31452
CLERK OF COURTS,Lowell A. WITMER,"City--9th Ward, 1st Precinct",32,2,0,0,34,30787,647,18,0,31452
CLERK OF COURTS,Lowell A. WITMER,"City--9th Ward, 2nd Precinct",34,1,0,0,35,30787,647,18,0,31452
CLERK OF COURTS,Lowell A. WITMER,"City--9th Ward, 3rd Precinct",75,2,0,0,77,30787,647,18,0,31452
CLERK OF COURTS,Lowell A. WITMER,"City--9th Ward, 4th Precinct",140,4,0,0,144,30787,647,18,0,31452
CLERK OF COURTS,Lowell A. WITMER,"City--9th Ward, 5th Precinct",88,5,0,0,93,30787,647,18,0,31452
CLERK OF COURTS,Lowell A. WITMER,"City--10th Ward, 1st Precinct",128,6,0,0,134,30787,647,18,0,31452
CLERK OF COURTS,Lowell A. WITMER,"City--10th Ward, 2nd Precinct",41,0,0,0,41,30787,647,18,0,31452
CLERK OF COURTS,Lowell A. WITMER,"City--10th Ward, 3rd Precinct",80,1,0,0,81,30787,647,18,0,31452
CLERK OF COURTS,Lowell A. WITMER,"City--10th Ward, 4th Precinct",53,0,0,0,53,30787,647,18,0,31452
CLERK OF COURTS,Lowell A. WITMER,City--11th Ward,55,31,0,0,86,30787,647,18,0,31452
CLERK OF COURTS,Lowell A. WITMER,City--12th Ward,150,6,0,0,156,30787,647,18,0,31452
CLERK OF COURTS,Lowell A. WITMER,"City--13th Ward, 1st Precinct",91,0,0,0,91,30787,647,18,0,31452
CLERK OF COURTS,Lowell A. WITMER,"City--13th Ward, 2nd Precinct",131,4,0,0,135,30787,647,18,0,31452
CLERK OF COURTS,Lowell A. WITMER,"City--13th Ward, 3rd Precinct",134,2,0,0,136,30787,647,18,0,31452
CLERK OF COURTS,Lowell A. WITMER,City--14th Ward,244,3,0,0,247,30787,647,18,0,31452
CLERK OF COURTS,Lowell A. WITMER,City--15th Ward,39,0,0,0,39,30787,647,18,0,31452
CLERK OF COURTS,Lowell A. WITMER,Berrysburg Borough,58,0,0,0,58,30787,647,18,0,31452
CLERK OF COURTS,Lowell A. WITMER,Dauphin Borough,148,1,0,0,149,30787,647,18,0,31452
CLERK OF COURTS,Lowell A. WITMER,Elizabethville Borough,165,1,0,0,166,30787,647,18,0,31452
CLERK OF COURTS,Lowell A. WITMER,Gratz Borough,85,2,0,0,87,30787,647,18,0,31452
CLERK OF COURTS,Lowell A. WITMER,Halifax Borough,74,3,0,0,77,30787,647,18,0,31452
CLERK OF COURTS,Lowell A. WITMER,Highspire--1st Precinct,120,2,0,0,122,30787,647,18,0,31452
CLERK OF COURTS,Lowell A. WITMER,Highspire--2nd Precinct,140,1,0,0,141,30787,647,18,0,31452
CLERK OF COURTS,Lowell A. WITMER,Hummelstown--1st Precinct,188,4,0,0,192,30787,647,18,0,31452
CLERK OF COURTS,Lowell A. WITMER,Hummelstown--2nd Precinct,391,4,0,0,395,30787,647,18,0,31452
CLERK OF COURTS,Lowell A. WITMER,Lykens Borough--1st Ward,80,1,0,0,81,30787,647,18,0,31452
CLERK OF COURTS,Lowell A. WITMER,Lykens Borough--2nd Ward,115,4,0,0,119,30787,647,18,0,31452
CLERK OF COURTS,Lowell A. WITMER,"Middletown--1st Ward, 1st Precinct",84,0,0,0,84,30787,647,18,0,31452
CLERK OF COURTS,Lowell A. WITMER,"Middletown--1st Ward, 2nd Precinct",132,8,1,0,141,30787,647,18,0,31452
CLERK OF COURTS,Lowell A. WITMER,"Middletown--2nd Ward, 1st Precinct",145,0,0,0,145,30787,647,18,0,31452
CLERK OF COURTS,Lowell A. WITMER,"Middletown--2nd Ward, 2nd Precinct",148,6,0,0,154,30787,647,18,0,31452
CLERK OF COURTS,Lowell A. WITMER,"Middletown--3rd Ward, 1st Precinct",112,1,0,0,113,30787,647,18,0,31452
CLERK OF COURTS,Lowell A. WITMER,"Middletown--3rd Ward, 2nd Precinct",187,0,0,0,187,30787,647,18,0,31452
CLERK OF COURTS,Lowell A. WITMER,Millersburg--1st Ward,128,4,0,0,132,30787,647,18,0,31452
CLERK OF COURTS,Lowell A. WITMER,Millersburg--2nd Ward,180,4,0,0,184,30787,647,18,0,31452
CLERK OF COURTS,Lowell A. WITMER,Paxtang Borough,235,3,0,0,238,30787,647,18,0,31452
CLERK OF COURTS,Lowell A. WITMER,Penbrook Borough--1st Ward,51,1,0,0,52,30787,647,18,0,31452
CLERK OF COURTS,Lowell A. WITMER,Penbrook Borough--2nd Ward,65,1,0,0,66,30787,647,18,0,31452
CLERK OF COURTS,Lowell A. WITMER,Penbrook Borough--3rd Ward,73,0,0,0,73,30787,647,18,0,31452
CLERK OF COURTS,Lowell A. WITMER,Penbrook Borough--4th Ward,78,1,0,0,79,30787,647,18,0,31452
CLERK OF COURTS,Lowell A. WITMER,Royalton Borough--1st Ward,39,0,0,0,39,30787,647,18,0,31452
CLERK OF COURTS,Lowell A. WITMER,Royalton Borough--2nd Ward,76,0,0,0,76,30787,647,18,0,31452
CLERK OF COURTS,Lowell A. WITMER,Steelton--1st Ward,128,5,0,0,133,30787,647,18,0,31452
CLERK OF COURTS,Lowell A. WITMER,"Steelton--2nd Ward, 1st Precinct",80,2,0,0,82,30787,647,18,0,31452
CLERK OF COURTS,Lowell A. WITMER,"Steelton--2nd Ward, 2nd Precinct",77,1,0,0,78,30787,647,18,0,31452
CLERK OF COURTS,Lowell A. WITMER,"Steelton--3rd Ward, 1st Precinct",35,0,0,0,35,30787,647,18,0,31452
CLERK OF COURTS,Lowell A. WITMER,"Steelton--3rd Ward, 2nd Precinct",74,0,0,0,74,30787,647,18,0,31452
CLERK OF COURTS,Lowell A. WITMER,Steelton--4th Ward,70,2,1,0,73,30787,647,18,0,31452
CLERK OF COURTS,Lowell A. WITMER,Pillow Borough,46,0,0,0,46,30787,647,18,0,31452
CLERK OF COURTS,Lowell A. WITMER,Williamstown--1st Ward,87,1,0,0,88,30787,647,18,0,31452
CLERK OF COURTS,Lowell A. WITMER,Williamstown--2nd Ward,64,0,0,0,64,30787,647,18,0,31452
CLERK OF COURTS,Lowell A. WITMER,Conewago Twp--1st Precinct,251,1,0,0,252,30787,647,18,0,31452
CLERK OF COURTS,Lowell A. WITMER,Conewago Twp--2nd Precinct,196,7,0,0,203,30787,647,18,0,31452
CLERK OF COURTS,Lowell A. WITMER,Derry Township--1st Precinct,313,4,0,0,317,30787,647,18,0,31452
CLERK OF COURTS,Lowell A. WITMER,Derry Township--2nd Precinct,243,6,0,0,249,30787,647,18,0,31452
CLERK OF COURTS,Lowell A. WITMER,Derry Township--3rd Precinct,192,4,0,0,196,30787,647,18,0,31452
CLERK OF COURTS,Lowell A. WITMER,Derry Township--4th Precinct,163,5,0,0,168,30787,647,18,0,31452
CLERK OF COURTS,Lowell A. WITMER,Derry Township--5th Precinct,130,3,0,0,133,30787,647,18,0,31452
CLERK OF COURTS,Lowell A. WITMER,Derry Township--6th Precinct,156,1,1,0,158,30787,647,18,0,31452
CLERK OF COURTS,Lowell A. WITMER,Derry Township--7th Precinct,351,16,0,0,367,30787,647,18,0,31452
CLERK OF COURTS,Lowell A. WITMER,Derry Township--8th Precinct,167,0,0,0,167,30787,647,18,0,31452
CLERK OF COURTS,Lowell A. WITMER,Derry Township--9th Precinct,102,3,0,0,105,30787,647,18,0,31452
CLERK OF COURTS,Lowell A. WITMER,Derry Township--10th Precinct,242,4,0,0,246,30787,647,18,0,31452
CLERK OF COURTS,Lowell A. WITMER,Derry Township--11th Precinct,312,7,0,0,319,30787,647,18,0,31452
CLERK OF COURTS,Lowell A. WITMER,Derry Township--12th Precinct,173,2,0,0,175,30787,647,18,0,31452
CLERK OF COURTS,Lowell A. WITMER,Derry Township--13th Precinct,247,7,0,0,254,30787,647,18,0,31452
CLERK OF COURTS,Lowell A. WITMER,Derry Township--14th Precinct,170,3,0,0,173,30787,647,18,0,31452
CLERK OF COURTS,Lowell A. WITMER,Derry Township--15th Precinct,310,6,1,0,317,30787,647,18,0,31452
CLERK OF COURTS,Lowell A. WITMER,East Hanover Township--1st Precinct,332,9,0,0,341,30787,647,18,0,31452
CLERK OF COURTS,Lowell A. WITMER,East Hanover Township--2nd Precinct,375,5,0,0,380,30787,647,18,0,31452
CLERK OF COURTS,Lowell A. WITMER,Halifax Twp--1st Precinct,249,3,0,0,252,30787,647,18,0,31452
CLERK OF COURTS,Lowell A. WITMER,Halifax Twp--2nd Precinct,317,12,0,0,329,30787,647,18,0,31452
CLERK OF COURTS,Lowell A. WITMER,Jackson Township,217,1,0,0,218,30787,647,18,0,31452
CLERK OF COURTS,Lowell A. WITMER,Jefferson Township,60,0,0,0,60,30787,647,18,0,31452
CLERK OF COURTS,Lowell A. WITMER,Londonderry Twp--1st Precinct,281,0,0,0,281,30787,647,18,0,31452
CLERK OF COURTS,Lowell A. WITMER,Londonderry Twp--2nd Precinct,268,3,0,0,271,30787,647,18,0,31452
CLERK OF COURTS,Lowell A. WITMER,Londonderry Twp--3rd Precinct,113,1,0,0,114,30787,647,18,0,31452
CLERK OF COURTS,Lowell A. WITMER,Lower Paxton Twp--1st Precinct,204,2,0,0,206,30787,647,18,0,31452
CLERK OF COURTS,Lowell A. WITMER,Lower Paxton Twp--2nd Precinct,215,8,0,0,223,30787,647,18,0,31452
CLERK OF COURTS,Lowell A. WITMER,Lower Paxton Twp--3rd precinct,410,11,0,0,421,30787,647,18,0,31452
CLERK OF COURTS,Lowell A. WITMER,Lower Paxton Twp--4th Precinct,285,4,0,0,289,30787,647,18,0,31452
CLERK OF COURTS,Lowell A. WITMER,Lower Paxton Twp--5th Precinct,244,4,1,0,249,30787,647,18,0,31452
CLERK OF COURTS,Lowell A. WITMER,Lower Paxton Twp--6th Precinct,178,4,0,0,182,30787,647,18,0,31452
CLERK OF COURTS,Lowell A. WITMER,Lower Paxton Twp--7th Precinct,361,7,0,0,368,30787,647,18,0,31452
CLERK OF COURTS,Lowell A. WITMER,Lower Paxton Twp--8th Precinct,145,2,0,0,147,30787,647,18,0,31452
CLERK OF COURTS,Lowell A. WITMER,Lower Paxton Twp--9th Precinct,212,4,0,0,216,30787,647,18,0,31452
CLERK OF COURTS,Lowell A. WITMER,Lower Paxton Twp--10th Precinct,116,3,0,0,119,30787,647,18,0,31452
CLERK OF COURTS,Lowell A. WITMER,Lower Paxton Twp--11th Precinct,191,2,1,0,194,30787,647,18,0,31452
CLERK OF COURTS,Lowell A. WITMER,Lower Paxton Twp--12th Precinct,281,8,1,0,290,30787,647,18,0,31452
CLERK OF COURTS,Lowell A. WITMER,Lower Paxton Twp--13th Precinct,273,5,0,0,278,30787,647,18,0,31452
CLERK OF COURTS,Lowell A. WITMER,Lower Paxton Twp--14th Precinct,151,3,3,0,157,30787,647,18,0,31452
CLERK OF COURTS,Lowell A. WITMER,Lower Paxton Twp--15th Precinct,255,4,0,0,259,30787,647,18,0,31452
CLERK OF COURTS,Lowell A. WITMER,Lower Paxton Twp--16th Precinct,441,11,0,0,452,30787,647,18,0,31452
CLERK OF COURTS,Lowell A. WITMER,Lower Paxton Twp--17th Precinct,193,7,0,0,200,30787,647,18,0,31452
CLERK OF COURTS,Lowell A. WITMER,Lower Paxton Twp--18th Precinct,185,2,0,0,187,30787,647,18,0,31452
CLERK OF COURTS,Lowell A. WITMER,Lower Paxton Twp--19th Precinct,342,17,0,0,359,30787,647,18,0,31452
CLERK OF COURTS,Lowell A. WITMER,Lower Paxton Twp--20th Precinct,272,5,0,0,277,30787,647,18,0,31452
CLERK OF COURTS,Lowell A. WITMER,Lower Paxton Twp--21st Precinct,340,8,0,0,348,30787,647,18,0,31452
CLERK OF COURTS,Lowell A. WITMER,Lower Paxton Twp--22nd Precinct,297,5,0,0,302,30787,647,18,0,31452
CLERK OF COURTS,Lowell A. WITMER,Lower Paxton Twp--23rd Precinct,272,4,0,0,276,30787,647,18,0,31452
CLERK OF COURTS,Lowell A. WITMER,Lower Paxton Twp--24th Precinct,267,6,0,0,273,30787,647,18,0,31452
CLERK OF COURTS,Lowell A. WITMER,Lower Paxton Twp--25th Precinct,154,4,0,0,158,30787,647,18,0,31452
CLERK OF COURTS,Lowell A. WITMER,Lower Paxton Twp--26th Precinct,261,7,0,0,268,30787,647,18,0,31452
CLERK OF COURTS,Lowell A. WITMER,Lower Paxton Twp--27th Precinct,233,2,0,0,235,30787,647,18,0,31452
CLERK OF COURTS,Lowell A. WITMER,Lower Swatara Twp--1st Precinct,339,4,0,0,343,30787,647,18,0,31452
CLERK OF COURTS,Lowell A. WITMER,Lower Swatara Twp--2nd Precinct,280,7,0,0,287,30787,647,18,0,31452
CLERK OF COURTS,Lowell A. WITMER,Lower Swatara Twp--3rd Precinct,247,25,0,0,272,30787,647,18,0,31452
CLERK OF COURTS,Lowell A. WITMER,Lower Swatara Twp--4th Precinct,238,1,0,0,239,30787,647,18,0,31452
CLERK OF COURTS,Lowell A. WITMER,Lykens Township,95,0,0,0,95,30787,647,18,0,31452
CLERK OF COURTS,Lowell A. WITMER,Middle Paxton Twp--1st Precinct,319,0,0,0,319,30787,647,18,0,31452
CLERK OF COURTS,Lowell A. WITMER,Middle Paxton Twp--2nd Precinct,260,1,0,0,261,30787,647,18,0,31452
CLERK OF COURTS,Lowell A. WITMER,Middle Paxton Twp--3rd Precinct,360,2,0,0,362,30787,647,18,0,31452
CLERK OF COURTS,Lowell A. WITMER,Mifflin Township,84,0,0,0,84,30787,647,18,0,31452
CLERK OF COURTS,Lowell A. WITMER,Reed Township,42,0,0,0,42,30787,647,18,0,31452
CLERK OF COURTS,Lowell A. WITMER,Rush Township,37,0,0,0,37,30787,647,18,0,31452
CLERK OF COURTS,Lowell A. WITMER,South Hanover Twp--1st Precinct,276,5,0,0,281,30787,647,18,0,31452
CLERK OF COURTS,Lowell A. WITMER,South Hanover Twp--2nd Precinct,374,8,0,0,382,30787,647,18,0,31452
CLERK OF COURTS,Lowell A. WITMER,South Hanover Twp--3rd Precinct,220,1,0,0,221,30787,647,18,0,31452
CLERK OF COURTS,Lowell A. WITMER,Susquehanna Twp--1st Ward,375,15,0,0,390,30787,647,18,0,31452
CLERK OF COURTS,Lowell A. WITMER,Susquehanna Twp--2nd Ward,584,21,0,0,605,30787,647,18,0,31452
CLERK OF COURTS,Lowell A. WITMER,Susquehanna Twp--3rd Ward,207,0,0,0,207,30787,647,18,0,31452
CLERK OF COURTS,Lowell A. WITMER,Susquehanna Twp--4th Ward,257,5,0,0,262,30787,647,18,0,31452
CLERK OF COURTS,Lowell A. WITMER,Susquehanna Twp--5th Ward,277,7,0,0,284,30787,647,18,0,31452
CLERK OF COURTS,Lowell A. WITMER,Susquehanna Twp--6th Ward,360,9,0,0,369,30787,647,18,0,31452
CLERK OF COURTS,Lowell A. WITMER,Susquehanna Twp--7th Ward,168,0,0,0,168,30787,647,18,0,31452
CLERK OF COURTS,Lowell A. WITMER,Susquehanna Twp--8th Ward,454,16,0,0,470,30787,647,18,0,31452
CLERK OF COURTS,Lowell A. WITMER,Susquehanna Twp--9th Ward,314,4,0,0,318,30787,647,18,0,31452
CLERK OF COURTS,Lowell A. WITMER,Swatara Township--1st Ward,265,3,0,0,268,30787,647,18,0,31452
CLERK OF COURTS,Lowell A. WITMER,Swatara Township--2nd Ward,163,12,0,0,175,30787,647,18,0,31452
CLERK OF COURTS,Lowell A. WITMER,Swatara Township--3rd Ward,203,6,0,0,209,30787,647,18,0,31452
CLERK OF COURTS,Lowell A. WITMER,Swatara Township--4th Ward,307,8,0,0,315,30787,647,18,0,31452
CLERK OF COURTS,Lowell A. WITMER,Swatara Township--5th Ward,429,4,0,0,433,30787,647,18,0,31452
CLERK OF COURTS,Lowell A. WITMER,Swatara Township--6th Ward,375,2,1,0,378,30787,647,18,0,31452
CLERK OF COURTS,Lowell A. WITMER,Swatara Township--7th Ward,382,10,0,0,392,30787,647,18,0,31452
CLERK OF COURTS,Lowell A. WITMER,Swatara Township--8th Ward,453,5,1,0,459,30787,647,18,0,31452
CLERK OF COURTS,Lowell A. WITMER,Swatara Township--9th Ward,170,9,0,0,179,30787,647,18,0,31452
CLERK OF COURTS,Lowell A. WITMER,Upper Paxton Twp--1st Precinct,288,3,0,0,291,30787,647,18,0,31452
CLERK OF COURTS,Lowell A. WITMER,Upper Paxton Twp--2nd Precinct,182,2,0,0,184,30787,647,18,0,31452
CLERK OF COURTS,Lowell A. WITMER,Washington Township,263,7,0,0,270,30787,647,18,0,31452
CLERK OF COURTS,Lowell A. WITMER,Wayne Township,234,0,1,0,235,30787,647,18,0,31452
CLERK OF COURTS,Lowell A. WITMER,West Hanover Twp--1st Precinct,296,4,0,0,300,30787,647,18,0,31452
CLERK OF COURTS,Lowell A. WITMER,West Hanover Twp--2nd Precinct,282,7,1,0,290,30787,647,18,0,31452
CLERK OF COURTS,Lowell A. WITMER,West Hanover Twp--3rd Precinct,654,16,1,0,671,30787,647,18,0,31452
CLERK OF COURTS,Lowell A. WITMER,West Hanover Twp--4th Precinct,371,1,0,0,372,30787,647,18,0,31452
CLERK OF COURTS,Lowell A. WITMER,Wiconisco Twp--1st Precinct,73,1,0,0,74,30787,647,18,0,31452
CLERK OF COURTS,Lowell A. WITMER,Wiconisco Twp--2nd Precinct,56,1,0,0,57,30787,647,18,0,31452
CLERK OF COURTS,Lowell A. WITMER,Williams Twp,132,0,0,0,132,30787,647,18,0,31452
CLERK OF COURTS,Write In  ,"City--1st Ward, 1st Precinct",0,0,0,0,0,36,0,0,0,36
CLERK OF COURTS,Write In  ,"City--1st Ward, 2nd Precinct",0,0,0,0,0,36,0,0,0,36
CLERK OF COURTS,Write In  ,"City--1st Ward, 3rd Precinct",0,0,0,0,0,36,0,0,0,36
CLERK OF COURTS,Write In  ,"City--2nd Ward, 1st Precinct",0,0,0,0,0,36,0,0,0,36
CLERK OF COURTS,Write In  ,"City--2nd Ward, 2nd Precinct",0,0,0,0,0,36,0,0,0,36
CLERK OF COURTS,Write In  ,City--3rd Ward,0,0,0,0,0,36,0,0,0,36
CLERK OF COURTS,Write In  ,City--4th Ward,0,0,0,0,0,36,0,0,0,36
CLERK OF COURTS,Write In  ,City--5th Ward,1,0,0,0,1,36,0,0,0,36
CLERK OF COURTS,Write In  ,City--6th Ward,1,0,0,0,1,36,0,0,0,36
CLERK OF COURTS,Write In  ,"City--7th Ward, 1st Precinct",0,0,0,0,0,36,0,0,0,36
CLERK OF COURTS,Write In  ,"City--7th Ward, 2nd Precinct",0,0,0,0,0,36,0,0,0,36
CLERK OF COURTS,Write In  ,City--8th Ward,1,0,0,0,1,36,0,0,0,36
CLERK OF COURTS,Write In  ,"City--9th Ward, 1st Precinct",0,0,0,0,0,36,0,0,0,36
CLERK OF COURTS,Write In  ,"City--9th Ward, 2nd Precinct",1,0,0,0,1,36,0,0,0,36
CLERK OF COURTS,Write In  ,"City--9th Ward, 3rd Precinct",1,0,0,0,1,36,0,0,0,36
CLERK OF COURTS,Write In  ,"City--9th Ward, 4th Precinct",0,0,0,0,0,36,0,0,0,36
CLERK OF COURTS,Write In  ,"City--9th Ward, 5th Precinct",0,0,0,0,0,36,0,0,0,36
CLERK OF COURTS,Write In  ,"City--10th Ward, 1st Precinct",0,0,0,0,0,36,0,0,0,36
CLERK OF COURTS,Write In  ,"City--10th Ward, 2nd Precinct",0,0,0,0,0,36,0,0,0,36
CLERK OF COURTS,Write In  ,"City--10th Ward, 3rd Precinct",1,0,0,0,1,36,0,0,0,36
CLERK OF COURTS,Write In  ,"City--10th Ward, 4th Precinct",1,0,0,0,1,36,0,0,0,36
CLERK OF COURTS,Write In  ,City--11th Ward,0,0,0,0,0,36,0,0,0,36
CLERK OF COURTS,Write In  ,City--12th Ward,0,0,0,0,0,36,0,0,0,36
CLERK OF COURTS,Write In  ,"City--13th Ward, 1st Precinct",1,0,0,0,1,36,0,0,0,36
CLERK OF COURTS,Write In  ,"City--13th Ward, 2nd Precinct",0,0,0,0,0,36,0,0,0,36
CLERK OF COURTS,Write In  ,"City--13th Ward, 3rd Precinct",0,0,0,0,0,36,0,0,0,36
CLERK OF COURTS,Write In  ,City--14th Ward,1,0,0,0,1,36,0,0,0,36
CLERK OF COURTS,Write In  ,City--15th Ward,0,0,0,0,0,36,0,0,0,36
CLERK OF COURTS,Write In  ,Berrysburg Borough,0,0,0,0,0,36,0,0,0,36
CLERK OF COURTS,Write In  ,Dauphin Borough,0,0,0,0,0,36,0,0,0,36
CLERK OF COURTS,Write In  ,Elizabethville Borough,0,0,0,0,0,36,0,0,0,36
CLERK OF COURTS,Write In  ,Gratz Borough,0,0,0,0,0,36,0,0,0,36
CLERK OF COURTS,Write In  ,Halifax Borough,1,0,0,0,1,36,0,0,0,36
CLERK OF COURTS,Write In  ,Highspire--1st Precinct,0,0,0,0,0,36,0,0,0,36
CLERK OF COURTS,Write In  ,Highspire--2nd Precinct,0,0,0,0,0,36,0,0,0,36
CLERK OF COURTS,Write In  ,Hummelstown--1st Precinct,0,0,0,0,0,36,0,0,0,36
CLERK OF COURTS,Write In  ,Hummelstown--2nd Precinct,0,0,0,0,0,36,0,0,0,36
CLERK OF COURTS,Write In  ,Lykens Borough--1st Ward,0,0,0,0,0,36,0,0,0,36
CLERK OF COURTS,Write In  ,Lykens Borough--2nd Ward,0,0,0,0,0,36,0,0,0,36
CLERK OF COURTS,Write In  ,"Middletown--1st Ward, 1st Precinct",0,0,0,0,0,36,0,0,0,36
CLERK OF COURTS,Write In  ,"Middletown--1st Ward, 2nd Precinct",0,0,0,0,0,36,0,0,0,36
CLERK OF COURTS,Write In  ,"Middletown--2nd Ward, 1st Precinct",0,0,0,0,0,36,0,0,0,36
CLERK OF COURTS,Write In  ,"Middletown--2nd Ward, 2nd Precinct",0,0,0,0,0,36,0,0,0,36
CLERK OF COURTS,Write In  ,"Middletown--3rd Ward, 1st Precinct",0,0,0,0,0,36,0,0,0,36
CLERK OF COURTS,Write In  ,"Middletown--3rd Ward, 2nd Precinct",0,0,0,0,0,36,0,0,0,36
CLERK OF COURTS,Write In  ,Millersburg--1st Ward,0,0,0,0,0,36,0,0,0,36
CLERK OF COURTS,Write In  ,Millersburg--2nd Ward,0,0,0,0,0,36,0,0,0,36
CLERK OF COURTS,Write In  ,Paxtang Borough,0,0,0,0,0,36,0,0,0,36
CLERK OF COURTS,Write In  ,Penbrook Borough--1st Ward,0,0,0,0,0,36,0,0,0,36
CLERK OF COURTS,Write In  ,Penbrook Borough--2nd Ward,0,0,0,0,0,36,0,0,0,36
CLERK OF COURTS,Write In  ,Penbrook Borough--3rd Ward,0,0,0,0,0,36,0,0,0,36
CLERK OF COURTS,Write In  ,Penbrook Borough--4th Ward,0,0,0,0,0,36,0,0,0,36
CLERK OF COURTS,Write In  ,Royalton Borough--1st Ward,0,0,0,0,0,36,0,0,0,36
CLERK OF COURTS,Write In  ,Royalton Borough--2nd Ward,0,0,0,0,0,36,0,0,0,36
CLERK OF COURTS,Write In  ,Steelton--1st Ward,0,0,0,0,0,36,0,0,0,36
CLERK OF COURTS,Write In  ,"Steelton--2nd Ward, 1st Precinct",0,0,0,0,0,36,0,0,0,36
CLERK OF COURTS,Write In  ,"Steelton--2nd Ward, 2nd Precinct",0,0,0,0,0,36,0,0,0,36
CLERK OF COURTS,Write In  ,"Steelton--3rd Ward, 1st Precinct",0,0,0,0,0,36,0,0,0,36
CLERK OF COURTS,Write In  ,"Steelton--3rd Ward, 2nd Precinct",1,0,0,0,1,36,0,0,0,36
CLERK OF COURTS,Write In  ,Steelton--4th Ward,0,0,0,0,0,36,0,0,0,36
CLERK OF COURTS,Write In  ,Pillow Borough,0,0,0,0,0,36,0,0,0,36
CLERK OF COURTS,Write In  ,Williamstown--1st Ward,0,0,0,0,0,36,0,0,0,36
CLERK OF COURTS,Write In  ,Williamstown--2nd Ward,0,0,0,0,0,36,0,0,0,36
CLERK OF COURTS,Write In  ,Conewago Twp--1st Precinct,0,0,0,0,0,36,0,0,0,36
CLERK OF COURTS,Write In  ,Conewago Twp--2nd Precinct,1,0,0,0,1,36,0,0,0,36
CLERK OF COURTS,Write In  ,Derry Township--1st Precinct,0,0,0,0,0,36,0,0,0,36
CLERK OF COURTS,Write In  ,Derry Township--2nd Precinct,0,0,0,0,0,36,0,0,0,36
CLERK OF COURTS,Write In  ,Derry Township--3rd Precinct,0,0,0,0,0,36,0,0,0,36
CLERK OF COURTS,Write In  ,Derry Township--4th Precinct,1,0,0,0,1,36,0,0,0,36
CLERK OF COURTS,Write In  ,Derry Township--5th Precinct,0,0,0,0,0,36,0,0,0,36
CLERK OF COURTS,Write In  ,Derry Township--6th Precinct,0,0,0,0,0,36,0,0,0,36
CLERK OF COURTS,Write In  ,Derry Township--7th Precinct,0,0,0,0,0,36,0,0,0,36
CLERK OF COURTS,Write In  ,Derry Township--8th Precinct,0,0,0,0,0,36,0,0,0,36
CLERK OF COURTS,Write In  ,Derry Township--9th Precinct,0,0,0,0,0,36,0,0,0,36
CLERK OF COURTS,Write In  ,Derry Township--10th Precinct,0,0,0,0,0,36,0,0,0,36
CLERK OF COURTS,Write In  ,Derry Township--11th Precinct,0,0,0,0,0,36,0,0,0,36
CLERK OF COURTS,Write In  ,Derry Township--12th Precinct,0,0,0,0,0,36,0,0,0,36
CLERK OF COURTS,Write In  ,Derry Township--13th Precinct,0,0,0,0,0,36,0,0,0,36
CLERK OF COURTS,Write In  ,Derry Township--14th Precinct,0,0,0,0,0,36,0,0,0,36
CLERK OF COURTS,Write In  ,Derry Township--15th Precinct,2,0,0,0,2,36,0,0,0,36
CLERK OF COURTS,Write In  ,East Hanover Township--1st Precinct,0,0,0,0,0,36,0,0,0,36
CLERK OF COURTS,Write In  ,East Hanover Township--2nd Precinct,0,0,0,0,0,36,0,0,0,36
CLERK OF COURTS,Write In  ,Halifax Twp--1st Precinct,0,0,0,0,0,36,0,0,0,36
CLERK OF COURTS,Write In  ,Halifax Twp--2nd Precinct,0,0,0,0,0,36,0,0,0,36
CLERK OF COURTS,Write In  ,Jackson Township,0,0,0,0,0,36,0,0,0,36
CLERK OF COURTS,Write In  ,Jefferson Township,0,0,0,0,0,36,0,0,0,36
CLERK OF COURTS,Write In  ,Londonderry Twp--1st Precinct,0,0,0,0,0,36,0,0,0,36
CLERK OF COURTS,Write In  ,Londonderry Twp--2nd Precinct,1,0,0,0,1,36,0,0,0,36
CLERK OF COURTS,Write In  ,Londonderry Twp--3rd Precinct,0,0,0,0,0,36,0,0,0,36
CLERK OF COURTS,Write In  ,Lower Paxton Twp--1st Precinct,0,0,0,0,0,36,0,0,0,36
CLERK OF COURTS,Write In  ,Lower Paxton Twp--2nd Precinct,1,0,0,0,1,36,0,0,0,36
CLERK OF COURTS,Write In  ,Lower Paxton Twp--3rd precinct,0,0,0,0,0,36,0,0,0,36
CLERK OF COURTS,Write In  ,Lower Paxton Twp--4th Precinct,0,0,0,0,0,36,0,0,0,36
CLERK OF COURTS,Write In  ,Lower Paxton Twp--5th Precinct,0,0,0,0,0,36,0,0,0,36
CLERK OF COURTS,Write In  ,Lower Paxton Twp--6th Precinct,0,0,0,0,0,36,0,0,0,36
CLERK OF COURTS,Write In  ,Lower Paxton Twp--7th Precinct,1,0,0,0,1,36,0,0,0,36
CLERK OF COURTS,Write In  ,Lower Paxton Twp--8th Precinct,0,0,0,0,0,36,0,0,0,36
CLERK OF COURTS,Write In  ,Lower Paxton Twp--9th Precinct,0,0,0,0,0,36,0,0,0,36
CLERK OF COURTS,Write In  ,Lower Paxton Twp--10th Precinct,1,0,0,0,1,36,0,0,0,36
CLERK OF COURTS,Write In  ,Lower Paxton Twp--11th Precinct,0,0,0,0,0,36,0,0,0,36
CLERK OF COURTS,Write In  ,Lower Paxton Twp--12th Precinct,2,0,0,0,2,36,0,0,0,36
CLERK OF COURTS,Write In  ,Lower Paxton Twp--13th Precinct,0,0,0,0,0,36,0,0,0,36
CLERK OF COURTS,Write In  ,Lower Paxton Twp--14th Precinct,0,0,0,0,0,36,0,0,0,36
CLERK OF COURTS,Write In  ,Lower Paxton Twp--15th Precinct,0,0,0,0,0,36,0,0,0,36
CLERK OF COURTS,Write In  ,Lower Paxton Twp--16th Precinct,0,0,0,0,0,36,0,0,0,36
CLERK OF COURTS,Write In  ,Lower Paxton Twp--17th Precinct,0,0,0,0,0,36,0,0,0,36
CLERK OF COURTS,Write In  ,Lower Paxton Twp--18th Precinct,0,0,0,0,0,36,0,0,0,36
CLERK OF COURTS,Write In  ,Lower Paxton Twp--19th Precinct,0,0,0,0,0,36,0,0,0,36
CLERK OF COURTS,Write In  ,Lower Paxton Twp--20th Precinct,0,0,0,0,0,36,0,0,0,36
CLERK OF COURTS,Write In  ,Lower Paxton Twp--21st Precinct,0,0,0,0,0,36,0,0,0,36
CLERK OF COURTS,Write In  ,Lower Paxton Twp--22nd Precinct,1,0,0,0,1,36,0,0,0,36
CLERK OF COURTS,Write In  ,Lower Paxton Twp--23rd Precinct,0,0,0,0,0,36,0,0,0,36
CLERK OF COURTS,Write In  ,Lower Paxton Twp--24th Precinct,0,0,0,0,0,36,0,0,0,36
CLERK OF COURTS,Write In  ,Lower Paxton Twp--25th Precinct,0,0,0,0,0,36,0,0,0,36
CLERK OF COURTS,Write In  ,Lower Paxton Twp--26th Precinct,0,0,0,0,0,36,0,0,0,36
CLERK OF COURTS,Write In  ,Lower Paxton Twp--27th Precinct,0,0,0,0,0,36,0,0,0,36
CLERK OF COURTS,Write In  ,Lower Swatara Twp--1st Precinct,0,0,0,0,0,36,0,0,0,36
CLERK OF COURTS,Write In  ,Lower Swatara Twp--2nd Precinct,1,0,0,0,1,36,0,0,0,36
CLERK OF COURTS,Write In  ,Lower Swatara Twp--3rd Precinct,0,0,0,0,0,36,0,0,0,36
CLERK OF COURTS,Write In  ,Lower Swatara Twp--4th Precinct,0,0,0,0,0,36,0,0,0,36
CLERK OF COURTS,Write In  ,Lykens Township,0,0,0,0,0,36,0,0,0,36
CLERK OF COURTS,Write In  ,Middle Paxton Twp--1st Precinct,0,0,0,0,0,36,0,0,0,36
CLERK OF COURTS,Write In  ,Middle Paxton Twp--2nd Precinct,0,0,0,0,0,36,0,0,0,36
CLERK OF COURTS,Write In  ,Middle Paxton Twp--3rd Precinct,0,0,0,0,0,36,0,0,0,36
CLERK OF COURTS,Write In  ,Mifflin Township,0,0,0,0,0,36,0,0,0,36
CLERK OF COURTS,Write In  ,Reed Township,0,0,0,0,0,36,0,0,0,36
CLERK OF COURTS,Write In  ,Rush Township,0,0,0,0,0,36,0,0,0,36
CLERK OF COURTS,Write In  ,South Hanover Twp--1st Precinct,0,0,0,0,0,36,0,0,0,36
CLERK OF COURTS,Write In  ,South Hanover Twp--2nd Precinct,0,0,0,0,0,36,0,0,0,36
CLERK OF COURTS,Write In  ,South Hanover Twp--3rd Precinct,0,0,0,0,0,36,0,0,0,36
CLERK OF COURTS,Write In  ,Susquehanna Twp--1st Ward,1,0,0,0,1,36,0,0,0,36
CLERK OF COURTS,Write In  ,Susquehanna Twp--2nd Ward,2,0,0,0,2,36,0,0,0,36
CLERK OF COURTS,Write In  ,Susquehanna Twp--3rd Ward,1,0,0,0,1,36,0,0,0,36
CLERK OF COURTS,Write In  ,Susquehanna Twp--4th Ward,2,0,0,0,2,36,0,0,0,36
CLERK OF COURTS,Write In  ,Susquehanna Twp--5th Ward,1,0,0,0,1,36,0,0,0,36
CLERK OF COURTS,Write In  ,Susquehanna Twp--6th Ward,0,0,0,0,0,36,0,0,0,36
CLERK OF COURTS,Write In  ,Susquehanna Twp--7th Ward,0,0,0,0,0,36,0,0,0,36
CLERK OF COURTS,Write In  ,Susquehanna Twp--8th Ward,0,0,0,0,0,36,0,0,0,36
CLERK OF COURTS,Write In  ,Susquehanna Twp--9th Ward,1,0,0,0,1,36,0,0,0,36
CLERK OF COURTS,Write In  ,Swatara Township--1st Ward,0,0,0,0,0,36,0,0,0,36
CLERK OF COURTS,Write In  ,Swatara Township--2nd Ward,1,0,0,0,1,36,0,0,0,36
CLERK OF COURTS,Write In  ,Swatara Township--3rd Ward,0,0,0,0,0,36,0,0,0,36
CLERK OF COURTS,Write In  ,Swatara Township--4th Ward,1,0,0,0,1,36,0,0,0,36
CLERK OF COURTS,Write In  ,Swatara Township--5th Ward,0,0,0,0,0,36,0,0,0,36
CLERK OF COURTS,Write In  ,Swatara Township--6th Ward,0,0,0,0,0,36,0,0,0,36
CLERK OF COURTS,Write In  ,Swatara Township--7th Ward,0,0,0,0,0,36,0,0,0,36
CLERK OF COURTS,Write In  ,Swatara Township--8th Ward,0,0,0,0,0,36,0,0,0,36
CLERK OF COURTS,Write In  ,Swatara Township--9th Ward,0,0,0,0,0,36,0,0,0,36
CLERK OF COURTS,Write In  ,Upper Paxton Twp--1st Precinct,1,0,0,0,1,36,0,0,0,36
CLERK OF COURTS,Write In  ,Upper Paxton Twp--2nd Precinct,0,0,0,0,0,36,0,0,0,36
CLERK OF COURTS,Write In  ,Washington Township,0,0,0,0,0,36,0,0,0,36
CLERK OF COURTS,Write In  ,Wayne Township,0,0,0,0,0,36,0,0,0,36
CLERK OF COURTS,Write In  ,West Hanover Twp--1st Precinct,0,0,0,0,0,36,0,0,0,36
CLERK OF COURTS,Write In  ,West Hanover Twp--2nd Precinct,1,0,0,0,1,36,0,0,0,36
CLERK OF COURTS,Write In  ,West Hanover Twp--3rd Precinct,1,0,0,0,1,36,0,0,0,36
CLERK OF COURTS,Write In  ,West Hanover Twp--4th Precinct,0,0,0,0,0,36,0,0,0,36
CLERK OF COURTS,Write In  ,Wiconisco Twp--1st Precinct,0,0,0,0,0,36,0,0,0,36
CLERK OF COURTS,Write In  ,Wiconisco Twp--2nd Precinct,0,0,0,0,0,36,0,0,0,36
CLERK OF COURTS,Write In  ,Williams Twp,0,0,0,0,0,36,0,0,0,36
COUNCIL  HUMMELSTOWN,Brian K. FOSTER,Hummelstown--1st Precinct,165,4,0,0,169,529,8,0,0,537
COUNCIL  HUMMELSTOWN,Brian K. FOSTER,Hummelstown--2nd Precinct,364,4,0,0,368,529,8,0,0,537
COUNCIL  HUMMELSTOWN,David S. ROETING,Hummelstown--1st Precinct,174,4,0,0,178,555,8,0,0,563
COUNCIL  HUMMELSTOWN,David S. ROETING,Hummelstown--2nd Precinct,381,4,0,0,385,555,8,0,0,563
COUNCIL  HUMMELSTOWN,Robert L. JONES,Hummelstown--1st Precinct,169,4,0,0,173,529,8,0,0,537
COUNCIL  HUMMELSTOWN,Robert L. JONES,Hummelstown--2nd Precinct,360,4,0,0,364,529,8,0,0,537
COUNCIL  HUMMELSTOWN,Write In  ,Hummelstown--1st Precinct,0,0,0,0,0,0,0,0,0,0
COUNCIL  HUMMELSTOWN,Write In  ,Hummelstown--2nd Precinct,0,0,0,0,0,0,0,0,0,0
COUNCIL  MDLT 1,Scott  SITES,"Middletown--1st Ward, 1st Precinct",75,0,0,0,75,200,7,0,0,207
COUNCIL  MDLT 1,Scott  SITES,"Middletown--1st Ward, 2nd Precinct",125,7,0,0,132,200,7,0,0,207
COUNCIL  MDLT 1,Write In  ,"Middletown--1st Ward, 1st Precinct",0,0,0,0,0,0,0,0,0,0
COUNCIL  MDLT 1,Write In  ,"Middletown--1st Ward, 2nd Precinct",0,0,0,0,0,0,0,0,0,0
COUNCIL  STEELTON,Dennis  HEEFNER,Steelton--1st Ward,99,5,0,0,104,377,7,0,0,384
COUNCIL  STEELTON,Dennis  HEEFNER,"Steelton--2nd Ward, 1st Precinct",60,1,0,0,61,377,7,0,0,384
COUNCIL  STEELTON,Dennis  HEEFNER,"Steelton--2nd Ward, 2nd Precinct",67,1,0,0,68,377,7,0,0,384
COUNCIL  STEELTON,Dennis  HEEFNER,"Steelton--3rd Ward, 1st Precinct",31,0,0,0,31,377,7,0,0,384
COUNCIL  STEELTON,Dennis  HEEFNER,"Steelton--3rd Ward, 2nd Precinct",64,0,0,0,64,377,7,0,0,384
COUNCIL  STEELTON,Dennis  HEEFNER,Steelton--4th Ward,56,0,0,0,56,377,7,0,0,384
COUNCIL  STEELTON,Maryjo  SZADA,Steelton--1st Ward,109,4,0,0,113,503,7,0,0,510
COUNCIL  STEELTON,Maryjo  SZADA,"Steelton--2nd Ward, 1st Precinct",105,0,0,0,105,503,7,0,0,510
COUNCIL  STEELTON,Maryjo  SZADA,"Steelton--2nd Ward, 2nd Precinct",56,1,0,0,57,503,7,0,0,510
COUNCIL  STEELTON,Maryjo  SZADA,"Steelton--3rd Ward, 1st Precinct",43,0,0,0,43,503,7,0,0,510
COUNCIL  STEELTON,Maryjo  SZADA,"Steelton--3rd Ward, 2nd Precinct",91,0,0,0,91,503,7,0,0,510
COUNCIL  STEELTON,Maryjo  SZADA,Steelton--4th Ward,99,2,0,0,101,503,7,0,0,510
COUNCIL  STEELTON,Michael K. ALBERT,Steelton--1st Ward,112,6,0,0,118,422,9,0,0,431
COUNCIL  STEELTON,Michael K. ALBERT,"Steelton--2nd Ward, 1st Precinct",71,2,0,0,73,422,9,0,0,431
COUNCIL  STEELTON,Michael K. ALBERT,"Steelton--2nd Ward, 2nd Precinct",61,1,0,0,62,422,9,0,0,431
COUNCIL  STEELTON,Michael K. ALBERT,"Steelton--3rd Ward, 1st Precinct",40,0,0,0,40,422,9,0,0,431
COUNCIL  STEELTON,Michael K. ALBERT,"Steelton--3rd Ward, 2nd Precinct",73,0,0,0,73,422,9,0,0,431
COUNCIL  STEELTON,Michael K. ALBERT,Steelton--4th Ward,65,0,0,0,65,422,9,0,0,431
COUNCIL  STEELTON,Stephen J. SHAVER,Steelton--1st Ward,110,5,0,0,115,385,8,0,0,393
COUNCIL  STEELTON,Stephen J. SHAVER,"Steelton--2nd Ward, 1st Precinct",73,1,0,0,74,385,8,0,0,393
COUNCIL  STEELTON,Stephen J. SHAVER,"Steelton--2nd Ward, 2nd Precinct",57,1,0,0,58,385,8,0,0,393
COUNCIL  STEELTON,Stephen J. SHAVER,"Steelton--3rd Ward, 1st Precinct",31,0,0,0,31,385,8,0,0,393
COUNCIL  STEELTON,Stephen J. SHAVER,"Steelton--3rd Ward, 2nd Precinct",61,0,0,0,61,385,8,0,0,393
COUNCIL  STEELTON,Stephen J. SHAVER,Steelton--4th Ward,53,1,0,0,54,385,8,0,0,393
COUNCIL  STEELTON,Write In  ,Steelton--1st Ward,0,0,0,0,0,0,0,0,0,0
COUNCIL  STEELTON,Write In  ,"Steelton--2nd Ward, 1st Precinct",0,0,0,0,0,0,0,0,0,0
COUNCIL  STEELTON,Write In  ,"Steelton--2nd Ward, 2nd Precinct",0,0,0,0,0,0,0,0,0,0
COUNCIL  STEELTON,Write In  ,"Steelton--3rd Ward, 1st Precinct",0,0,0,0,0,0,0,0,0,0
COUNCIL  STEELTON,Write In  ,"Steelton--3rd Ward, 2nd Precinct",0,0,0,0,0,0,0,0,0,0
COUNCIL  STEELTON,Write In  ,Steelton--4th Ward,0,0,0,0,0,0,0,0,0,0
COUNCIL 2YR  ROYALTON 1,Write In  ,Royalton Borough--1st Ward,0,0,0,0,0,0,0,0,0,0
COUNCIL 2YR DAUPHIN,Jody A. SEARIGHT,Dauphin Borough,111,0,0,0,111,111,0,0,0,111
COUNCIL 2YR DAUPHIN,Write In  ,Dauphin Borough,3,0,0,0,3,3,0,0,0,3
COUNCIL 2YR EVILLE,Write In  ,Elizabethville Borough,2,0,0,0,2,2,0,0,0,2
COUNCIL 2YR LYKENS 1,Write In  ,Lykens Borough--1st Ward,12,0,0,0,12,12,0,0,0,12
COUNCIL 2YR MDLT 2,Sandra  NAGLE,"Middletown--2nd Ward, 1st Precinct",135,2,0,0,137,290,6,0,0,296
COUNCIL 2YR MDLT 2,Sandra  NAGLE,"Middletown--2nd Ward, 2nd Precinct",155,4,0,0,159,290,6,0,0,296
COUNCIL 2YR MDLT 2,Write In  ,"Middletown--2nd Ward, 1st Precinct",4,0,0,0,4,4,0,0,0,4
COUNCIL 2YR MDLT 2,Write In  ,"Middletown--2nd Ward, 2nd Precinct",0,0,0,0,0,4,0,0,0,4
COUNCIL 2YR MLBRG 1,Chris  DIETZ,Millersburg--1st Ward,51,3,0,0,54,51,3,0,0,54
COUNCIL 2YR MLBRG 1,Write In  ,Millersburg--1st Ward,1,0,0,0,1,1,0,0,0,1
COUNCIL 2YR PENBROOK 4,Peggyanne  MILLER,Penbrook Borough--4th Ward,80,1,0,0,81,80,1,0,0,81
COUNCIL 2YR PENBROOK 4,Write In  ,Penbrook Borough--4th Ward,4,0,0,0,4,4,0,0,0,4
COUNCIL 4YR DAUPHIN,John  WINDISH,Dauphin Borough,138,1,0,0,139,138,1,0,0,139
COUNCIL 4YR DAUPHIN,Joseph R. WYNN,Dauphin Borough,123,1,0,0,124,123,1,0,0,124
COUNCIL 4YR DAUPHIN,Trudy A. KOPPENHAVER,Dauphin Borough,142,1,0,0,143,142,1,0,0,143
COUNCIL 4YR DAUPHIN,Write In  ,Dauphin Borough,9,0,0,0,9,9,0,0,0,9
COUNCIL 4YR EVILLE,Brian E. STAHL,Elizabethville Borough,147,0,0,0,147,147,0,0,0,147
COUNCIL 4YR EVILLE,Gary E. SHADLE,Elizabethville Borough,168,1,0,0,169,168,1,0,0,169
COUNCIL 4YR EVILLE,Stuart A. MARGERUM,Elizabethville Borough,157,0,0,0,157,157,0,0,0,157
COUNCIL 4YR EVILLE,Write In  ,Elizabethville Borough,0,0,0,0,0,0,0,0,0,0
COUNCIL 4YR LYKENS 1,Claudia  MAFFEI,Lykens Borough--1st Ward,67,1,0,0,68,67,1,0,0,68
COUNCIL 4YR LYKENS 1,Write In  ,Lykens Borough--1st Ward,7,0,0,0,7,7,0,0,0,7
COUNCIL 4YR MDLT 2,Ruth A. SITLER,"Middletown--2nd Ward, 1st Precinct",132,1,0,0,133,279,5,0,0,284
COUNCIL 4YR MDLT 2,Ruth A. SITLER,"Middletown--2nd Ward, 2nd Precinct",147,4,0,0,151,279,5,0,0,284
COUNCIL 4YR MDLT 2,Write In  ,"Middletown--2nd Ward, 1st Precinct",3,0,0,0,3,3,0,0,0,3
COUNCIL 4YR MDLT 2,Write In  ,"Middletown--2nd Ward, 2nd Precinct",0,0,0,0,0,3,0,0,0,3
COUNCIL 4YR MLBRG 1,Write In  ,Millersburg--1st Ward,10,0,0,0,10,10,0,0,0,10
COUNCIL 4YR PENBROOK 4,Kevin  RAMPER,Penbrook Borough--4th Ward,75,1,0,0,76,75,1,0,0,76
COUNCIL 4YR PENBROOK 4,Write In  ,Penbrook Borough--4th Ward,1,0,0,0,1,1,0,0,0,1
COUNCIL 4YR ROYALTON  1,Rebecca A. HESS,Royalton Borough--1st Ward,34,0,0,0,34,34,0,0,0,34
COUNCIL 4YR ROYALTON  1,Teddy L. BIESECKER,Royalton Borough--1st Ward,30,0,0,0,30,30,0,0,0,30
COUNCIL 4YR ROYALTON  1,Tildon J. SIDES,Royalton Borough--1st Ward,32,0,0,0,32,32,0,0,0,32
COUNCIL 4YR ROYALTON  1,Write In  ,Royalton Borough--1st Ward,1,0,0,0,1,1,0,0,0,1
COUNCIL BERRYSBURG,Charles E. GALLAGHER,Berrysburg Borough,39,0,0,0,39,39,0,0,0,39
COUNCIL BERRYSBURG,Write In  ,Berrysburg Borough,2,0,0,0,2,2,0,0,0,2
COUNCIL GRATZ,Larry R. SHADE,Gratz Borough,71,2,0,0,73,71,2,0,0,73
COUNCIL GRATZ,Mark  LONG,Gratz Borough,70,1,0,0,71,70,1,0,0,71
COUNCIL GRATZ,Ray  KISSINGER,Gratz Borough,64,2,0,0,66,64,2,0,0,66
COUNCIL GRATZ,Write In  ,Gratz Borough,2,0,0,0,2,2,0,0,0,2
COUNCIL HALIFAX,Write In  ,Halifax Borough,35,0,0,0,35,35,0,0,0,35
COUNCIL HIGHSPIRE,A. Kay  SUTCH,Highspire--1st Precinct,106,2,0,0,108,218,3,0,0,221
COUNCIL HIGHSPIRE,A. Kay  SUTCH,Highspire--2nd Precinct,112,1,0,0,113,218,3,0,0,221
COUNCIL HIGHSPIRE,Dorothy Hess MATESEVAC,Highspire--1st Precinct,101,2,0,0,103,213,3,0,0,216
COUNCIL HIGHSPIRE,Dorothy Hess MATESEVAC,Highspire--2nd Precinct,112,1,0,0,113,213,3,0,0,216
COUNCIL HIGHSPIRE,"James Dennis TITUS, JR.",Highspire--1st Precinct,101,2,0,0,103,220,2,0,0,222
COUNCIL HIGHSPIRE,"James Dennis TITUS, JR.",Highspire--2nd Precinct,119,0,0,0,119,220,2,0,0,222
COUNCIL HIGHSPIRE,Jared P. GOUGHNOUR,Highspire--1st Precinct,94,2,0,0,96,202,2,0,0,204
COUNCIL HIGHSPIRE,Jared P. GOUGHNOUR,Highspire--2nd Precinct,108,0,0,0,108,202,2,0,0,204
COUNCIL HIGHSPIRE,Write In  ,Highspire--1st Precinct,0,0,0,0,0,0,0,0,0,0
COUNCIL HIGHSPIRE,Write In  ,Highspire--2nd Precinct,0,0,0,0,0,0,0,0,0,0
COUNCIL LYKENS 2,James A. SCHNIEDER,Lykens Borough--2nd Ward,81,2,0,0,83,81,2,0,0,83
COUNCIL LYKENS 2,"John L. CESSNA, JR.",Lykens Borough--2nd Ward,114,3,0,0,117,114,3,0,0,117
COUNCIL LYKENS 2,Write In  ,Lykens Borough--2nd Ward,9,0,0,0,9,9,0,0,0,9
COUNCIL MDLT 3,Write In  ,"Middletown--3rd Ward, 1st Precinct",51,0,0,0,51,73,0,0,0,73
COUNCIL MDLT 3,Write In  ,"Middletown--3rd Ward, 2nd Precinct",22,0,0,0,22,73,0,0,0,73
COUNCIL MLBRG 2,Matthew M. MAVRETIC,Millersburg--2nd Ward,155,3,0,0,158,155,3,0,0,158
COUNCIL MLBRG 2,Write In  ,Millersburg--2nd Ward,2,0,0,0,2,2,0,0,0,2
COUNCIL PAXTANG,Deborah  SENECA,Paxtang Borough,225,2,0,0,227,225,2,0,0,227
COUNCIL PAXTANG,"E. Denny  BEAVER, JR.",Paxtang Borough,200,2,0,0,202,200,2,0,0,202
COUNCIL PAXTANG,Virginia S. PANZA,Paxtang Borough,170,1,0,0,171,170,1,0,0,171
COUNCIL PAXTANG,Write In  ,Paxtang Borough,73,0,0,0,73,73,0,0,0,73
COUNCIL PENBROOK 1,Michael D. SWEIGARD,Penbrook Borough--1st Ward,48,1,0,0,49,48,1,0,0,49
COUNCIL PENBROOK 1,Write In  ,Penbrook Borough--1st Ward,0,0,0,0,0,0,0,0,0,0
COUNCIL PENBROOK 2,Beverly Ann CARLSON,Penbrook Borough--2nd Ward,52,0,0,0,52,52,0,0,0,52
COUNCIL PENBROOK 2,Write In  ,Penbrook Borough--2nd Ward,1,0,0,0,1,1,0,0,0,1
COUNCIL PENBROOK 3,Sandy  MATIO,Penbrook Borough--3rd Ward,69,0,0,0,69,69,0,0,0,69
COUNCIL PENBROOK 3,Write In  ,Penbrook Borough--3rd Ward,1,0,0,0,1,1,0,0,0,1
COUNCIL PILLOW,Dennis  SMELTZ,Pillow Borough,49,0,0,0,49,49,0,0,0,49
COUNCIL PILLOW,Joseph  REED,Pillow Borough,37,0,0,0,37,37,0,0,0,37
COUNCIL PILLOW,Write In  ,Pillow Borough,3,0,0,0,3,3,0,0,0,3
COUNCIL ROYALTON 2,Cindy D. MARSH,Royalton Borough--2nd Ward,74,0,0,0,74,74,0,0,0,74
COUNCIL ROYALTON 2,Gerald B. BURKETT,Royalton Borough--2nd Ward,72,0,0,0,72,72,0,0,0,72
COUNCIL ROYALTON 2,Write In  ,Royalton Borough--2nd Ward,0,0,0,0,0,0,0,0,0,0
COUNCIL WILLIAMSTOWN 1,Dane  WILLIARD,Williamstown--1st Ward,103,1,0,0,104,103,1,0,0,104
COUNCIL WILLIAMSTOWN 1,Ronald  UMHOLTZ,Williamstown--1st Ward,96,1,0,0,97,96,1,0,0,97
COUNCIL WILLIAMSTOWN 1,Write In  ,Williamstown--1st Ward,3,0,0,0,3,3,0,0,0,3
COUNCIL WILLIAMSTOWN 2,Dennis  HAND,Williamstown--2nd Ward,66,0,0,0,66,66,0,0,0,66
COUNCIL WILLIAMSTOWN 2,Write In  ,Williamstown--2nd Ward,0,0,0,0,0,0,0,0,0,0
COUNTY COMMISSIONER,Alvin Q. TAYLOR,"City--1st Ward, 1st Precinct",46,1,0,0,47,12876,224,8,0,13108
COUNTY COMMISSIONER,Alvin Q. TAYLOR,"City--1st Ward, 2nd Precinct",127,1,1,0,129,12876,224,8,0,13108
COUNTY COMMISSIONER,Alvin Q. TAYLOR,"City--1st Ward, 3rd Precinct",74,0,0,0,74,12876,224,8,0,13108
COUNTY COMMISSIONER,Alvin Q. TAYLOR,"City--2nd Ward, 1st Precinct",30,0,0,0,30,12876,224,8,0,13108
COUNTY COMMISSIONER,Alvin Q. TAYLOR,"City--2nd Ward, 2nd Precinct",62,0,0,0,62,12876,224,8,0,13108
COUNTY COMMISSIONER,Alvin Q. TAYLOR,City--3rd Ward,77,0,0,0,77,12876,224,8,0,13108
COUNTY COMMISSIONER,Alvin Q. TAYLOR,City--4th Ward,102,3,0,0,105,12876,224,8,0,13108
COUNTY COMMISSIONER,Alvin Q. TAYLOR,City--5th Ward,163,7,0,0,170,12876,224,8,0,13108
COUNTY COMMISSIONER,Alvin Q. TAYLOR,City--6th Ward,97,1,2,0,100,12876,224,8,0,13108
COUNTY COMMISSIONER,Alvin Q. TAYLOR,"City--7th Ward, 1st Precinct",48,1,0,0,49,12876,224,8,0,13108
COUNTY COMMISSIONER,Alvin Q. TAYLOR,"City--7th Ward, 2nd Precinct",183,0,0,0,183,12876,224,8,0,13108
COUNTY COMMISSIONER,Alvin Q. TAYLOR,City--8th Ward,166,3,0,0,169,12876,224,8,0,13108
COUNTY COMMISSIONER,Alvin Q. TAYLOR,"City--9th Ward, 1st Precinct",41,2,0,0,43,12876,224,8,0,13108
COUNTY COMMISSIONER,Alvin Q. TAYLOR,"City--9th Ward, 2nd Precinct",98,1,0,0,99,12876,224,8,0,13108
COUNTY COMMISSIONER,Alvin Q. TAYLOR,"City--9th Ward, 3rd Precinct",204,1,0,0,205,12876,224,8,0,13108
COUNTY COMMISSIONER,Alvin Q. TAYLOR,"City--9th Ward, 4th Precinct",119,2,0,0,121,12876,224,8,0,13108
COUNTY COMMISSIONER,Alvin Q. TAYLOR,"City--9th Ward, 5th Precinct",85,4,0,0,89,12876,224,8,0,13108
COUNTY COMMISSIONER,Alvin Q. TAYLOR,"City--10th Ward, 1st Precinct",184,0,0,0,184,12876,224,8,0,13108
COUNTY COMMISSIONER,Alvin Q. TAYLOR,"City--10th Ward, 2nd Precinct",92,0,0,0,92,12876,224,8,0,13108
COUNTY COMMISSIONER,Alvin Q. TAYLOR,"City--10th Ward, 3rd Precinct",49,0,0,0,49,12876,224,8,0,13108
COUNTY COMMISSIONER,Alvin Q. TAYLOR,"City--10th Ward, 4th Precinct",140,1,0,0,141,12876,224,8,0,13108
COUNTY COMMISSIONER,Alvin Q. TAYLOR,City--11th Ward,96,13,0,0,109,12876,224,8,0,13108
COUNTY COMMISSIONER,Alvin Q. TAYLOR,City--12th Ward,157,2,0,0,159,12876,224,8,0,13108
COUNTY COMMISSIONER,Alvin Q. TAYLOR,"City--13th Ward, 1st Precinct",92,0,0,0,92,12876,224,8,0,13108
COUNTY COMMISSIONER,Alvin Q. TAYLOR,"City--13th Ward, 2nd Precinct",93,1,0,0,94,12876,224,8,0,13108
COUNTY COMMISSIONER,Alvin Q. TAYLOR,"City--13th Ward, 3rd Precinct",156,1,0,0,157,12876,224,8,0,13108
COUNTY COMMISSIONER,Alvin Q. TAYLOR,City--14th Ward,192,5,0,0,197,12876,224,8,0,13108
COUNTY COMMISSIONER,Alvin Q. TAYLOR,City--15th Ward,83,1,0,0,84,12876,224,8,0,13108
COUNTY COMMISSIONER,Alvin Q. TAYLOR,Berrysburg Borough,16,0,0,0,16,12876,224,8,0,13108
COUNTY COMMISSIONER,Alvin Q. TAYLOR,Dauphin Borough,40,1,0,0,41,12876,224,8,0,13108
COUNTY COMMISSIONER,Alvin Q. TAYLOR,Elizabethville Borough,39,1,0,0,40,12876,224,8,0,13108
COUNTY COMMISSIONER,Alvin Q. TAYLOR,Gratz Borough,15,0,0,0,15,12876,224,8,0,13108
COUNTY COMMISSIONER,Alvin Q. TAYLOR,Halifax Borough,21,0,0,0,21,12876,224,8,0,13108
COUNTY COMMISSIONER,Alvin Q. TAYLOR,Highspire--1st Precinct,56,0,0,0,56,12876,224,8,0,13108
COUNTY COMMISSIONER,Alvin Q. TAYLOR,Highspire--2nd Precinct,41,0,0,0,41,12876,224,8,0,13108
COUNTY COMMISSIONER,Alvin Q. TAYLOR,Hummelstown--1st Precinct,57,1,0,0,58,12876,224,8,0,13108
COUNTY COMMISSIONER,Alvin Q. TAYLOR,Hummelstown--2nd Precinct,99,2,0,0,101,12876,224,8,0,13108
COUNTY COMMISSIONER,Alvin Q. TAYLOR,Lykens Borough--1st Ward,28,1,0,0,29,12876,224,8,0,13108
COUNTY COMMISSIONER,Alvin Q. TAYLOR,Lykens Borough--2nd Ward,38,1,0,0,39,12876,224,8,0,13108
COUNTY COMMISSIONER,Alvin Q. TAYLOR,"Middletown--1st Ward, 1st Precinct",26,0,0,0,26,12876,224,8,0,13108
COUNTY COMMISSIONER,Alvin Q. TAYLOR,"Middletown--1st Ward, 2nd Precinct",49,0,0,0,49,12876,224,8,0,13108
COUNTY COMMISSIONER,Alvin Q. TAYLOR,"Middletown--2nd Ward, 1st Precinct",48,0,0,0,48,12876,224,8,0,13108
COUNTY COMMISSIONER,Alvin Q. TAYLOR,"Middletown--2nd Ward, 2nd Precinct",43,1,0,0,44,12876,224,8,0,13108
COUNTY COMMISSIONER,Alvin Q. TAYLOR,"Middletown--3rd Ward, 1st Precinct",34,1,0,0,35,12876,224,8,0,13108
COUNTY COMMISSIONER,Alvin Q. TAYLOR,"Middletown--3rd Ward, 2nd Precinct",48,0,0,0,48,12876,224,8,0,13108
COUNTY COMMISSIONER,Alvin Q. TAYLOR,Millersburg--1st Ward,19,1,0,0,20,12876,224,8,0,13108
COUNTY COMMISSIONER,Alvin Q. TAYLOR,Millersburg--2nd Ward,41,0,0,0,41,12876,224,8,0,13108
COUNTY COMMISSIONER,Alvin Q. TAYLOR,Paxtang Borough,91,2,0,0,93,12876,224,8,0,13108
COUNTY COMMISSIONER,Alvin Q. TAYLOR,Penbrook Borough--1st Ward,37,0,0,0,37,12876,224,8,0,13108
COUNTY COMMISSIONER,Alvin Q. TAYLOR,Penbrook Borough--2nd Ward,31,0,0,0,31,12876,224,8,0,13108
COUNTY COMMISSIONER,Alvin Q. TAYLOR,Penbrook Borough--3rd Ward,31,0,0,0,31,12876,224,8,0,13108
COUNTY COMMISSIONER,Alvin Q. TAYLOR,Penbrook Borough--4th Ward,54,0,0,0,54,12876,224,8,0,13108
COUNTY COMMISSIONER,Alvin Q. TAYLOR,Royalton Borough--1st Ward,14,0,0,0,14,12876,224,8,0,13108
COUNTY COMMISSIONER,Alvin Q. TAYLOR,Royalton Borough--2nd Ward,10,0,0,0,10,12876,224,8,0,13108
COUNTY COMMISSIONER,Alvin Q. TAYLOR,Steelton--1st Ward,49,3,0,0,52,12876,224,8,0,13108
COUNTY COMMISSIONER,Alvin Q. TAYLOR,"Steelton--2nd Ward, 1st Precinct",69,0,0,0,69,12876,224,8,0,13108
COUNTY COMMISSIONER,Alvin Q. TAYLOR,"Steelton--2nd Ward, 2nd Precinct",25,0,0,0,25,12876,224,8,0,13108
COUNTY COMMISSIONER,Alvin Q. TAYLOR,"Steelton--3rd Ward, 1st Precinct",29,0,0,0,29,12876,224,8,0,13108
COUNTY COMMISSIONER,Alvin Q. TAYLOR,"Steelton--3rd Ward, 2nd Precinct",77,0,0,0,77,12876,224,8,0,13108
COUNTY COMMISSIONER,Alvin Q. TAYLOR,Steelton--4th Ward,53,1,0,0,54,12876,224,8,0,13108
COUNTY COMMISSIONER,Alvin Q. TAYLOR,Pillow Borough,18,0,0,0,18,12876,224,8,0,13108
COUNTY COMMISSIONER,Alvin Q. TAYLOR,Williamstown--1st Ward,28,0,0,0,28,12876,224,8,0,13108
COUNTY COMMISSIONER,Alvin Q. TAYLOR,Williamstown--2nd Ward,16,0,0,0,16,12876,224,8,0,13108
COUNTY COMMISSIONER,Alvin Q. TAYLOR,Conewago Twp--1st Precinct,60,1,0,0,61,12876,224,8,0,13108
COUNTY COMMISSIONER,Alvin Q. TAYLOR,Conewago Twp--2nd Precinct,40,0,0,0,40,12876,224,8,0,13108
COUNTY COMMISSIONER,Alvin Q. TAYLOR,Derry Township--1st Precinct,93,1,0,0,94,12876,224,8,0,13108
COUNTY COMMISSIONER,Alvin Q. TAYLOR,Derry Township--2nd Precinct,74,2,0,0,76,12876,224,8,0,13108
COUNTY COMMISSIONER,Alvin Q. TAYLOR,Derry Township--3rd Precinct,98,0,1,0,99,12876,224,8,0,13108
COUNTY COMMISSIONER,Alvin Q. TAYLOR,Derry Township--4th Precinct,51,2,1,0,54,12876,224,8,0,13108
COUNTY COMMISSIONER,Alvin Q. TAYLOR,Derry Township--5th Precinct,38,0,0,0,38,12876,224,8,0,13108
COUNTY COMMISSIONER,Alvin Q. TAYLOR,Derry Township--6th Precinct,57,0,0,0,57,12876,224,8,0,13108
COUNTY COMMISSIONER,Alvin Q. TAYLOR,Derry Township--7th Precinct,84,0,0,0,84,12876,224,8,0,13108
COUNTY COMMISSIONER,Alvin Q. TAYLOR,Derry Township--8th Precinct,58,0,0,0,58,12876,224,8,0,13108
COUNTY COMMISSIONER,Alvin Q. TAYLOR,Derry Township--9th Precinct,44,1,0,0,45,12876,224,8,0,13108
COUNTY COMMISSIONER,Alvin Q. TAYLOR,Derry Township--10th Precinct,52,2,0,0,54,12876,224,8,0,13108
COUNTY COMMISSIONER,Alvin Q. TAYLOR,Derry Township--11th Precinct,91,2,0,0,93,12876,224,8,0,13108
COUNTY COMMISSIONER,Alvin Q. TAYLOR,Derry Township--12th Precinct,49,2,0,0,51,12876,224,8,0,13108
COUNTY COMMISSIONER,Alvin Q. TAYLOR,Derry Township--13th Precinct,82,2,0,0,84,12876,224,8,0,13108
COUNTY COMMISSIONER,Alvin Q. TAYLOR,Derry Township--14th Precinct,60,2,0,0,62,12876,224,8,0,13108
COUNTY COMMISSIONER,Alvin Q. TAYLOR,Derry Township--15th Precinct,95,3,0,0,98,12876,224,8,0,13108
COUNTY COMMISSIONER,Alvin Q. TAYLOR,East Hanover Township--1st Precinct,75,1,0,0,76,12876,224,8,0,13108
COUNTY COMMISSIONER,Alvin Q. TAYLOR,East Hanover Township--2nd Precinct,94,2,0,0,96,12876,224,8,0,13108
COUNTY COMMISSIONER,Alvin Q. TAYLOR,Halifax Twp--1st Precinct,74,2,0,0,76,12876,224,8,0,13108
COUNTY COMMISSIONER,Alvin Q. TAYLOR,Halifax Twp--2nd Precinct,69,3,0,0,72,12876,224,8,0,13108
COUNTY COMMISSIONER,Alvin Q. TAYLOR,Jackson Township,59,0,0,0,59,12876,224,8,0,13108
COUNTY COMMISSIONER,Alvin Q. TAYLOR,Jefferson Township,22,0,0,0,22,12876,224,8,0,13108
COUNTY COMMISSIONER,Alvin Q. TAYLOR,Londonderry Twp--1st Precinct,59,0,0,0,59,12876,224,8,0,13108
COUNTY COMMISSIONER,Alvin Q. TAYLOR,Londonderry Twp--2nd Precinct,62,0,0,0,62,12876,224,8,0,13108
COUNTY COMMISSIONER,Alvin Q. TAYLOR,Londonderry Twp--3rd Precinct,32,0,0,0,32,12876,224,8,0,13108
COUNTY COMMISSIONER,Alvin Q. TAYLOR,Lower Paxton Twp--1st Precinct,69,0,0,0,69,12876,224,8,0,13108
COUNTY COMMISSIONER,Alvin Q. TAYLOR,Lower Paxton Twp--2nd Precinct,84,6,0,0,90,12876,224,8,0,13108
COUNTY COMMISSIONER,Alvin Q. TAYLOR,Lower Paxton Twp--3rd precinct,120,3,0,0,123,12876,224,8,0,13108
COUNTY COMMISSIONER,Alvin Q. TAYLOR,Lower Paxton Twp--4th Precinct,90,1,0,0,91,12876,224,8,0,13108
COUNTY COMMISSIONER,Alvin Q. TAYLOR,Lower Paxton Twp--5th Precinct,83,0,0,0,83,12876,224,8,0,13108
COUNTY COMMISSIONER,Alvin Q. TAYLOR,Lower Paxton Twp--6th Precinct,94,0,0,0,94,12876,224,8,0,13108
COUNTY COMMISSIONER,Alvin Q. TAYLOR,Lower Paxton Twp--7th Precinct,85,1,0,0,86,12876,224,8,0,13108
COUNTY COMMISSIONER,Alvin Q. TAYLOR,Lower Paxton Twp--8th Precinct,77,2,0,0,79,12876,224,8,0,13108
COUNTY COMMISSIONER,Alvin Q. TAYLOR,Lower Paxton Twp--9th Precinct,50,3,0,0,53,12876,224,8,0,13108
COUNTY COMMISSIONER,Alvin Q. TAYLOR,Lower Paxton Twp--10th Precinct,107,5,0,0,112,12876,224,8,0,13108
COUNTY COMMISSIONER,Alvin Q. TAYLOR,Lower Paxton Twp--11th Precinct,75,2,0,0,77,12876,224,8,0,13108
COUNTY COMMISSIONER,Alvin Q. TAYLOR,Lower Paxton Twp--12th Precinct,90,0,0,0,90,12876,224,8,0,13108
COUNTY COMMISSIONER,Alvin Q. TAYLOR,Lower Paxton Twp--13th Precinct,108,3,0,0,111,12876,224,8,0,13108
COUNTY COMMISSIONER,Alvin Q. TAYLOR,Lower Paxton Twp--14th Precinct,79,3,2,0,84,12876,224,8,0,13108
COUNTY COMMISSIONER,Alvin Q. TAYLOR,Lower Paxton Twp--15th Precinct,101,0,0,0,101,12876,224,8,0,13108
COUNTY COMMISSIONER,Alvin Q. TAYLOR,Lower Paxton Twp--16th Precinct,126,0,0,0,126,12876,224,8,0,13108
COUNTY COMMISSIONER,Alvin Q. TAYLOR,Lower Paxton Twp--17th Precinct,100,0,0,0,100,12876,224,8,0,13108
COUNTY COMMISSIONER,Alvin Q. TAYLOR,Lower Paxton Twp--18th Precinct,88,0,0,0,88,12876,224,8,0,13108
COUNTY COMMISSIONER,Alvin Q. TAYLOR,Lower Paxton Twp--19th Precinct,134,1,0,0,135,12876,224,8,0,13108
COUNTY COMMISSIONER,Alvin Q. TAYLOR,Lower Paxton Twp--20th Precinct,73,1,0,0,74,12876,224,8,0,13108
COUNTY COMMISSIONER,Alvin Q. TAYLOR,Lower Paxton Twp--21st Precinct,107,7,0,0,114,12876,224,8,0,13108
COUNTY COMMISSIONER,Alvin Q. TAYLOR,Lower Paxton Twp--22nd Precinct,78,0,0,0,78,12876,224,8,0,13108
COUNTY COMMISSIONER,Alvin Q. TAYLOR,Lower Paxton Twp--23rd Precinct,59,0,0,0,59,12876,224,8,0,13108
COUNTY COMMISSIONER,Alvin Q. TAYLOR,Lower Paxton Twp--24th Precinct,76,3,0,0,79,12876,224,8,0,13108
COUNTY COMMISSIONER,Alvin Q. TAYLOR,Lower Paxton Twp--25th Precinct,78,1,0,0,79,12876,224,8,0,13108
COUNTY COMMISSIONER,Alvin Q. TAYLOR,Lower Paxton Twp--26th Precinct,100,3,0,0,103,12876,224,8,0,13108
COUNTY COMMISSIONER,Alvin Q. TAYLOR,Lower Paxton Twp--27th Precinct,82,0,0,0,82,12876,224,8,0,13108
COUNTY COMMISSIONER,Alvin Q. TAYLOR,Lower Swatara Twp--1st Precinct,68,2,0,0,70,12876,224,8,0,13108
COUNTY COMMISSIONER,Alvin Q. TAYLOR,Lower Swatara Twp--2nd Precinct,75,4,0,0,79,12876,224,8,0,13108
COUNTY COMMISSIONER,Alvin Q. TAYLOR,Lower Swatara Twp--3rd Precinct,71,10,0,0,81,12876,224,8,0,13108
COUNTY COMMISSIONER,Alvin Q. TAYLOR,Lower Swatara Twp--4th Precinct,64,0,0,0,64,12876,224,8,0,13108
COUNTY COMMISSIONER,Alvin Q. TAYLOR,Lykens Township,24,0,0,0,24,12876,224,8,0,13108
COUNTY COMMISSIONER,Alvin Q. TAYLOR,Middle Paxton Twp--1st Precinct,96,0,0,0,96,12876,224,8,0,13108
COUNTY COMMISSIONER,Alvin Q. TAYLOR,Middle Paxton Twp--2nd Precinct,94,0,0,0,94,12876,224,8,0,13108
COUNTY COMMISSIONER,Alvin Q. TAYLOR,Middle Paxton Twp--3rd Precinct,85,1,0,0,86,12876,224,8,0,13108
COUNTY COMMISSIONER,Alvin Q. TAYLOR,Mifflin Township,14,0,0,0,14,12876,224,8,0,13108
COUNTY COMMISSIONER,Alvin Q. TAYLOR,Reed Township,12,0,0,0,12,12876,224,8,0,13108
COUNTY COMMISSIONER,Alvin Q. TAYLOR,Rush Township,10,0,0,0,10,12876,224,8,0,13108
COUNTY COMMISSIONER,Alvin Q. TAYLOR,South Hanover Twp--1st Precinct,67,0,0,0,67,12876,224,8,0,13108
COUNTY COMMISSIONER,Alvin Q. TAYLOR,South Hanover Twp--2nd Precinct,98,3,0,0,101,12876,224,8,0,13108
COUNTY COMMISSIONER,Alvin Q. TAYLOR,South Hanover Twp--3rd Precinct,61,0,0,0,61,12876,224,8,0,13108
COUNTY COMMISSIONER,Alvin Q. TAYLOR,Susquehanna Twp--1st Ward,250,6,0,0,256,12876,224,8,0,13108
COUNTY COMMISSIONER,Alvin Q. TAYLOR,Susquehanna Twp--2nd Ward,243,11,0,0,254,12876,224,8,0,13108
COUNTY COMMISSIONER,Alvin Q. TAYLOR,Susquehanna Twp--3rd Ward,211,3,0,0,214,12876,224,8,0,13108
COUNTY COMMISSIONER,Alvin Q. TAYLOR,Susquehanna Twp--4th Ward,167,1,0,0,168,12876,224,8,0,13108
COUNTY COMMISSIONER,Alvin Q. TAYLOR,Susquehanna Twp--5th Ward,136,3,0,0,139,12876,224,8,0,13108
COUNTY COMMISSIONER,Alvin Q. TAYLOR,Susquehanna Twp--6th Ward,144,1,0,0,145,12876,224,8,0,13108
COUNTY COMMISSIONER,Alvin Q. TAYLOR,Susquehanna Twp--7th Ward,103,0,0,0,103,12876,224,8,0,13108
COUNTY COMMISSIONER,Alvin Q. TAYLOR,Susquehanna Twp--8th Ward,213,10,0,0,223,12876,224,8,0,13108
COUNTY COMMISSIONER,Alvin Q. TAYLOR,Susquehanna Twp--9th Ward,216,2,0,0,218,12876,224,8,0,13108
COUNTY COMMISSIONER,Alvin Q. TAYLOR,Swatara Township--1st Ward,127,2,0,0,129,12876,224,8,0,13108
COUNTY COMMISSIONER,Alvin Q. TAYLOR,Swatara Township--2nd Ward,100,11,0,0,111,12876,224,8,0,13108
COUNTY COMMISSIONER,Alvin Q. TAYLOR,Swatara Township--3rd Ward,90,2,0,0,92,12876,224,8,0,13108
COUNTY COMMISSIONER,Alvin Q. TAYLOR,Swatara Township--4th Ward,112,0,0,0,112,12876,224,8,0,13108
COUNTY COMMISSIONER,Alvin Q. TAYLOR,Swatara Township--5th Ward,132,0,0,0,132,12876,224,8,0,13108
COUNTY COMMISSIONER,Alvin Q. TAYLOR,Swatara Township--6th Ward,157,1,0,0,158,12876,224,8,0,13108
COUNTY COMMISSIONER,Alvin Q. TAYLOR,Swatara Township--7th Ward,168,3,0,0,171,12876,224,8,0,13108
COUNTY COMMISSIONER,Alvin Q. TAYLOR,Swatara Township--8th Ward,130,1,0,0,131,12876,224,8,0,13108
COUNTY COMMISSIONER,Alvin Q. TAYLOR,Swatara Township--9th Ward,97,3,0,0,100,12876,224,8,0,13108
COUNTY COMMISSIONER,Alvin Q. TAYLOR,Upper Paxton Twp--1st Precinct,58,1,0,0,59,12876,224,8,0,13108
COUNTY COMMISSIONER,Alvin Q. TAYLOR,Upper Paxton Twp--2nd Precinct,39,0,0,0,39,12876,224,8,0,13108
COUNTY COMMISSIONER,Alvin Q. TAYLOR,Washington Township,60,0,0,0,60,12876,224,8,0,13108
COUNTY COMMISSIONER,Alvin Q. TAYLOR,Wayne Township,63,0,0,0,63,12876,224,8,0,13108
COUNTY COMMISSIONER,Alvin Q. TAYLOR,West Hanover Twp--1st Precinct,66,0,0,0,66,12876,224,8,0,13108
COUNTY COMMISSIONER,Alvin Q. TAYLOR,West Hanover Twp--2nd Precinct,81,0,0,0,81,12876,224,8,0,13108
COUNTY COMMISSIONER,Alvin Q. TAYLOR,West Hanover Twp--3rd Precinct,185,2,1,0,188,12876,224,8,0,13108
COUNTY COMMISSIONER,Alvin Q. TAYLOR,West Hanover Twp--4th Precinct,93,1,0,0,94,12876,224,8,0,13108
COUNTY COMMISSIONER,Alvin Q. TAYLOR,Wiconisco Twp--1st Precinct,24,0,0,0,24,12876,224,8,0,13108
COUNTY COMMISSIONER,Alvin Q. TAYLOR,Wiconisco Twp--2nd Precinct,19,0,0,0,19,12876,224,8,0,13108
COUNTY COMMISSIONER,Alvin Q. TAYLOR,Williams Twp,22,0,0,0,22,12876,224,8,0,13108
COUNTY COMMISSIONER,"George P. HARTWICK, III","City--1st Ward, 1st Precinct",88,1,0,0,89,19872,371,12,0,20255
COUNTY COMMISSIONER,"George P. HARTWICK, III","City--1st Ward, 2nd Precinct",135,2,1,0,138,19872,371,12,0,20255
COUNTY COMMISSIONER,"George P. HARTWICK, III","City--1st Ward, 3rd Precinct",56,1,0,0,57,19872,371,12,0,20255
COUNTY COMMISSIONER,"George P. HARTWICK, III","City--2nd Ward, 1st Precinct",29,0,0,0,29,19872,371,12,0,20255
COUNTY COMMISSIONER,"George P. HARTWICK, III","City--2nd Ward, 2nd Precinct",70,1,0,0,71,19872,371,12,0,20255
COUNTY COMMISSIONER,"George P. HARTWICK, III",City--3rd Ward,98,1,0,0,99,19872,371,12,0,20255
COUNTY COMMISSIONER,"George P. HARTWICK, III",City--4th Ward,133,5,0,0,138,19872,371,12,0,20255
COUNTY COMMISSIONER,"George P. HARTWICK, III",City--5th Ward,286,7,0,0,293,19872,371,12,0,20255
COUNTY COMMISSIONER,"George P. HARTWICK, III",City--6th Ward,144,2,3,0,149,19872,371,12,0,20255
COUNTY COMMISSIONER,"George P. HARTWICK, III","City--7th Ward, 1st Precinct",47,1,0,0,48,19872,371,12,0,20255
COUNTY COMMISSIONER,"George P. HARTWICK, III","City--7th Ward, 2nd Precinct",119,1,0,0,120,19872,371,12,0,20255
COUNTY COMMISSIONER,"George P. HARTWICK, III",City--8th Ward,134,2,0,0,136,19872,371,12,0,20255
COUNTY COMMISSIONER,"George P. HARTWICK, III","City--9th Ward, 1st Precinct",44,0,0,0,44,19872,371,12,0,20255
COUNTY COMMISSIONER,"George P. HARTWICK, III","City--9th Ward, 2nd Precinct",81,1,0,0,82,19872,371,12,0,20255
COUNTY COMMISSIONER,"George P. HARTWICK, III","City--9th Ward, 3rd Precinct",156,1,0,0,157,19872,371,12,0,20255
COUNTY COMMISSIONER,"George P. HARTWICK, III","City--9th Ward, 4th Precinct",158,3,0,0,161,19872,371,12,0,20255
COUNTY COMMISSIONER,"George P. HARTWICK, III","City--9th Ward, 5th Precinct",105,4,0,0,109,19872,371,12,0,20255
COUNTY COMMISSIONER,"George P. HARTWICK, III","City--10th Ward, 1st Precinct",210,3,0,0,213,19872,371,12,0,20255
COUNTY COMMISSIONER,"George P. HARTWICK, III","City--10th Ward, 2nd Precinct",87,0,0,0,87,19872,371,12,0,20255
COUNTY COMMISSIONER,"George P. HARTWICK, III","City--10th Ward, 3rd Precinct",76,1,0,0,77,19872,371,12,0,20255
COUNTY COMMISSIONER,"George P. HARTWICK, III","City--10th Ward, 4th Precinct",104,0,0,0,104,19872,371,12,0,20255
COUNTY COMMISSIONER,"George P. HARTWICK, III",City--11th Ward,85,17,0,0,102,19872,371,12,0,20255
COUNTY COMMISSIONER,"George P. HARTWICK, III",City--12th Ward,226,6,0,0,232,19872,371,12,0,20255
COUNTY COMMISSIONER,"George P. HARTWICK, III","City--13th Ward, 1st Precinct",103,0,0,0,103,19872,371,12,0,20255
COUNTY COMMISSIONER,"George P. HARTWICK, III","City--13th Ward, 2nd Precinct",137,1,0,0,138,19872,371,12,0,20255
COUNTY COMMISSIONER,"George P. HARTWICK, III","City--13th Ward, 3rd Precinct",166,1,0,0,167,19872,371,12,0,20255
COUNTY COMMISSIONER,"George P. HARTWICK, III",City--14th Ward,294,6,0,0,300,19872,371,12,0,20255
COUNTY COMMISSIONER,"George P. HARTWICK, III",City--15th Ward,70,1,0,0,71,19872,371,12,0,20255
COUNTY COMMISSIONER,"George P. HARTWICK, III",Berrysburg Borough,33,0,0,0,33,19872,371,12,0,20255
COUNTY COMMISSIONER,"George P. HARTWICK, III",Dauphin Borough,82,1,0,0,83,19872,371,12,0,20255
COUNTY COMMISSIONER,"George P. HARTWICK, III",Elizabethville Borough,68,3,0,0,71,19872,371,12,0,20255
COUNTY COMMISSIONER,"George P. HARTWICK, III",Gratz Borough,34,0,0,0,34,19872,371,12,0,20255
COUNTY COMMISSIONER,"George P. HARTWICK, III",Halifax Borough,31,1,0,0,32,19872,371,12,0,20255
COUNTY COMMISSIONER,"George P. HARTWICK, III",Highspire--1st Precinct,87,1,0,0,88,19872,371,12,0,20255
COUNTY COMMISSIONER,"George P. HARTWICK, III",Highspire--2nd Precinct,107,1,0,0,108,19872,371,12,0,20255
COUNTY COMMISSIONER,"George P. HARTWICK, III",Hummelstown--1st Precinct,112,2,0,0,114,19872,371,12,0,20255
COUNTY COMMISSIONER,"George P. HARTWICK, III",Hummelstown--2nd Precinct,194,2,0,0,196,19872,371,12,0,20255
COUNTY COMMISSIONER,"George P. HARTWICK, III",Lykens Borough--1st Ward,43,1,0,0,44,19872,371,12,0,20255
COUNTY COMMISSIONER,"George P. HARTWICK, III",Lykens Borough--2nd Ward,67,1,0,0,68,19872,371,12,0,20255
COUNTY COMMISSIONER,"George P. HARTWICK, III","Middletown--1st Ward, 1st Precinct",42,0,0,0,42,19872,371,12,0,20255
COUNTY COMMISSIONER,"George P. HARTWICK, III","Middletown--1st Ward, 2nd Precinct",81,1,0,0,82,19872,371,12,0,20255
COUNTY COMMISSIONER,"George P. HARTWICK, III","Middletown--2nd Ward, 1st Precinct",79,1,0,0,80,19872,371,12,0,20255
COUNTY COMMISSIONER,"George P. HARTWICK, III","Middletown--2nd Ward, 2nd Precinct",84,3,0,0,87,19872,371,12,0,20255
COUNTY COMMISSIONER,"George P. HARTWICK, III","Middletown--3rd Ward, 1st Precinct",43,1,0,0,44,19872,371,12,0,20255
COUNTY COMMISSIONER,"George P. HARTWICK, III","Middletown--3rd Ward, 2nd Precinct",94,0,0,0,94,19872,371,12,0,20255
COUNTY COMMISSIONER,"George P. HARTWICK, III",Millersburg--1st Ward,49,1,0,0,50,19872,371,12,0,20255
COUNTY COMMISSIONER,"George P. HARTWICK, III",Millersburg--2nd Ward,78,1,0,0,79,19872,371,12,0,20255
COUNTY COMMISSIONER,"George P. HARTWICK, III",Paxtang Borough,162,3,0,0,165,19872,371,12,0,20255
COUNTY COMMISSIONER,"George P. HARTWICK, III",Penbrook Borough--1st Ward,41,0,0,0,41,19872,371,12,0,20255
COUNTY COMMISSIONER,"George P. HARTWICK, III",Penbrook Borough--2nd Ward,44,0,0,0,44,19872,371,12,0,20255
COUNTY COMMISSIONER,"George P. HARTWICK, III",Penbrook Borough--3rd Ward,36,0,0,0,36,19872,371,12,0,20255
COUNTY COMMISSIONER,"George P. HARTWICK, III",Penbrook Borough--4th Ward,46,1,0,0,47,19872,371,12,0,20255
COUNTY COMMISSIONER,"George P. HARTWICK, III",Royalton Borough--1st Ward,24,0,0,0,24,19872,371,12,0,20255
COUNTY COMMISSIONER,"George P. HARTWICK, III",Royalton Borough--2nd Ward,29,0,0,0,29,19872,371,12,0,20255
COUNTY COMMISSIONER,"George P. HARTWICK, III",Steelton--1st Ward,126,5,0,0,131,19872,371,12,0,20255
COUNTY COMMISSIONER,"George P. HARTWICK, III","Steelton--2nd Ward, 1st Precinct",103,0,0,0,103,19872,371,12,0,20255
COUNTY COMMISSIONER,"George P. HARTWICK, III","Steelton--2nd Ward, 2nd Precinct",68,0,0,0,68,19872,371,12,0,20255
COUNTY COMMISSIONER,"George P. HARTWICK, III","Steelton--3rd Ward, 1st Precinct",59,0,0,0,59,19872,371,12,0,20255
COUNTY COMMISSIONER,"George P. HARTWICK, III","Steelton--3rd Ward, 2nd Precinct",95,0,0,0,95,19872,371,12,0,20255
COUNTY COMMISSIONER,"George P. HARTWICK, III",Steelton--4th Ward,108,1,2,0,111,19872,371,12,0,20255
COUNTY COMMISSIONER,"George P. HARTWICK, III",Pillow Borough,29,0,0,0,29,19872,371,12,0,20255
COUNTY COMMISSIONER,"George P. HARTWICK, III",Williamstown--1st Ward,51,1,0,0,52,19872,371,12,0,20255
COUNTY COMMISSIONER,"George P. HARTWICK, III",Williamstown--2nd Ward,29,0,0,0,29,19872,371,12,0,20255
COUNTY COMMISSIONER,"George P. HARTWICK, III",Conewago Twp--1st Precinct,86,1,0,0,87,19872,371,12,0,20255
COUNTY COMMISSIONER,"George P. HARTWICK, III",Conewago Twp--2nd Precinct,69,0,0,0,69,19872,371,12,0,20255
COUNTY COMMISSIONER,"George P. HARTWICK, III",Derry Township--1st Precinct,173,2,0,0,175,19872,371,12,0,20255
COUNTY COMMISSIONER,"George P. HARTWICK, III",Derry Township--2nd Precinct,130,3,0,0,133,19872,371,12,0,20255
COUNTY COMMISSIONER,"George P. HARTWICK, III",Derry Township--3rd Precinct,132,3,1,0,136,19872,371,12,0,20255
COUNTY COMMISSIONER,"George P. HARTWICK, III",Derry Township--4th Precinct,83,1,0,0,84,19872,371,12,0,20255
COUNTY COMMISSIONER,"George P. HARTWICK, III",Derry Township--5th Precinct,64,0,0,0,64,19872,371,12,0,20255
COUNTY COMMISSIONER,"George P. HARTWICK, III",Derry Township--6th Precinct,88,2,0,0,90,19872,371,12,0,20255
COUNTY COMMISSIONER,"George P. HARTWICK, III",Derry Township--7th Precinct,139,5,0,0,144,19872,371,12,0,20255
COUNTY COMMISSIONER,"George P. HARTWICK, III",Derry Township--8th Precinct,93,0,0,0,93,19872,371,12,0,20255
COUNTY COMMISSIONER,"George P. HARTWICK, III",Derry Township--9th Precinct,64,3,0,0,67,19872,371,12,0,20255
COUNTY COMMISSIONER,"George P. HARTWICK, III",Derry Township--10th Precinct,102,1,0,0,103,19872,371,12,0,20255
COUNTY COMMISSIONER,"George P. HARTWICK, III",Derry Township--11th Precinct,157,6,0,0,163,19872,371,12,0,20255
COUNTY COMMISSIONER,"George P. HARTWICK, III",Derry Township--12th Precinct,83,2,0,0,85,19872,371,12,0,20255
COUNTY COMMISSIONER,"George P. HARTWICK, III",Derry Township--13th Precinct,121,5,0,0,126,19872,371,12,0,20255
COUNTY COMMISSIONER,"George P. HARTWICK, III",Derry Township--14th Precinct,91,4,0,0,95,19872,371,12,0,20255
COUNTY COMMISSIONER,"George P. HARTWICK, III",Derry Township--15th Precinct,160,4,0,0,164,19872,371,12,0,20255
COUNTY COMMISSIONER,"George P. HARTWICK, III",East Hanover Township--1st Precinct,145,2,0,0,147,19872,371,12,0,20255
COUNTY COMMISSIONER,"George P. HARTWICK, III",East Hanover Township--2nd Precinct,157,3,0,0,160,19872,371,12,0,20255
COUNTY COMMISSIONER,"George P. HARTWICK, III",Halifax Twp--1st Precinct,132,3,0,0,135,19872,371,12,0,20255
COUNTY COMMISSIONER,"George P. HARTWICK, III",Halifax Twp--2nd Precinct,115,3,0,0,118,19872,371,12,0,20255
COUNTY COMMISSIONER,"George P. HARTWICK, III",Jackson Township,109,0,0,0,109,19872,371,12,0,20255
COUNTY COMMISSIONER,"George P. HARTWICK, III",Jefferson Township,32,0,0,0,32,19872,371,12,0,20255
COUNTY COMMISSIONER,"George P. HARTWICK, III",Londonderry Twp--1st Precinct,121,0,0,0,121,19872,371,12,0,20255
COUNTY COMMISSIONER,"George P. HARTWICK, III",Londonderry Twp--2nd Precinct,122,0,0,0,122,19872,371,12,0,20255
COUNTY COMMISSIONER,"George P. HARTWICK, III",Londonderry Twp--3rd Precinct,49,0,0,0,49,19872,371,12,0,20255
COUNTY COMMISSIONER,"George P. HARTWICK, III",Lower Paxton Twp--1st Precinct,105,2,0,0,107,19872,371,12,0,20255
COUNTY COMMISSIONER,"George P. HARTWICK, III",Lower Paxton Twp--2nd Precinct,136,5,0,0,141,19872,371,12,0,20255
COUNTY COMMISSIONER,"George P. HARTWICK, III",Lower Paxton Twp--3rd precinct,194,5,0,0,199,19872,371,12,0,20255
COUNTY COMMISSIONER,"George P. HARTWICK, III",Lower Paxton Twp--4th Precinct,150,1,0,0,151,19872,371,12,0,20255
COUNTY COMMISSIONER,"George P. HARTWICK, III",Lower Paxton Twp--5th Precinct,168,1,1,0,170,19872,371,12,0,20255
COUNTY COMMISSIONER,"George P. HARTWICK, III",Lower Paxton Twp--6th Precinct,124,3,0,0,127,19872,371,12,0,20255
COUNTY COMMISSIONER,"George P. HARTWICK, III",Lower Paxton Twp--7th Precinct,171,3,0,0,174,19872,371,12,0,20255
COUNTY COMMISSIONER,"George P. HARTWICK, III",Lower Paxton Twp--8th Precinct,105,2,0,0,107,19872,371,12,0,20255
COUNTY COMMISSIONER,"George P. HARTWICK, III",Lower Paxton Twp--9th Precinct,104,0,0,0,104,19872,371,12,0,20255
COUNTY COMMISSIONER,"George P. HARTWICK, III",Lower Paxton Twp--10th Precinct,93,5,0,0,98,19872,371,12,0,20255
COUNTY COMMISSIONER,"George P. HARTWICK, III",Lower Paxton Twp--11th Precinct,115,2,0,0,117,19872,371,12,0,20255
COUNTY COMMISSIONER,"George P. HARTWICK, III",Lower Paxton Twp--12th Precinct,181,3,0,0,184,19872,371,12,0,20255
COUNTY COMMISSIONER,"George P. HARTWICK, III",Lower Paxton Twp--13th Precinct,173,6,0,0,179,19872,371,12,0,20255
COUNTY COMMISSIONER,"George P. HARTWICK, III",Lower Paxton Twp--14th Precinct,105,2,1,0,108,19872,371,12,0,20255
COUNTY COMMISSIONER,"George P. HARTWICK, III",Lower Paxton Twp--15th Precinct,147,3,0,0,150,19872,371,12,0,20255
COUNTY COMMISSIONER,"George P. HARTWICK, III",Lower Paxton Twp--16th Precinct,224,2,0,0,226,19872,371,12,0,20255
COUNTY COMMISSIONER,"George P. HARTWICK, III",Lower Paxton Twp--17th Precinct,121,6,0,0,127,19872,371,12,0,20255
COUNTY COMMISSIONER,"George P. HARTWICK, III",Lower Paxton Twp--18th Precinct,125,1,0,0,126,19872,371,12,0,20255
COUNTY COMMISSIONER,"George P. HARTWICK, III",Lower Paxton Twp--19th Precinct,219,3,0,0,222,19872,371,12,0,20255
COUNTY COMMISSIONER,"George P. HARTWICK, III",Lower Paxton Twp--20th Precinct,125,1,0,0,126,19872,371,12,0,20255
COUNTY COMMISSIONER,"George P. HARTWICK, III",Lower Paxton Twp--21st Precinct,217,11,0,0,228,19872,371,12,0,20255
COUNTY COMMISSIONER,"George P. HARTWICK, III",Lower Paxton Twp--22nd Precinct,139,2,0,0,141,19872,371,12,0,20255
COUNTY COMMISSIONER,"George P. HARTWICK, III",Lower Paxton Twp--23rd Precinct,114,0,0,0,114,19872,371,12,0,20255
COUNTY COMMISSIONER,"George P. HARTWICK, III",Lower Paxton Twp--24th Precinct,147,0,0,0,147,19872,371,12,0,20255
COUNTY COMMISSIONER,"George P. HARTWICK, III",Lower Paxton Twp--25th Precinct,122,1,0,0,123,19872,371,12,0,20255
COUNTY COMMISSIONER,"George P. HARTWICK, III",Lower Paxton Twp--26th Precinct,174,4,0,0,178,19872,371,12,0,20255
COUNTY COMMISSIONER,"George P. HARTWICK, III",Lower Paxton Twp--27th Precinct,142,2,0,0,144,19872,371,12,0,20255
COUNTY COMMISSIONER,"George P. HARTWICK, III",Lower Swatara Twp--1st Precinct,150,3,0,0,153,19872,371,12,0,20255
COUNTY COMMISSIONER,"George P. HARTWICK, III",Lower Swatara Twp--2nd Precinct,131,4,0,0,135,19872,371,12,0,20255
COUNTY COMMISSIONER,"George P. HARTWICK, III",Lower Swatara Twp--3rd Precinct,129,9,0,0,138,19872,371,12,0,20255
COUNTY COMMISSIONER,"George P. HARTWICK, III",Lower Swatara Twp--4th Precinct,105,0,0,0,105,19872,371,12,0,20255
COUNTY COMMISSIONER,"George P. HARTWICK, III",Lykens Township,37,0,0,0,37,19872,371,12,0,20255
COUNTY COMMISSIONER,"George P. HARTWICK, III",Middle Paxton Twp--1st Precinct,145,0,0,0,145,19872,371,12,0,20255
COUNTY COMMISSIONER,"George P. HARTWICK, III",Middle Paxton Twp--2nd Precinct,147,0,0,0,147,19872,371,12,0,20255
COUNTY COMMISSIONER,"George P. HARTWICK, III",Middle Paxton Twp--3rd Precinct,149,1,0,0,150,19872,371,12,0,20255
COUNTY COMMISSIONER,"George P. HARTWICK, III",Mifflin Township,30,0,0,0,30,19872,371,12,0,20255
COUNTY COMMISSIONER,"George P. HARTWICK, III",Reed Township,21,0,0,0,21,19872,371,12,0,20255
COUNTY COMMISSIONER,"George P. HARTWICK, III",Rush Township,15,0,0,0,15,19872,371,12,0,20255
COUNTY COMMISSIONER,"George P. HARTWICK, III",South Hanover Twp--1st Precinct,116,1,0,0,117,19872,371,12,0,20255
COUNTY COMMISSIONER,"George P. HARTWICK, III",South Hanover Twp--2nd Precinct,167,6,0,0,173,19872,371,12,0,20255
COUNTY COMMISSIONER,"George P. HARTWICK, III",South Hanover Twp--3rd Precinct,95,0,0,0,95,19872,371,12,0,20255
COUNTY COMMISSIONER,"George P. HARTWICK, III",Susquehanna Twp--1st Ward,364,10,0,0,374,19872,371,12,0,20255
COUNTY COMMISSIONER,"George P. HARTWICK, III",Susquehanna Twp--2nd Ward,397,8,0,0,405,19872,371,12,0,20255
COUNTY COMMISSIONER,"George P. HARTWICK, III",Susquehanna Twp--3rd Ward,214,4,0,0,218,19872,371,12,0,20255
COUNTY COMMISSIONER,"George P. HARTWICK, III",Susquehanna Twp--4th Ward,239,2,0,0,241,19872,371,12,0,20255
COUNTY COMMISSIONER,"George P. HARTWICK, III",Susquehanna Twp--5th Ward,203,5,0,0,208,19872,371,12,0,20255
COUNTY COMMISSIONER,"George P. HARTWICK, III",Susquehanna Twp--6th Ward,216,7,0,0,223,19872,371,12,0,20255
COUNTY COMMISSIONER,"George P. HARTWICK, III",Susquehanna Twp--7th Ward,147,0,0,0,147,19872,371,12,0,20255
COUNTY COMMISSIONER,"George P. HARTWICK, III",Susquehanna Twp--8th Ward,358,13,0,0,371,19872,371,12,0,20255
COUNTY COMMISSIONER,"George P. HARTWICK, III",Susquehanna Twp--9th Ward,308,4,0,0,312,19872,371,12,0,20255
COUNTY COMMISSIONER,"George P. HARTWICK, III",Swatara Township--1st Ward,284,3,0,0,287,19872,371,12,0,20255
COUNTY COMMISSIONER,"George P. HARTWICK, III",Swatara Township--2nd Ward,146,12,0,0,158,19872,371,12,0,20255
COUNTY COMMISSIONER,"George P. HARTWICK, III",Swatara Township--3rd Ward,182,7,0,0,189,19872,371,12,0,20255
COUNTY COMMISSIONER,"George P. HARTWICK, III",Swatara Township--4th Ward,200,2,0,0,202,19872,371,12,0,20255
COUNTY COMMISSIONER,"George P. HARTWICK, III",Swatara Township--5th Ward,264,1,0,0,265,19872,371,12,0,20255
COUNTY COMMISSIONER,"George P. HARTWICK, III",Swatara Township--6th Ward,221,1,0,0,222,19872,371,12,0,20255
COUNTY COMMISSIONER,"George P. HARTWICK, III",Swatara Township--7th Ward,290,7,0,0,297,19872,371,12,0,20255
COUNTY COMMISSIONER,"George P. HARTWICK, III",Swatara Township--8th Ward,279,2,1,0,282,19872,371,12,0,20255
COUNTY COMMISSIONER,"George P. HARTWICK, III",Swatara Township--9th Ward,130,7,0,0,137,19872,371,12,0,20255
COUNTY COMMISSIONER,"George P. HARTWICK, III",Upper Paxton Twp--1st Precinct,124,3,0,0,127,19872,371,12,0,20255
COUNTY COMMISSIONER,"George P. HARTWICK, III",Upper Paxton Twp--2nd Precinct,73,0,0,0,73,19872,371,12,0,20255
COUNTY COMMISSIONER,"George P. HARTWICK, III",Washington Township,101,3,0,0,104,19872,371,12,0,20255
COUNTY COMMISSIONER,"George P. HARTWICK, III",Wayne Township,101,1,0,0,102,19872,371,12,0,20255
COUNTY COMMISSIONER,"George P. HARTWICK, III",West Hanover Twp--1st Precinct,123,0,0,0,123,19872,371,12,0,20255
COUNTY COMMISSIONER,"George P. HARTWICK, III",West Hanover Twp--2nd Precinct,160,3,0,0,163,19872,371,12,0,20255
COUNTY COMMISSIONER,"George P. HARTWICK, III",West Hanover Twp--3rd Precinct,331,10,2,0,343,19872,371,12,0,20255
COUNTY COMMISSIONER,"George P. HARTWICK, III",West Hanover Twp--4th Precinct,198,2,0,0,200,19872,371,12,0,20255
COUNTY COMMISSIONER,"George P. HARTWICK, III",Wiconisco Twp--1st Precinct,45,0,0,0,45,19872,371,12,0,20255
COUNTY COMMISSIONER,"George P. HARTWICK, III",Wiconisco Twp--2nd Precinct,30,0,0,0,30,19872,371,12,0,20255
COUNTY COMMISSIONER,"George P. HARTWICK, III",Williams Twp,51,0,0,0,51,19872,371,12,0,20255
COUNTY COMMISSIONER,Jeff  HASTE,"City--1st Ward, 1st Precinct",33,3,0,0,36,22474,480,10,0,22964
COUNTY COMMISSIONER,Jeff  HASTE,"City--1st Ward, 2nd Precinct",63,0,0,0,63,22474,480,10,0,22964
COUNTY COMMISSIONER,Jeff  HASTE,"City--1st Ward, 3rd Precinct",14,0,0,0,14,22474,480,10,0,22964
COUNTY COMMISSIONER,Jeff  HASTE,"City--2nd Ward, 1st Precinct",21,0,0,0,21,22474,480,10,0,22964
COUNTY COMMISSIONER,Jeff  HASTE,"City--2nd Ward, 2nd Precinct",25,0,0,0,25,22474,480,10,0,22964
COUNTY COMMISSIONER,Jeff  HASTE,City--3rd Ward,38,1,0,0,39,22474,480,10,0,22964
COUNTY COMMISSIONER,Jeff  HASTE,City--4th Ward,50,0,0,0,50,22474,480,10,0,22964
COUNTY COMMISSIONER,Jeff  HASTE,City--5th Ward,94,5,0,0,99,22474,480,10,0,22964
COUNTY COMMISSIONER,Jeff  HASTE,City--6th Ward,49,0,0,0,49,22474,480,10,0,22964
COUNTY COMMISSIONER,Jeff  HASTE,"City--7th Ward, 1st Precinct",21,1,0,0,22,22474,480,10,0,22964
COUNTY COMMISSIONER,Jeff  HASTE,"City--7th Ward, 2nd Precinct",18,1,0,0,19,22474,480,10,0,22964
COUNTY COMMISSIONER,Jeff  HASTE,City--8th Ward,20,0,0,0,20,22474,480,10,0,22964
COUNTY COMMISSIONER,Jeff  HASTE,"City--9th Ward, 1st Precinct",21,0,0,0,21,22474,480,10,0,22964
COUNTY COMMISSIONER,Jeff  HASTE,"City--9th Ward, 2nd Precinct",11,0,0,0,11,22474,480,10,0,22964
COUNTY COMMISSIONER,Jeff  HASTE,"City--9th Ward, 3rd Precinct",25,1,0,0,26,22474,480,10,0,22964
COUNTY COMMISSIONER,Jeff  HASTE,"City--9th Ward, 4th Precinct",80,2,0,0,82,22474,480,10,0,22964
COUNTY COMMISSIONER,Jeff  HASTE,"City--9th Ward, 5th Precinct",48,2,0,0,50,22474,480,10,0,22964
COUNTY COMMISSIONER,Jeff  HASTE,"City--10th Ward, 1st Precinct",58,3,0,0,61,22474,480,10,0,22964
COUNTY COMMISSIONER,Jeff  HASTE,"City--10th Ward, 2nd Precinct",12,0,0,0,12,22474,480,10,0,22964
COUNTY COMMISSIONER,Jeff  HASTE,"City--10th Ward, 3rd Precinct",47,0,0,0,47,22474,480,10,0,22964
COUNTY COMMISSIONER,Jeff  HASTE,"City--10th Ward, 4th Precinct",26,0,0,0,26,22474,480,10,0,22964
COUNTY COMMISSIONER,Jeff  HASTE,City--11th Ward,28,24,0,0,52,22474,480,10,0,22964
COUNTY COMMISSIONER,Jeff  HASTE,City--12th Ward,65,3,0,0,68,22474,480,10,0,22964
COUNTY COMMISSIONER,Jeff  HASTE,"City--13th Ward, 1st Precinct",43,0,0,0,43,22474,480,10,0,22964
COUNTY COMMISSIONER,Jeff  HASTE,"City--13th Ward, 2nd Precinct",69,4,0,0,73,22474,480,10,0,22964
COUNTY COMMISSIONER,Jeff  HASTE,"City--13th Ward, 3rd Precinct",78,1,0,0,79,22474,480,10,0,22964
COUNTY COMMISSIONER,Jeff  HASTE,City--14th Ward,125,0,0,0,125,22474,480,10,0,22964
COUNTY COMMISSIONER,Jeff  HASTE,City--15th Ward,19,0,0,0,19,22474,480,10,0,22964
COUNTY COMMISSIONER,Jeff  HASTE,Berrysburg Borough,44,0,0,0,44,22474,480,10,0,22964
COUNTY COMMISSIONER,Jeff  HASTE,Dauphin Borough,107,1,0,0,108,22474,480,10,0,22964
COUNTY COMMISSIONER,Jeff  HASTE,Elizabethville Borough,127,1,0,0,128,22474,480,10,0,22964
COUNTY COMMISSIONER,Jeff  HASTE,Gratz Borough,66,2,0,0,68,22474,480,10,0,22964
COUNTY COMMISSIONER,Jeff  HASTE,Halifax Borough,69,2,0,0,71,22474,480,10,0,22964
COUNTY COMMISSIONER,Jeff  HASTE,Highspire--1st Precinct,87,3,0,0,90,22474,480,10,0,22964
COUNTY COMMISSIONER,Jeff  HASTE,Highspire--2nd Precinct,82,0,0,0,82,22474,480,10,0,22964
COUNTY COMMISSIONER,Jeff  HASTE,Hummelstown--1st Precinct,124,3,0,0,127,22474,480,10,0,22964
COUNTY COMMISSIONER,Jeff  HASTE,Hummelstown--2nd Precinct,268,4,0,0,272,22474,480,10,0,22964
COUNTY COMMISSIONER,Jeff  HASTE,Lykens Borough--1st Ward,67,0,0,0,67,22474,480,10,0,22964
COUNTY COMMISSIONER,Jeff  HASTE,Lykens Borough--2nd Ward,88,2,0,0,90,22474,480,10,0,22964
COUNTY COMMISSIONER,Jeff  HASTE,"Middletown--1st Ward, 1st Precinct",63,0,0,0,63,22474,480,10,0,22964
COUNTY COMMISSIONER,Jeff  HASTE,"Middletown--1st Ward, 2nd Precinct",103,6,1,0,110,22474,480,10,0,22964
COUNTY COMMISSIONER,Jeff  HASTE,"Middletown--2nd Ward, 1st Precinct",107,3,0,0,110,22474,480,10,0,22964
COUNTY COMMISSIONER,Jeff  HASTE,"Middletown--2nd Ward, 2nd Precinct",112,3,0,0,115,22474,480,10,0,22964
COUNTY COMMISSIONER,Jeff  HASTE,"Middletown--3rd Ward, 1st Precinct",96,1,0,0,97,22474,480,10,0,22964
COUNTY COMMISSIONER,Jeff  HASTE,"Middletown--3rd Ward, 2nd Precinct",148,0,0,0,148,22474,480,10,0,22964
COUNTY COMMISSIONER,Jeff  HASTE,Millersburg--1st Ward,116,4,0,0,120,22474,480,10,0,22964
COUNTY COMMISSIONER,Jeff  HASTE,Millersburg--2nd Ward,137,3,0,0,140,22474,480,10,0,22964
COUNTY COMMISSIONER,Jeff  HASTE,Paxtang Borough,163,1,0,0,164,22474,480,10,0,22964
COUNTY COMMISSIONER,Jeff  HASTE,Penbrook Borough--1st Ward,28,1,0,0,29,22474,480,10,0,22964
COUNTY COMMISSIONER,Jeff  HASTE,Penbrook Borough--2nd Ward,46,1,0,0,47,22474,480,10,0,22964
COUNTY COMMISSIONER,Jeff  HASTE,Penbrook Borough--3rd Ward,46,0,0,0,46,22474,480,10,0,22964
COUNTY COMMISSIONER,Jeff  HASTE,Penbrook Borough--4th Ward,46,1,0,0,47,22474,480,10,0,22964
COUNTY COMMISSIONER,Jeff  HASTE,Royalton Borough--1st Ward,24,0,0,0,24,22474,480,10,0,22964
COUNTY COMMISSIONER,Jeff  HASTE,Royalton Borough--2nd Ward,61,0,0,0,61,22474,480,10,0,22964
COUNTY COMMISSIONER,Jeff  HASTE,Steelton--1st Ward,65,1,0,0,66,22474,480,10,0,22964
COUNTY COMMISSIONER,Jeff  HASTE,"Steelton--2nd Ward, 1st Precinct",36,2,0,0,38,22474,480,10,0,22964
COUNTY COMMISSIONER,Jeff  HASTE,"Steelton--2nd Ward, 2nd Precinct",51,1,0,0,52,22474,480,10,0,22964
COUNTY COMMISSIONER,Jeff  HASTE,"Steelton--3rd Ward, 1st Precinct",16,0,0,0,16,22474,480,10,0,22964
COUNTY COMMISSIONER,Jeff  HASTE,"Steelton--3rd Ward, 2nd Precinct",38,0,0,0,38,22474,480,10,0,22964
COUNTY COMMISSIONER,Jeff  HASTE,Steelton--4th Ward,41,0,0,0,41,22474,480,10,0,22964
COUNTY COMMISSIONER,Jeff  HASTE,Pillow Borough,34,0,0,0,34,22474,480,10,0,22964
COUNTY COMMISSIONER,Jeff  HASTE,Williamstown--1st Ward,72,1,0,0,73,22474,480,10,0,22964
COUNTY COMMISSIONER,Jeff  HASTE,Williamstown--2nd Ward,48,0,0,0,48,22474,480,10,0,22964
COUNTY COMMISSIONER,Jeff  HASTE,Conewago Twp--1st Precinct,233,1,0,0,234,22474,480,10,0,22964
COUNTY COMMISSIONER,Jeff  HASTE,Conewago Twp--2nd Precinct,162,7,0,0,169,22474,480,10,0,22964
COUNTY COMMISSIONER,Jeff  HASTE,Derry Township--1st Precinct,233,3,0,0,236,22474,480,10,0,22964
COUNTY COMMISSIONER,Jeff  HASTE,Derry Township--2nd Precinct,197,4,0,0,201,22474,480,10,0,22964
COUNTY COMMISSIONER,Jeff  HASTE,Derry Township--3rd Precinct,135,3,0,0,138,22474,480,10,0,22964
COUNTY COMMISSIONER,Jeff  HASTE,Derry Township--4th Precinct,125,4,0,0,129,22474,480,10,0,22964
COUNTY COMMISSIONER,Jeff  HASTE,Derry Township--5th Precinct,110,3,0,0,113,22474,480,10,0,22964
COUNTY COMMISSIONER,Jeff  HASTE,Derry Township--6th Precinct,111,0,1,0,112,22474,480,10,0,22964
COUNTY COMMISSIONER,Jeff  HASTE,Derry Township--7th Precinct,304,11,0,0,315,22474,480,10,0,22964
COUNTY COMMISSIONER,Jeff  HASTE,Derry Township--8th Precinct,135,0,0,0,135,22474,480,10,0,22964
COUNTY COMMISSIONER,Jeff  HASTE,Derry Township--9th Precinct,78,3,0,0,81,22474,480,10,0,22964
COUNTY COMMISSIONER,Jeff  HASTE,Derry Township--10th Precinct,201,3,0,0,204,22474,480,10,0,22964
COUNTY COMMISSIONER,Jeff  HASTE,Derry Township--11th Precinct,250,6,0,0,256,22474,480,10,0,22964
COUNTY COMMISSIONER,Jeff  HASTE,Derry Township--12th Precinct,136,3,0,0,139,22474,480,10,0,22964
COUNTY COMMISSIONER,Jeff  HASTE,Derry Township--13th Precinct,188,7,0,0,195,22474,480,10,0,22964
COUNTY COMMISSIONER,Jeff  HASTE,Derry Township--14th Precinct,119,3,0,0,122,22474,480,10,0,22964
COUNTY COMMISSIONER,Jeff  HASTE,Derry Township--15th Precinct,248,3,1,0,252,22474,480,10,0,22964
COUNTY COMMISSIONER,Jeff  HASTE,East Hanover Township--1st Precinct,252,7,0,0,259,22474,480,10,0,22964
COUNTY COMMISSIONER,Jeff  HASTE,East Hanover Township--2nd Precinct,279,3,0,0,282,22474,480,10,0,22964
COUNTY COMMISSIONER,Jeff  HASTE,Halifax Twp--1st Precinct,211,2,0,0,213,22474,480,10,0,22964
COUNTY COMMISSIONER,Jeff  HASTE,Halifax Twp--2nd Precinct,265,9,0,0,274,22474,480,10,0,22964
COUNTY COMMISSIONER,Jeff  HASTE,Jackson Township,176,1,0,0,177,22474,480,10,0,22964
COUNTY COMMISSIONER,Jeff  HASTE,Jefferson Township,55,0,0,0,55,22474,480,10,0,22964
COUNTY COMMISSIONER,Jeff  HASTE,Londonderry Twp--1st Precinct,229,0,0,0,229,22474,480,10,0,22964
COUNTY COMMISSIONER,Jeff  HASTE,Londonderry Twp--2nd Precinct,210,4,0,0,214,22474,480,10,0,22964
COUNTY COMMISSIONER,Jeff  HASTE,Londonderry Twp--3rd Precinct,87,1,0,0,88,22474,480,10,0,22964
COUNTY COMMISSIONER,Jeff  HASTE,Lower Paxton Twp--1st Precinct,151,1,0,0,152,22474,480,10,0,22964
COUNTY COMMISSIONER,Jeff  HASTE,Lower Paxton Twp--2nd Precinct,142,4,0,0,146,22474,480,10,0,22964
COUNTY COMMISSIONER,Jeff  HASTE,Lower Paxton Twp--3rd precinct,300,9,0,0,309,22474,480,10,0,22964
COUNTY COMMISSIONER,Jeff  HASTE,Lower Paxton Twp--4th Precinct,217,3,0,0,220,22474,480,10,0,22964
COUNTY COMMISSIONER,Jeff  HASTE,Lower Paxton Twp--5th Precinct,174,4,0,0,178,22474,480,10,0,22964
COUNTY COMMISSIONER,Jeff  HASTE,Lower Paxton Twp--6th Precinct,119,4,0,0,123,22474,480,10,0,22964
COUNTY COMMISSIONER,Jeff  HASTE,Lower Paxton Twp--7th Precinct,271,4,0,0,275,22474,480,10,0,22964
COUNTY COMMISSIONER,Jeff  HASTE,Lower Paxton Twp--8th Precinct,109,2,0,0,111,22474,480,10,0,22964
COUNTY COMMISSIONER,Jeff  HASTE,Lower Paxton Twp--9th Precinct,167,4,0,0,171,22474,480,10,0,22964
COUNTY COMMISSIONER,Jeff  HASTE,Lower Paxton Twp--10th Precinct,83,3,0,0,86,22474,480,10,0,22964
COUNTY COMMISSIONER,Jeff  HASTE,Lower Paxton Twp--11th Precinct,141,2,1,0,144,22474,480,10,0,22964
COUNTY COMMISSIONER,Jeff  HASTE,Lower Paxton Twp--12th Precinct,231,7,1,0,239,22474,480,10,0,22964
COUNTY COMMISSIONER,Jeff  HASTE,Lower Paxton Twp--13th Precinct,186,1,0,0,187,22474,480,10,0,22964
COUNTY COMMISSIONER,Jeff  HASTE,Lower Paxton Twp--14th Precinct,101,3,1,0,105,22474,480,10,0,22964
COUNTY COMMISSIONER,Jeff  HASTE,Lower Paxton Twp--15th Precinct,185,4,0,0,189,22474,480,10,0,22964
COUNTY COMMISSIONER,Jeff  HASTE,Lower Paxton Twp--16th Precinct,318,9,0,0,327,22474,480,10,0,22964
COUNTY COMMISSIONER,Jeff  HASTE,Lower Paxton Twp--17th Precinct,136,6,0,0,142,22474,480,10,0,22964
COUNTY COMMISSIONER,Jeff  HASTE,Lower Paxton Twp--18th Precinct,139,2,0,0,141,22474,480,10,0,22964
COUNTY COMMISSIONER,Jeff  HASTE,Lower Paxton Twp--19th Precinct,246,15,0,0,261,22474,480,10,0,22964
COUNTY COMMISSIONER,Jeff  HASTE,Lower Paxton Twp--20th Precinct,197,4,0,0,201,22474,480,10,0,22964
COUNTY COMMISSIONER,Jeff  HASTE,Lower Paxton Twp--21st Precinct,260,3,0,0,263,22474,480,10,0,22964
COUNTY COMMISSIONER,Jeff  HASTE,Lower Paxton Twp--22nd Precinct,222,5,0,0,227,22474,480,10,0,22964
COUNTY COMMISSIONER,Jeff  HASTE,Lower Paxton Twp--23rd Precinct,208,3,0,0,211,22474,480,10,0,22964
COUNTY COMMISSIONER,Jeff  HASTE,Lower Paxton Twp--24th Precinct,191,6,0,0,197,22474,480,10,0,22964
COUNTY COMMISSIONER,Jeff  HASTE,Lower Paxton Twp--25th Precinct,116,3,0,0,119,22474,480,10,0,22964
COUNTY COMMISSIONER,Jeff  HASTE,Lower Paxton Twp--26th Precinct,169,4,0,0,173,22474,480,10,0,22964
COUNTY COMMISSIONER,Jeff  HASTE,Lower Paxton Twp--27th Precinct,149,2,0,0,151,22474,480,10,0,22964
COUNTY COMMISSIONER,Jeff  HASTE,Lower Swatara Twp--1st Precinct,268,2,0,0,270,22474,480,10,0,22964
COUNTY COMMISSIONER,Jeff  HASTE,Lower Swatara Twp--2nd Precinct,216,4,0,0,220,22474,480,10,0,22964
COUNTY COMMISSIONER,Jeff  HASTE,Lower Swatara Twp--3rd Precinct,191,19,0,0,210,22474,480,10,0,22964
COUNTY COMMISSIONER,Jeff  HASTE,Lower Swatara Twp--4th Precinct,190,1,0,0,191,22474,480,10,0,22964
COUNTY COMMISSIONER,Jeff  HASTE,Lykens Township,76,0,0,0,76,22474,480,10,0,22964
COUNTY COMMISSIONER,Jeff  HASTE,Middle Paxton Twp--1st Precinct,266,0,0,0,266,22474,480,10,0,22964
COUNTY COMMISSIONER,Jeff  HASTE,Middle Paxton Twp--2nd Precinct,185,2,0,0,187,22474,480,10,0,22964
COUNTY COMMISSIONER,Jeff  HASTE,Middle Paxton Twp--3rd Precinct,293,1,0,0,294,22474,480,10,0,22964
COUNTY COMMISSIONER,Jeff  HASTE,Mifflin Township,69,0,0,0,69,22474,480,10,0,22964
COUNTY COMMISSIONER,Jeff  HASTE,Reed Township,32,0,0,0,32,22474,480,10,0,22964
COUNTY COMMISSIONER,Jeff  HASTE,Rush Township,29,0,0,0,29,22474,480,10,0,22964
COUNTY COMMISSIONER,Jeff  HASTE,South Hanover Twp--1st Precinct,223,5,0,0,228,22474,480,10,0,22964
COUNTY COMMISSIONER,Jeff  HASTE,South Hanover Twp--2nd Precinct,293,4,0,0,297,22474,480,10,0,22964
COUNTY COMMISSIONER,Jeff  HASTE,South Hanover Twp--3rd Precinct,168,1,0,0,169,22474,480,10,0,22964
COUNTY COMMISSIONER,Jeff  HASTE,Susquehanna Twp--1st Ward,261,11,0,0,272,22474,480,10,0,22964
COUNTY COMMISSIONER,Jeff  HASTE,Susquehanna Twp--2nd Ward,461,18,0,0,479,22474,480,10,0,22964
COUNTY COMMISSIONER,Jeff  HASTE,Susquehanna Twp--3rd Ward,147,0,0,0,147,22474,480,10,0,22964
COUNTY COMMISSIONER,Jeff  HASTE,Susquehanna Twp--4th Ward,174,5,0,0,179,22474,480,10,0,22964
COUNTY COMMISSIONER,Jeff  HASTE,Susquehanna Twp--5th Ward,227,5,0,0,232,22474,480,10,0,22964
COUNTY COMMISSIONER,Jeff  HASTE,Susquehanna Twp--6th Ward,267,5,0,0,272,22474,480,10,0,22964
COUNTY COMMISSIONER,Jeff  HASTE,Susquehanna Twp--7th Ward,131,0,0,0,131,22474,480,10,0,22964
COUNTY COMMISSIONER,Jeff  HASTE,Susquehanna Twp--8th Ward,343,10,0,0,353,22474,480,10,0,22964
COUNTY COMMISSIONER,Jeff  HASTE,Susquehanna Twp--9th Ward,201,1,0,0,202,22474,480,10,0,22964
COUNTY COMMISSIONER,Jeff  HASTE,Swatara Township--1st Ward,178,3,0,0,181,22474,480,10,0,22964
COUNTY COMMISSIONER,Jeff  HASTE,Swatara Township--2nd Ward,100,11,0,0,111,22474,480,10,0,22964
COUNTY COMMISSIONER,Jeff  HASTE,Swatara Township--3rd Ward,117,3,0,0,120,22474,480,10,0,22964
COUNTY COMMISSIONER,Jeff  HASTE,Swatara Township--4th Ward,226,8,0,0,234,22474,480,10,0,22964
COUNTY COMMISSIONER,Jeff  HASTE,Swatara Township--5th Ward,305,2,0,0,307,22474,480,10,0,22964
COUNTY COMMISSIONER,Jeff  HASTE,Swatara Township--6th Ward,263,2,1,0,266,22474,480,10,0,22964
COUNTY COMMISSIONER,Jeff  HASTE,Swatara Township--7th Ward,248,6,0,0,254,22474,480,10,0,22964
COUNTY COMMISSIONER,Jeff  HASTE,Swatara Township--8th Ward,341,6,0,0,347,22474,480,10,0,22964
COUNTY COMMISSIONER,Jeff  HASTE,Swatara Township--9th Ward,122,3,0,0,125,22474,480,10,0,22964
COUNTY COMMISSIONER,Jeff  HASTE,Upper Paxton Twp--1st Precinct,233,1,0,0,234,22474,480,10,0,22964
COUNTY COMMISSIONER,Jeff  HASTE,Upper Paxton Twp--2nd Precinct,155,2,0,0,157,22474,480,10,0,22964
COUNTY COMMISSIONER,Jeff  HASTE,Washington Township,225,6,0,0,231,22474,480,10,0,22964
COUNTY COMMISSIONER,Jeff  HASTE,Wayne Township,185,1,0,0,186,22474,480,10,0,22964
COUNTY COMMISSIONER,Jeff  HASTE,West Hanover Twp--1st Precinct,217,5,1,0,223,22474,480,10,0,22964
COUNTY COMMISSIONER,Jeff  HASTE,West Hanover Twp--2nd Precinct,205,5,1,0,211,22474,480,10,0,22964
COUNTY COMMISSIONER,Jeff  HASTE,West Hanover Twp--3rd Precinct,470,12,1,0,483,22474,480,10,0,22964
COUNTY COMMISSIONER,Jeff  HASTE,West Hanover Twp--4th Precinct,267,1,0,0,268,22474,480,10,0,22964
COUNTY COMMISSIONER,Jeff  HASTE,Wiconisco Twp--1st Precinct,58,1,0,0,59,22474,480,10,0,22964
COUNTY COMMISSIONER,Jeff  HASTE,Wiconisco Twp--2nd Precinct,47,1,0,0,48,22474,480,10,0,22964
COUNTY COMMISSIONER,Jeff  HASTE,Williams Twp,117,1,0,0,118,22474,480,10,0,22964
COUNTY COMMISSIONER,Nick  DiFRANCESCO,"City--1st Ward, 1st Precinct",32,3,0,0,35,23331,469,13,0,23813
COUNTY COMMISSIONER,Nick  DiFRANCESCO,"City--1st Ward, 2nd Precinct",67,1,0,0,68,23331,469,13,0,23813
COUNTY COMMISSIONER,Nick  DiFRANCESCO,"City--1st Ward, 3rd Precinct",16,0,0,0,16,23331,469,13,0,23813
COUNTY COMMISSIONER,Nick  DiFRANCESCO,"City--2nd Ward, 1st Precinct",23,0,0,0,23,23331,469,13,0,23813
COUNTY COMMISSIONER,Nick  DiFRANCESCO,"City--2nd Ward, 2nd Precinct",26,1,0,0,27,23331,469,13,0,23813
COUNTY COMMISSIONER,Nick  DiFRANCESCO,City--3rd Ward,43,0,0,0,43,23331,469,13,0,23813
COUNTY COMMISSIONER,Nick  DiFRANCESCO,City--4th Ward,57,1,0,0,58,23331,469,13,0,23813
COUNTY COMMISSIONER,Nick  DiFRANCESCO,City--5th Ward,107,5,0,0,112,23331,469,13,0,23813
COUNTY COMMISSIONER,Nick  DiFRANCESCO,City--6th Ward,59,1,1,0,61,23331,469,13,0,23813
COUNTY COMMISSIONER,Nick  DiFRANCESCO,"City--7th Ward, 1st Precinct",26,0,0,0,26,23331,469,13,0,23813
COUNTY COMMISSIONER,Nick  DiFRANCESCO,"City--7th Ward, 2nd Precinct",21,2,0,0,23,23331,469,13,0,23813
COUNTY COMMISSIONER,Nick  DiFRANCESCO,City--8th Ward,9,0,0,0,9,23331,469,13,0,23813
COUNTY COMMISSIONER,Nick  DiFRANCESCO,"City--9th Ward, 1st Precinct",19,1,0,0,20,23331,469,13,0,23813
COUNTY COMMISSIONER,Nick  DiFRANCESCO,"City--9th Ward, 2nd Precinct",15,0,0,0,15,23331,469,13,0,23813
COUNTY COMMISSIONER,Nick  DiFRANCESCO,"City--9th Ward, 3rd Precinct",26,1,0,0,27,23331,469,13,0,23813
COUNTY COMMISSIONER,Nick  DiFRANCESCO,"City--9th Ward, 4th Precinct",92,2,0,0,94,23331,469,13,0,23813
COUNTY COMMISSIONER,Nick  DiFRANCESCO,"City--9th Ward, 5th Precinct",51,3,0,0,54,23331,469,13,0,23813
COUNTY COMMISSIONER,Nick  DiFRANCESCO,"City--10th Ward, 1st Precinct",70,5,0,0,75,23331,469,13,0,23813
COUNTY COMMISSIONER,Nick  DiFRANCESCO,"City--10th Ward, 2nd Precinct",19,0,0,0,19,23331,469,13,0,23813
COUNTY COMMISSIONER,Nick  DiFRANCESCO,"City--10th Ward, 3rd Precinct",60,1,0,0,61,23331,469,13,0,23813
COUNTY COMMISSIONER,Nick  DiFRANCESCO,"City--10th Ward, 4th Precinct",21,0,0,0,21,23331,469,13,0,23813
COUNTY COMMISSIONER,Nick  DiFRANCESCO,City--11th Ward,33,26,0,0,59,23331,469,13,0,23813
COUNTY COMMISSIONER,Nick  DiFRANCESCO,City--12th Ward,78,4,0,0,82,23331,469,13,0,23813
COUNTY COMMISSIONER,Nick  DiFRANCESCO,"City--13th Ward, 1st Precinct",44,0,0,0,44,23331,469,13,0,23813
COUNTY COMMISSIONER,Nick  DiFRANCESCO,"City--13th Ward, 2nd Precinct",70,2,0,0,72,23331,469,13,0,23813
COUNTY COMMISSIONER,Nick  DiFRANCESCO,"City--13th Ward, 3rd Precinct",101,1,0,0,102,23331,469,13,0,23813
COUNTY COMMISSIONER,Nick  DiFRANCESCO,City--14th Ward,131,0,0,0,131,23331,469,13,0,23813
COUNTY COMMISSIONER,Nick  DiFRANCESCO,City--15th Ward,13,0,0,0,13,23331,469,13,0,23813
COUNTY COMMISSIONER,Nick  DiFRANCESCO,Berrysburg Borough,40,0,0,0,40,23331,469,13,0,23813
COUNTY COMMISSIONER,Nick  DiFRANCESCO,Dauphin Borough,117,1,0,0,118,23331,469,13,0,23813
COUNTY COMMISSIONER,Nick  DiFRANCESCO,Elizabethville Borough,115,0,0,0,115,23331,469,13,0,23813
COUNTY COMMISSIONER,Nick  DiFRANCESCO,Gratz Borough,65,2,0,0,67,23331,469,13,0,23813
COUNTY COMMISSIONER,Nick  DiFRANCESCO,Halifax Borough,63,2,0,0,65,23331,469,13,0,23813
COUNTY COMMISSIONER,Nick  DiFRANCESCO,Highspire--1st Precinct,98,3,0,0,101,23331,469,13,0,23813
COUNTY COMMISSIONER,Nick  DiFRANCESCO,Highspire--2nd Precinct,108,1,0,0,109,23331,469,13,0,23813
COUNTY COMMISSIONER,Nick  DiFRANCESCO,Hummelstown--1st Precinct,128,4,0,0,132,23331,469,13,0,23813
COUNTY COMMISSIONER,Nick  DiFRANCESCO,Hummelstown--2nd Precinct,283,4,0,0,287,23331,469,13,0,23813
COUNTY COMMISSIONER,Nick  DiFRANCESCO,Lykens Borough--1st Ward,64,0,0,0,64,23331,469,13,0,23813
COUNTY COMMISSIONER,Nick  DiFRANCESCO,Lykens Borough--2nd Ward,88,4,0,0,92,23331,469,13,0,23813
COUNTY COMMISSIONER,Nick  DiFRANCESCO,"Middletown--1st Ward, 1st Precinct",78,0,0,0,78,23331,469,13,0,23813
COUNTY COMMISSIONER,Nick  DiFRANCESCO,"Middletown--1st Ward, 2nd Precinct",120,7,1,0,128,23331,469,13,0,23813
COUNTY COMMISSIONER,Nick  DiFRANCESCO,"Middletown--2nd Ward, 1st Precinct",133,1,0,0,134,23331,469,13,0,23813
COUNTY COMMISSIONER,Nick  DiFRANCESCO,"Middletown--2nd Ward, 2nd Precinct",140,4,0,0,144,23331,469,13,0,23813
COUNTY COMMISSIONER,Nick  DiFRANCESCO,"Middletown--3rd Ward, 1st Precinct",115,1,0,0,116,23331,469,13,0,23813
COUNTY COMMISSIONER,Nick  DiFRANCESCO,"Middletown--3rd Ward, 2nd Precinct",183,0,0,0,183,23331,469,13,0,23813
COUNTY COMMISSIONER,Nick  DiFRANCESCO,Millersburg--1st Ward,105,2,0,0,107,23331,469,13,0,23813
COUNTY COMMISSIONER,Nick  DiFRANCESCO,Millersburg--2nd Ward,124,3,0,0,127,23331,469,13,0,23813
COUNTY COMMISSIONER,Nick  DiFRANCESCO,Paxtang Borough,177,0,0,0,177,23331,469,13,0,23813
COUNTY COMMISSIONER,Nick  DiFRANCESCO,Penbrook Borough--1st Ward,27,1,0,0,28,23331,469,13,0,23813
COUNTY COMMISSIONER,Nick  DiFRANCESCO,Penbrook Borough--2nd Ward,46,1,0,0,47,23331,469,13,0,23813
COUNTY COMMISSIONER,Nick  DiFRANCESCO,Penbrook Borough--3rd Ward,52,0,0,0,52,23331,469,13,0,23813
COUNTY COMMISSIONER,Nick  DiFRANCESCO,Penbrook Borough--4th Ward,52,2,0,0,54,23331,469,13,0,23813
COUNTY COMMISSIONER,Nick  DiFRANCESCO,Royalton Borough--1st Ward,32,0,0,0,32,23331,469,13,0,23813
COUNTY COMMISSIONER,Nick  DiFRANCESCO,Royalton Borough--2nd Ward,72,0,0,0,72,23331,469,13,0,23813
COUNTY COMMISSIONER,Nick  DiFRANCESCO,Steelton--1st Ward,94,1,0,0,95,23331,469,13,0,23813
COUNTY COMMISSIONER,Nick  DiFRANCESCO,"Steelton--2nd Ward, 1st Precinct",48,2,0,0,50,23331,469,13,0,23813
COUNTY COMMISSIONER,Nick  DiFRANCESCO,"Steelton--2nd Ward, 2nd Precinct",59,1,0,0,60,23331,469,13,0,23813
COUNTY COMMISSIONER,Nick  DiFRANCESCO,"Steelton--3rd Ward, 1st Precinct",22,0,0,0,22,23331,469,13,0,23813
COUNTY COMMISSIONER,Nick  DiFRANCESCO,"Steelton--3rd Ward, 2nd Precinct",38,0,0,0,38,23331,469,13,0,23813
COUNTY COMMISSIONER,Nick  DiFRANCESCO,Steelton--4th Ward,52,0,1,0,53,23331,469,13,0,23813
COUNTY COMMISSIONER,Nick  DiFRANCESCO,Pillow Borough,29,0,0,0,29,23331,469,13,0,23813
COUNTY COMMISSIONER,Nick  DiFRANCESCO,Williamstown--1st Ward,73,0,0,0,73,23331,469,13,0,23813
COUNTY COMMISSIONER,Nick  DiFRANCESCO,Williamstown--2nd Ward,44,0,0,0,44,23331,469,13,0,23813
COUNTY COMMISSIONER,Nick  DiFRANCESCO,Conewago Twp--1st Precinct,223,1,0,0,224,23331,469,13,0,23813
COUNTY COMMISSIONER,Nick  DiFRANCESCO,Conewago Twp--2nd Precinct,168,7,0,0,175,23331,469,13,0,23813
COUNTY COMMISSIONER,Nick  DiFRANCESCO,Derry Township--1st Precinct,263,4,0,0,267,23331,469,13,0,23813
COUNTY COMMISSIONER,Nick  DiFRANCESCO,Derry Township--2nd Precinct,207,3,0,0,210,23331,469,13,0,23813
COUNTY COMMISSIONER,Nick  DiFRANCESCO,Derry Township--3rd Precinct,147,2,0,0,149,23331,469,13,0,23813
COUNTY COMMISSIONER,Nick  DiFRANCESCO,Derry Township--4th Precinct,130,4,0,0,134,23331,469,13,0,23813
COUNTY COMMISSIONER,Nick  DiFRANCESCO,Derry Township--5th Precinct,117,3,0,0,120,23331,469,13,0,23813
COUNTY COMMISSIONER,Nick  DiFRANCESCO,Derry Township--6th Precinct,122,1,1,0,124,23331,469,13,0,23813
COUNTY COMMISSIONER,Nick  DiFRANCESCO,Derry Township--7th Precinct,303,12,0,0,315,23331,469,13,0,23813
COUNTY COMMISSIONER,Nick  DiFRANCESCO,Derry Township--8th Precinct,135,0,0,0,135,23331,469,13,0,23813
COUNTY COMMISSIONER,Nick  DiFRANCESCO,Derry Township--9th Precinct,83,2,0,0,85,23331,469,13,0,23813
COUNTY COMMISSIONER,Nick  DiFRANCESCO,Derry Township--10th Precinct,205,3,0,0,208,23331,469,13,0,23813
COUNTY COMMISSIONER,Nick  DiFRANCESCO,Derry Township--11th Precinct,242,5,0,0,247,23331,469,13,0,23813
COUNTY COMMISSIONER,Nick  DiFRANCESCO,Derry Township--12th Precinct,133,0,0,0,133,23331,469,13,0,23813
COUNTY COMMISSIONER,Nick  DiFRANCESCO,Derry Township--13th Precinct,203,5,0,0,208,23331,469,13,0,23813
COUNTY COMMISSIONER,Nick  DiFRANCESCO,Derry Township--14th Precinct,119,5,0,0,124,23331,469,13,0,23813
COUNTY COMMISSIONER,Nick  DiFRANCESCO,Derry Township--15th Precinct,255,4,1,0,260,23331,469,13,0,23813
COUNTY COMMISSIONER,Nick  DiFRANCESCO,East Hanover Township--1st Precinct,276,7,0,0,283,23331,469,13,0,23813
COUNTY COMMISSIONER,Nick  DiFRANCESCO,East Hanover Township--2nd Precinct,300,4,0,0,304,23331,469,13,0,23813
COUNTY COMMISSIONER,Nick  DiFRANCESCO,Halifax Twp--1st Precinct,191,3,0,0,194,23331,469,13,0,23813
COUNTY COMMISSIONER,Nick  DiFRANCESCO,Halifax Twp--2nd Precinct,244,9,0,0,253,23331,469,13,0,23813
COUNTY COMMISSIONER,Nick  DiFRANCESCO,Jackson Township,146,1,0,0,147,23331,469,13,0,23813
COUNTY COMMISSIONER,Nick  DiFRANCESCO,Jefferson Township,50,0,0,0,50,23331,469,13,0,23813
COUNTY COMMISSIONER,Nick  DiFRANCESCO,Londonderry Twp--1st Precinct,246,0,0,0,246,23331,469,13,0,23813
COUNTY COMMISSIONER,Nick  DiFRANCESCO,Londonderry Twp--2nd Precinct,247,4,0,0,251,23331,469,13,0,23813
COUNTY COMMISSIONER,Nick  DiFRANCESCO,Londonderry Twp--3rd Precinct,103,1,0,0,104,23331,469,13,0,23813
COUNTY COMMISSIONER,Nick  DiFRANCESCO,Lower Paxton Twp--1st Precinct,161,2,0,0,163,23331,469,13,0,23813
COUNTY COMMISSIONER,Nick  DiFRANCESCO,Lower Paxton Twp--2nd Precinct,162,5,0,0,167,23331,469,13,0,23813
COUNTY COMMISSIONER,Nick  DiFRANCESCO,Lower Paxton Twp--3rd precinct,302,8,0,0,310,23331,469,13,0,23813
COUNTY COMMISSIONER,Nick  DiFRANCESCO,Lower Paxton Twp--4th Precinct,224,3,0,0,227,23331,469,13,0,23813
COUNTY COMMISSIONER,Nick  DiFRANCESCO,Lower Paxton Twp--5th Precinct,177,3,0,0,180,23331,469,13,0,23813
COUNTY COMMISSIONER,Nick  DiFRANCESCO,Lower Paxton Twp--6th Precinct,120,3,0,0,123,23331,469,13,0,23813
COUNTY COMMISSIONER,Nick  DiFRANCESCO,Lower Paxton Twp--7th Precinct,290,3,0,0,293,23331,469,13,0,23813
COUNTY COMMISSIONER,Nick  DiFRANCESCO,Lower Paxton Twp--8th Precinct,114,2,0,0,116,23331,469,13,0,23813
COUNTY COMMISSIONER,Nick  DiFRANCESCO,Lower Paxton Twp--9th Precinct,162,4,0,0,166,23331,469,13,0,23813
COUNTY COMMISSIONER,Nick  DiFRANCESCO,Lower Paxton Twp--10th Precinct,81,3,0,0,84,23331,469,13,0,23813
COUNTY COMMISSIONER,Nick  DiFRANCESCO,Lower Paxton Twp--11th Precinct,158,1,1,0,160,23331,469,13,0,23813
COUNTY COMMISSIONER,Nick  DiFRANCESCO,Lower Paxton Twp--12th Precinct,231,6,1,0,238,23331,469,13,0,23813
COUNTY COMMISSIONER,Nick  DiFRANCESCO,Lower Paxton Twp--13th Precinct,200,1,0,0,201,23331,469,13,0,23813
COUNTY COMMISSIONER,Nick  DiFRANCESCO,Lower Paxton Twp--14th Precinct,98,3,2,0,103,23331,469,13,0,23813
COUNTY COMMISSIONER,Nick  DiFRANCESCO,Lower Paxton Twp--15th Precinct,201,3,0,0,204,23331,469,13,0,23813
COUNTY COMMISSIONER,Nick  DiFRANCESCO,Lower Paxton Twp--16th Precinct,326,9,0,0,335,23331,469,13,0,23813
COUNTY COMMISSIONER,Nick  DiFRANCESCO,Lower Paxton Twp--17th Precinct,142,2,0,0,144,23331,469,13,0,23813
COUNTY COMMISSIONER,Nick  DiFRANCESCO,Lower Paxton Twp--18th Precinct,127,1,0,0,128,23331,469,13,0,23813
COUNTY COMMISSIONER,Nick  DiFRANCESCO,Lower Paxton Twp--19th Precinct,264,13,0,0,277,23331,469,13,0,23813
COUNTY COMMISSIONER,Nick  DiFRANCESCO,Lower Paxton Twp--20th Precinct,220,5,0,0,225,23331,469,13,0,23813
COUNTY COMMISSIONER,Nick  DiFRANCESCO,Lower Paxton Twp--21st Precinct,254,3,0,0,257,23331,469,13,0,23813
COUNTY COMMISSIONER,Nick  DiFRANCESCO,Lower Paxton Twp--22nd Precinct,225,3,0,0,228,23331,469,13,0,23813
COUNTY COMMISSIONER,Nick  DiFRANCESCO,Lower Paxton Twp--23rd Precinct,202,3,0,0,205,23331,469,13,0,23813
COUNTY COMMISSIONER,Nick  DiFRANCESCO,Lower Paxton Twp--24th Precinct,195,6,0,0,201,23331,469,13,0,23813
COUNTY COMMISSIONER,Nick  DiFRANCESCO,Lower Paxton Twp--25th Precinct,127,3,0,0,130,23331,469,13,0,23813
COUNTY COMMISSIONER,Nick  DiFRANCESCO,Lower Paxton Twp--26th Precinct,193,5,0,0,198,23331,469,13,0,23813
COUNTY COMMISSIONER,Nick  DiFRANCESCO,Lower Paxton Twp--27th Precinct,176,0,0,0,176,23331,469,13,0,23813
COUNTY COMMISSIONER,Nick  DiFRANCESCO,Lower Swatara Twp--1st Precinct,334,2,0,0,336,23331,469,13,0,23813
COUNTY COMMISSIONER,Nick  DiFRANCESCO,Lower Swatara Twp--2nd Precinct,259,4,0,0,263,23331,469,13,0,23813
COUNTY COMMISSIONER,Nick  DiFRANCESCO,Lower Swatara Twp--3rd Precinct,242,18,0,0,260,23331,469,13,0,23813
COUNTY COMMISSIONER,Nick  DiFRANCESCO,Lower Swatara Twp--4th Precinct,237,1,0,0,238,23331,469,13,0,23813
COUNTY COMMISSIONER,Nick  DiFRANCESCO,Lykens Township,69,0,0,0,69,23331,469,13,0,23813
COUNTY COMMISSIONER,Nick  DiFRANCESCO,Middle Paxton Twp--1st Precinct,224,0,0,0,224,23331,469,13,0,23813
COUNTY COMMISSIONER,Nick  DiFRANCESCO,Middle Paxton Twp--2nd Precinct,176,2,0,0,178,23331,469,13,0,23813
COUNTY COMMISSIONER,Nick  DiFRANCESCO,Middle Paxton Twp--3rd Precinct,271,1,0,0,272,23331,469,13,0,23813
COUNTY COMMISSIONER,Nick  DiFRANCESCO,Mifflin Township,63,0,0,0,63,23331,469,13,0,23813
COUNTY COMMISSIONER,Nick  DiFRANCESCO,Reed Township,28,0,0,0,28,23331,469,13,0,23813
COUNTY COMMISSIONER,Nick  DiFRANCESCO,Rush Township,33,0,0,0,33,23331,469,13,0,23813
COUNTY COMMISSIONER,Nick  DiFRANCESCO,South Hanover Twp--1st Precinct,218,3,0,0,221,23331,469,13,0,23813
COUNTY COMMISSIONER,Nick  DiFRANCESCO,South Hanover Twp--2nd Precinct,302,6,0,0,308,23331,469,13,0,23813
COUNTY COMMISSIONER,Nick  DiFRANCESCO,South Hanover Twp--3rd Precinct,164,2,0,0,166,23331,469,13,0,23813
COUNTY COMMISSIONER,Nick  DiFRANCESCO,Susquehanna Twp--1st Ward,234,10,0,0,244,23331,469,13,0,23813
COUNTY COMMISSIONER,Nick  DiFRANCESCO,Susquehanna Twp--2nd Ward,436,17,0,0,453,23331,469,13,0,23813
COUNTY COMMISSIONER,Nick  DiFRANCESCO,Susquehanna Twp--3rd Ward,130,0,0,0,130,23331,469,13,0,23813
COUNTY COMMISSIONER,Nick  DiFRANCESCO,Susquehanna Twp--4th Ward,166,3,0,0,169,23331,469,13,0,23813
COUNTY COMMISSIONER,Nick  DiFRANCESCO,Susquehanna Twp--5th Ward,230,3,0,0,233,23331,469,13,0,23813
COUNTY COMMISSIONER,Nick  DiFRANCESCO,Susquehanna Twp--6th Ward,284,7,0,0,291,23331,469,13,0,23813
COUNTY COMMISSIONER,Nick  DiFRANCESCO,Susquehanna Twp--7th Ward,107,0,0,0,107,23331,469,13,0,23813
COUNTY COMMISSIONER,Nick  DiFRANCESCO,Susquehanna Twp--8th Ward,324,11,0,0,335,23331,469,13,0,23813
COUNTY COMMISSIONER,Nick  DiFRANCESCO,Susquehanna Twp--9th Ward,194,1,0,0,195,23331,469,13,0,23813
COUNTY COMMISSIONER,Nick  DiFRANCESCO,Swatara Township--1st Ward,182,3,0,0,185,23331,469,13,0,23813
COUNTY COMMISSIONER,Nick  DiFRANCESCO,Swatara Township--2nd Ward,112,9,0,0,121,23331,469,13,0,23813
COUNTY COMMISSIONER,Nick  DiFRANCESCO,Swatara Township--3rd Ward,136,1,0,0,137,23331,469,13,0,23813
COUNTY COMMISSIONER,Nick  DiFRANCESCO,Swatara Township--4th Ward,234,8,0,0,242,23331,469,13,0,23813
COUNTY COMMISSIONER,Nick  DiFRANCESCO,Swatara Township--5th Ward,343,4,0,0,347,23331,469,13,0,23813
COUNTY COMMISSIONER,Nick  DiFRANCESCO,Swatara Township--6th Ward,304,2,1,0,307,23331,469,13,0,23813
COUNTY COMMISSIONER,Nick  DiFRANCESCO,Swatara Township--7th Ward,281,9,0,0,290,23331,469,13,0,23813
COUNTY COMMISSIONER,Nick  DiFRANCESCO,Swatara Township--8th Ward,352,5,0,0,357,23331,469,13,0,23813
COUNTY COMMISSIONER,Nick  DiFRANCESCO,Swatara Township--9th Ward,129,3,0,0,132,23331,469,13,0,23813
COUNTY COMMISSIONER,Nick  DiFRANCESCO,Upper Paxton Twp--1st Precinct,210,1,0,0,211,23331,469,13,0,23813
COUNTY COMMISSIONER,Nick  DiFRANCESCO,Upper Paxton Twp--2nd Precinct,134,2,0,0,136,23331,469,13,0,23813
COUNTY COMMISSIONER,Nick  DiFRANCESCO,Washington Township,200,5,0,0,205,23331,469,13,0,23813
COUNTY COMMISSIONER,Nick  DiFRANCESCO,Wayne Township,187,0,1,0,188,23331,469,13,0,23813
COUNTY COMMISSIONER,Nick  DiFRANCESCO,West Hanover Twp--1st Precinct,237,5,1,0,243,23331,469,13,0,23813
COUNTY COMMISSIONER,Nick  DiFRANCESCO,West Hanover Twp--2nd Precinct,202,7,1,0,210,23331,469,13,0,23813
COUNTY COMMISSIONER,Nick  DiFRANCESCO,West Hanover Twp--3rd Precinct,487,10,0,0,497,23331,469,13,0,23813
COUNTY COMMISSIONER,Nick  DiFRANCESCO,West Hanover Twp--4th Precinct,267,1,0,0,268,23331,469,13,0,23813
COUNTY COMMISSIONER,Nick  DiFRANCESCO,Wiconisco Twp--1st Precinct,58,1,0,0,59,23331,469,13,0,23813
COUNTY COMMISSIONER,Nick  DiFRANCESCO,Wiconisco Twp--2nd Precinct,41,1,0,0,42,23331,469,13,0,23813
COUNTY COMMISSIONER,Nick  DiFRANCESCO,Williams Twp,107,1,0,0,108,23331,469,13,0,23813
COUNTY COMMISSIONER,Write In  ,"City--1st Ward, 1st Precinct",0,0,0,0,0,64,0,0,0,64
COUNTY COMMISSIONER,Write In  ,"City--1st Ward, 2nd Precinct",0,0,0,0,0,64,0,0,0,64
COUNTY COMMISSIONER,Write In  ,"City--1st Ward, 3rd Precinct",0,0,0,0,0,64,0,0,0,64
COUNTY COMMISSIONER,Write In  ,"City--2nd Ward, 1st Precinct",0,0,0,0,0,64,0,0,0,64
COUNTY COMMISSIONER,Write In  ,"City--2nd Ward, 2nd Precinct",1,0,0,0,1,64,0,0,0,64
COUNTY COMMISSIONER,Write In  ,City--3rd Ward,0,0,0,0,0,64,0,0,0,64
COUNTY COMMISSIONER,Write In  ,City--4th Ward,1,0,0,0,1,64,0,0,0,64
COUNTY COMMISSIONER,Write In  ,City--5th Ward,4,0,0,0,4,64,0,0,0,64
COUNTY COMMISSIONER,Write In  ,City--6th Ward,0,0,0,0,0,64,0,0,0,64
COUNTY COMMISSIONER,Write In  ,"City--7th Ward, 1st Precinct",0,0,0,0,0,64,0,0,0,64
COUNTY COMMISSIONER,Write In  ,"City--7th Ward, 2nd Precinct",0,0,0,0,0,64,0,0,0,64
COUNTY COMMISSIONER,Write In  ,City--8th Ward,0,0,0,0,0,64,0,0,0,64
COUNTY COMMISSIONER,Write In  ,"City--9th Ward, 1st Precinct",0,0,0,0,0,64,0,0,0,64
COUNTY COMMISSIONER,Write In  ,"City--9th Ward, 2nd Precinct",0,0,0,0,0,64,0,0,0,64
COUNTY COMMISSIONER,Write In  ,"City--9th Ward, 3rd Precinct",0,0,0,0,0,64,0,0,0,64
COUNTY COMMISSIONER,Write In  ,"City--9th Ward, 4th Precinct",0,0,0,0,0,64,0,0,0,64
COUNTY COMMISSIONER,Write In  ,"City--9th Ward, 5th Precinct",0,0,0,0,0,64,0,0,0,64
COUNTY COMMISSIONER,Write In  ,"City--10th Ward, 1st Precinct",0,0,0,0,0,64,0,0,0,64
COUNTY COMMISSIONER,Write In  ,"City--10th Ward, 2nd Precinct",0,0,0,0,0,64,0,0,0,64
COUNTY COMMISSIONER,Write In  ,"City--10th Ward, 3rd Precinct",1,0,0,0,1,64,0,0,0,64
COUNTY COMMISSIONER,Write In  ,"City--10th Ward, 4th Precinct",0,0,0,0,0,64,0,0,0,64
COUNTY COMMISSIONER,Write In  ,City--11th Ward,1,0,0,0,1,64,0,0,0,64
COUNTY COMMISSIONER,Write In  ,City--12th Ward,0,0,0,0,0,64,0,0,0,64
COUNTY COMMISSIONER,Write In  ,"City--13th Ward, 1st Precinct",3,0,0,0,3,64,0,0,0,64
COUNTY COMMISSIONER,Write In  ,"City--13th Ward, 2nd Precinct",0,0,0,0,0,64,0,0,0,64
COUNTY COMMISSIONER,Write In  ,"City--13th Ward, 3rd Precinct",2,0,0,0,2,64,0,0,0,64
COUNTY COMMISSIONER,Write In  ,City--14th Ward,0,0,0,0,0,64,0,0,0,64
COUNTY COMMISSIONER,Write In  ,City--15th Ward,0,0,0,0,0,64,0,0,0,64
COUNTY COMMISSIONER,Write In  ,Berrysburg Borough,0,0,0,0,0,64,0,0,0,64
COUNTY COMMISSIONER,Write In  ,Dauphin Borough,0,0,0,0,0,64,0,0,0,64
COUNTY COMMISSIONER,Write In  ,Elizabethville Borough,0,0,0,0,0,64,0,0,0,64
COUNTY COMMISSIONER,Write In  ,Gratz Borough,1,0,0,0,1,64,0,0,0,64
COUNTY COMMISSIONER,Write In  ,Halifax Borough,1,0,0,0,1,64,0,0,0,64
COUNTY COMMISSIONER,Write In  ,Highspire--1st Precinct,0,0,0,0,0,64,0,0,0,64
COUNTY COMMISSIONER,Write In  ,Highspire--2nd Precinct,1,0,0,0,1,64,0,0,0,64
COUNTY COMMISSIONER,Write In  ,Hummelstown--1st Precinct,0,0,0,0,0,64,0,0,0,64
COUNTY COMMISSIONER,Write In  ,Hummelstown--2nd Precinct,1,0,0,0,1,64,0,0,0,64
COUNTY COMMISSIONER,Write In  ,Lykens Borough--1st Ward,0,0,0,0,0,64,0,0,0,64
COUNTY COMMISSIONER,Write In  ,Lykens Borough--2nd Ward,1,0,0,0,1,64,0,0,0,64
COUNTY COMMISSIONER,Write In  ,"Middletown--1st Ward, 1st Precinct",1,0,0,0,1,64,0,0,0,64
COUNTY COMMISSIONER,Write In  ,"Middletown--1st Ward, 2nd Precinct",0,0,0,0,0,64,0,0,0,64
COUNTY COMMISSIONER,Write In  ,"Middletown--2nd Ward, 1st Precinct",0,0,0,0,0,64,0,0,0,64
COUNTY COMMISSIONER,Write In  ,"Middletown--2nd Ward, 2nd Precinct",1,0,0,0,1,64,0,0,0,64
COUNTY COMMISSIONER,Write In  ,"Middletown--3rd Ward, 1st Precinct",0,0,0,0,0,64,0,0,0,64
COUNTY COMMISSIONER,Write In  ,"Middletown--3rd Ward, 2nd Precinct",0,0,0,0,0,64,0,0,0,64
COUNTY COMMISSIONER,Write In  ,Millersburg--1st Ward,0,0,0,0,0,64,0,0,0,64
COUNTY COMMISSIONER,Write In  ,Millersburg--2nd Ward,2,0,0,0,2,64,0,0,0,64
COUNTY COMMISSIONER,Write In  ,Paxtang Borough,0,0,0,0,0,64,0,0,0,64
COUNTY COMMISSIONER,Write In  ,Penbrook Borough--1st Ward,0,0,0,0,0,64,0,0,0,64
COUNTY COMMISSIONER,Write In  ,Penbrook Borough--2nd Ward,0,0,0,0,0,64,0,0,0,64
COUNTY COMMISSIONER,Write In  ,Penbrook Borough--3rd Ward,4,0,0,0,4,64,0,0,0,64
COUNTY COMMISSIONER,Write In  ,Penbrook Borough--4th Ward,2,0,0,0,2,64,0,0,0,64
COUNTY COMMISSIONER,Write In  ,Royalton Borough--1st Ward,0,0,0,0,0,64,0,0,0,64
COUNTY COMMISSIONER,Write In  ,Royalton Borough--2nd Ward,0,0,0,0,0,64,0,0,0,64
COUNTY COMMISSIONER,Write In  ,Steelton--1st Ward,1,0,0,0,1,64,0,0,0,64
COUNTY COMMISSIONER,Write In  ,"Steelton--2nd Ward, 1st Precinct",0,0,0,0,0,64,0,0,0,64
COUNTY COMMISSIONER,Write In  ,"Steelton--2nd Ward, 2nd Precinct",0,0,0,0,0,64,0,0,0,64
COUNTY COMMISSIONER,Write In  ,"Steelton--3rd Ward, 1st Precinct",0,0,0,0,0,64,0,0,0,64
COUNTY COMMISSIONER,Write In  ,"Steelton--3rd Ward, 2nd Precinct",0,0,0,0,0,64,0,0,0,64
COUNTY COMMISSIONER,Write In  ,Steelton--4th Ward,0,0,0,0,0,64,0,0,0,64
COUNTY COMMISSIONER,Write In  ,Pillow Borough,0,0,0,0,0,64,0,0,0,64
COUNTY COMMISSIONER,Write In  ,Williamstown--1st Ward,0,0,0,0,0,64,0,0,0,64
COUNTY COMMISSIONER,Write In  ,Williamstown--2nd Ward,1,0,0,0,1,64,0,0,0,64
COUNTY COMMISSIONER,Write In  ,Conewago Twp--1st Precinct,0,0,0,0,0,64,0,0,0,64
COUNTY COMMISSIONER,Write In  ,Conewago Twp--2nd Precinct,0,0,0,0,0,64,0,0,0,64
COUNTY COMMISSIONER,Write In  ,Derry Township--1st Precinct,0,0,0,0,0,64,0,0,0,64
COUNTY COMMISSIONER,Write In  ,Derry Township--2nd Precinct,0,0,0,0,0,64,0,0,0,64
COUNTY COMMISSIONER,Write In  ,Derry Township--3rd Precinct,0,0,0,0,0,64,0,0,0,64
COUNTY COMMISSIONER,Write In  ,Derry Township--4th Precinct,0,0,0,0,0,64,0,0,0,64
COUNTY COMMISSIONER,Write In  ,Derry Township--5th Precinct,0,0,0,0,0,64,0,0,0,64
COUNTY COMMISSIONER,Write In  ,Derry Township--6th Precinct,0,0,0,0,0,64,0,0,0,64
COUNTY COMMISSIONER,Write In  ,Derry Township--7th Precinct,0,0,0,0,0,64,0,0,0,64
COUNTY COMMISSIONER,Write In  ,Derry Township--8th Precinct,0,0,0,0,0,64,0,0,0,64
COUNTY COMMISSIONER,Write In  ,Derry Township--9th Precinct,0,0,0,0,0,64,0,0,0,64
COUNTY COMMISSIONER,Write In  ,Derry Township--10th Precinct,0,0,0,0,0,64,0,0,0,64
COUNTY COMMISSIONER,Write In  ,Derry Township--11th Precinct,0,0,0,0,0,64,0,0,0,64
COUNTY COMMISSIONER,Write In  ,Derry Township--12th Precinct,0,0,0,0,0,64,0,0,0,64
COUNTY COMMISSIONER,Write In  ,Derry Township--13th Precinct,0,0,0,0,0,64,0,0,0,64
COUNTY COMMISSIONER,Write In  ,Derry Township--14th Precinct,0,0,0,0,0,64,0,0,0,64
COUNTY COMMISSIONER,Write In  ,Derry Township--15th Precinct,0,0,0,0,0,64,0,0,0,64
COUNTY COMMISSIONER,Write In  ,East Hanover Township--1st Precinct,0,0,0,0,0,64,0,0,0,64
COUNTY COMMISSIONER,Write In  ,East Hanover Township--2nd Precinct,0,0,0,0,0,64,0,0,0,64
COUNTY COMMISSIONER,Write In  ,Halifax Twp--1st Precinct,1,0,0,0,1,64,0,0,0,64
COUNTY COMMISSIONER,Write In  ,Halifax Twp--2nd Precinct,0,0,0,0,0,64,0,0,0,64
COUNTY COMMISSIONER,Write In  ,Jackson Township,0,0,0,0,0,64,0,0,0,64
COUNTY COMMISSIONER,Write In  ,Jefferson Township,0,0,0,0,0,64,0,0,0,64
COUNTY COMMISSIONER,Write In  ,Londonderry Twp--1st Precinct,0,0,0,0,0,64,0,0,0,64
COUNTY COMMISSIONER,Write In  ,Londonderry Twp--2nd Precinct,2,0,0,0,2,64,0,0,0,64
COUNTY COMMISSIONER,Write In  ,Londonderry Twp--3rd Precinct,0,0,0,0,0,64,0,0,0,64
COUNTY COMMISSIONER,Write In  ,Lower Paxton Twp--1st Precinct,0,0,0,0,0,64,0,0,0,64
COUNTY COMMISSIONER,Write In  ,Lower Paxton Twp--2nd Precinct,2,0,0,0,2,64,0,0,0,64
COUNTY COMMISSIONER,Write In  ,Lower Paxton Twp--3rd precinct,0,0,0,0,0,64,0,0,0,64
COUNTY COMMISSIONER,Write In  ,Lower Paxton Twp--4th Precinct,1,0,0,0,1,64,0,0,0,64
COUNTY COMMISSIONER,Write In  ,Lower Paxton Twp--5th Precinct,1,0,0,0,1,64,0,0,0,64
COUNTY COMMISSIONER,Write In  ,Lower Paxton Twp--6th Precinct,0,0,0,0,0,64,0,0,0,64
COUNTY COMMISSIONER,Write In  ,Lower Paxton Twp--7th Precinct,1,0,0,0,1,64,0,0,0,64
COUNTY COMMISSIONER,Write In  ,Lower Paxton Twp--8th Precinct,0,0,0,0,0,64,0,0,0,64
COUNTY COMMISSIONER,Write In  ,Lower Paxton Twp--9th Precinct,1,0,0,0,1,64,0,0,0,64
COUNTY COMMISSIONER,Write In  ,Lower Paxton Twp--10th Precinct,0,0,0,0,0,64,0,0,0,64
COUNTY COMMISSIONER,Write In  ,Lower Paxton Twp--11th Precinct,0,0,0,0,0,64,0,0,0,64
COUNTY COMMISSIONER,Write In  ,Lower Paxton Twp--12th Precinct,0,0,0,0,0,64,0,0,0,64
COUNTY COMMISSIONER,Write In  ,Lower Paxton Twp--13th Precinct,1,0,0,0,1,64,0,0,0,64
COUNTY COMMISSIONER,Write In  ,Lower Paxton Twp--14th Precinct,0,0,0,0,0,64,0,0,0,64
COUNTY COMMISSIONER,Write In  ,Lower Paxton Twp--15th Precinct,0,0,0,0,0,64,0,0,0,64
COUNTY COMMISSIONER,Write In  ,Lower Paxton Twp--16th Precinct,2,0,0,0,2,64,0,0,0,64
COUNTY COMMISSIONER,Write In  ,Lower Paxton Twp--17th Precinct,0,0,0,0,0,64,0,0,0,64
COUNTY COMMISSIONER,Write In  ,Lower Paxton Twp--18th Precinct,0,0,0,0,0,64,0,0,0,64
COUNTY COMMISSIONER,Write In  ,Lower Paxton Twp--19th Precinct,1,0,0,0,1,64,0,0,0,64
COUNTY COMMISSIONER,Write In  ,Lower Paxton Twp--20th Precinct,4,0,0,0,4,64,0,0,0,64
COUNTY COMMISSIONER,Write In  ,Lower Paxton Twp--21st Precinct,1,0,0,0,1,64,0,0,0,64
COUNTY COMMISSIONER,Write In  ,Lower Paxton Twp--22nd Precinct,0,0,0,0,0,64,0,0,0,64
COUNTY COMMISSIONER,Write In  ,Lower Paxton Twp--23rd Precinct,0,0,0,0,0,64,0,0,0,64
COUNTY COMMISSIONER,Write In  ,Lower Paxton Twp--24th Precinct,0,0,0,0,0,64,0,0,0,64
COUNTY COMMISSIONER,Write In  ,Lower Paxton Twp--25th Precinct,0,0,0,0,0,64,0,0,0,64
COUNTY COMMISSIONER,Write In  ,Lower Paxton Twp--26th Precinct,0,0,0,0,0,64,0,0,0,64
COUNTY COMMISSIONER,Write In  ,Lower Paxton Twp--27th Precinct,0,0,0,0,0,64,0,0,0,64
COUNTY COMMISSIONER,Write In  ,Lower Swatara Twp--1st Precinct,1,0,0,0,1,64,0,0,0,64
COUNTY COMMISSIONER,Write In  ,Lower Swatara Twp--2nd Precinct,0,0,0,0,0,64,0,0,0,64
COUNTY COMMISSIONER,Write In  ,Lower Swatara Twp--3rd Precinct,0,0,0,0,0,64,0,0,0,64
COUNTY COMMISSIONER,Write In  ,Lower Swatara Twp--4th Precinct,0,0,0,0,0,64,0,0,0,64
COUNTY COMMISSIONER,Write In  ,Lykens Township,0,0,0,0,0,64,0,0,0,64
COUNTY COMMISSIONER,Write In  ,Middle Paxton Twp--1st Precinct,0,0,0,0,0,64,0,0,0,64
COUNTY COMMISSIONER,Write In  ,Middle Paxton Twp--2nd Precinct,0,0,0,0,0,64,0,0,0,64
COUNTY COMMISSIONER,Write In  ,Middle Paxton Twp--3rd Precinct,0,0,0,0,0,64,0,0,0,64
COUNTY COMMISSIONER,Write In  ,Mifflin Township,0,0,0,0,0,64,0,0,0,64
COUNTY COMMISSIONER,Write In  ,Reed Township,0,0,0,0,0,64,0,0,0,64
COUNTY COMMISSIONER,Write In  ,Rush Township,0,0,0,0,0,64,0,0,0,64
COUNTY COMMISSIONER,Write In  ,South Hanover Twp--1st Precinct,0,0,0,0,0,64,0,0,0,64
COUNTY COMMISSIONER,Write In  ,South Hanover Twp--2nd Precinct,0,0,0,0,0,64,0,0,0,64
COUNTY COMMISSIONER,Write In  ,South Hanover Twp--3rd Precinct,1,0,0,0,1,64,0,0,0,64
COUNTY COMMISSIONER,Write In  ,Susquehanna Twp--1st Ward,1,0,0,0,1,64,0,0,0,64
COUNTY COMMISSIONER,Write In  ,Susquehanna Twp--2nd Ward,0,0,0,0,0,64,0,0,0,64
COUNTY COMMISSIONER,Write In  ,Susquehanna Twp--3rd Ward,0,0,0,0,0,64,0,0,0,64
COUNTY COMMISSIONER,Write In  ,Susquehanna Twp--4th Ward,2,0,0,0,2,64,0,0,0,64
COUNTY COMMISSIONER,Write In  ,Susquehanna Twp--5th Ward,0,0,0,0,0,64,0,0,0,64
COUNTY COMMISSIONER,Write In  ,Susquehanna Twp--6th Ward,0,0,0,0,0,64,0,0,0,64
COUNTY COMMISSIONER,Write In  ,Susquehanna Twp--7th Ward,0,0,0,0,0,64,0,0,0,64
COUNTY COMMISSIONER,Write In  ,Susquehanna Twp--8th Ward,2,0,0,0,2,64,0,0,0,64
COUNTY COMMISSIONER,Write In  ,Susquehanna Twp--9th Ward,1,0,0,0,1,64,0,0,0,64
COUNTY COMMISSIONER,Write In  ,Swatara Township--1st Ward,2,0,0,0,2,64,0,0,0,64
COUNTY COMMISSIONER,Write In  ,Swatara Township--2nd Ward,0,0,0,0,0,64,0,0,0,64
COUNTY COMMISSIONER,Write In  ,Swatara Township--3rd Ward,0,0,0,0,0,64,0,0,0,64
COUNTY COMMISSIONER,Write In  ,Swatara Township--4th Ward,0,0,0,0,0,64,0,0,0,64
COUNTY COMMISSIONER,Write In  ,Swatara Township--5th Ward,0,0,0,0,0,64,0,0,0,64
COUNTY COMMISSIONER,Write In  ,Swatara Township--6th Ward,1,0,0,0,1,64,0,0,0,64
COUNTY COMMISSIONER,Write In  ,Swatara Township--7th Ward,2,0,0,0,2,64,0,0,0,64
COUNTY COMMISSIONER,Write In  ,Swatara Township--8th Ward,0,0,0,0,0,64,0,0,0,64
COUNTY COMMISSIONER,Write In  ,Swatara Township--9th Ward,0,0,0,0,0,64,0,0,0,64
COUNTY COMMISSIONER,Write In  ,Upper Paxton Twp--1st Precinct,1,0,0,0,1,64,0,0,0,64
COUNTY COMMISSIONER,Write In  ,Upper Paxton Twp--2nd Precinct,0,0,0,0,0,64,0,0,0,64
COUNTY COMMISSIONER,Write In  ,Washington Township,0,0,0,0,0,64,0,0,0,64
COUNTY COMMISSIONER,Write In  ,Wayne Township,0,0,0,0,0,64,0,0,0,64
COUNTY COMMISSIONER,Write In  ,West Hanover Twp--1st Precinct,0,0,0,0,0,64,0,0,0,64
COUNTY COMMISSIONER,Write In  ,West Hanover Twp--2nd Precinct,0,0,0,0,0,64,0,0,0,64
COUNTY COMMISSIONER,Write In  ,West Hanover Twp--3rd Precinct,1,0,0,0,1,64,0,0,0,64
COUNTY COMMISSIONER,Write In  ,West Hanover Twp--4th Precinct,1,0,0,0,1,64,0,0,0,64
COUNTY COMMISSIONER,Write In  ,Wiconisco Twp--1st Precinct,0,0,0,0,0,64,0,0,0,64
COUNTY COMMISSIONER,Write In  ,Wiconisco Twp--2nd Precinct,0,0,0,0,0,64,0,0,0,64
COUNTY COMMISSIONER,Write In  ,Williams Twp,0,0,0,0,0,64,0,0,0,64
COUNTY CONTROLLER,Marie E. REBUCK,"City--1st Ward, 1st Precinct",48,3,0,0,51,28263,636,16,0,28915
COUNTY CONTROLLER,Marie E. REBUCK,"City--1st Ward, 2nd Precinct",91,1,1,0,93,28263,636,16,0,28915
COUNTY CONTROLLER,Marie E. REBUCK,"City--1st Ward, 3rd Precinct",23,0,0,0,23,28263,636,16,0,28915
COUNTY CONTROLLER,Marie E. REBUCK,"City--2nd Ward, 1st Precinct",26,0,0,0,26,28263,636,16,0,28915
COUNTY CONTROLLER,Marie E. REBUCK,"City--2nd Ward, 2nd Precinct",37,1,0,0,38,28263,636,16,0,28915
COUNTY CONTROLLER,Marie E. REBUCK,City--3rd Ward,56,1,0,0,57,28263,636,16,0,28915
COUNTY CONTROLLER,Marie E. REBUCK,City--4th Ward,78,4,0,0,82,28263,636,16,0,28915
COUNTY CONTROLLER,Marie E. REBUCK,City--5th Ward,158,8,0,0,166,28263,636,16,0,28915
COUNTY CONTROLLER,Marie E. REBUCK,City--6th Ward,91,1,2,0,94,28263,636,16,0,28915
COUNTY CONTROLLER,Marie E. REBUCK,"City--7th Ward, 1st Precinct",27,1,0,0,28,28263,636,16,0,28915
COUNTY CONTROLLER,Marie E. REBUCK,"City--7th Ward, 2nd Precinct",49,2,0,0,51,28263,636,16,0,28915
COUNTY CONTROLLER,Marie E. REBUCK,City--8th Ward,34,0,0,0,34,28263,636,16,0,28915
COUNTY CONTROLLER,Marie E. REBUCK,"City--9th Ward, 1st Precinct",25,2,0,0,27,28263,636,16,0,28915
COUNTY CONTROLLER,Marie E. REBUCK,"City--9th Ward, 2nd Precinct",28,1,0,0,29,28263,636,16,0,28915
COUNTY CONTROLLER,Marie E. REBUCK,"City--9th Ward, 3rd Precinct",51,2,0,0,53,28263,636,16,0,28915
COUNTY CONTROLLER,Marie E. REBUCK,"City--9th Ward, 4th Precinct",113,3,0,0,116,28263,636,16,0,28915
COUNTY CONTROLLER,Marie E. REBUCK,"City--9th Ward, 5th Precinct",78,4,0,0,82,28263,636,16,0,28915
COUNTY CONTROLLER,Marie E. REBUCK,"City--10th Ward, 1st Precinct",113,4,0,0,117,28263,636,16,0,28915
COUNTY CONTROLLER,Marie E. REBUCK,"City--10th Ward, 2nd Precinct",28,0,0,0,28,28263,636,16,0,28915
COUNTY CONTROLLER,Marie E. REBUCK,"City--10th Ward, 3rd Precinct",68,1,0,0,69,28263,636,16,0,28915
COUNTY CONTROLLER,Marie E. REBUCK,"City--10th Ward, 4th Precinct",41,0,0,0,41,28263,636,16,0,28915
COUNTY CONTROLLER,Marie E. REBUCK,City--11th Ward,42,29,0,0,71,28263,636,16,0,28915
COUNTY CONTROLLER,Marie E. REBUCK,City--12th Ward,122,6,0,0,128,28263,636,16,0,28915
COUNTY CONTROLLER,Marie E. REBUCK,"City--13th Ward, 1st Precinct",72,0,0,0,72,28263,636,16,0,28915
COUNTY CONTROLLER,Marie E. REBUCK,"City--13th Ward, 2nd Precinct",101,5,0,0,106,28263,636,16,0,28915
COUNTY CONTROLLER,Marie E. REBUCK,"City--13th Ward, 3rd Precinct",106,2,0,0,108,28263,636,16,0,28915
COUNTY CONTROLLER,Marie E. REBUCK,City--14th Ward,188,3,0,0,191,28263,636,16,0,28915
COUNTY CONTROLLER,Marie E. REBUCK,City--15th Ward,33,0,0,0,33,28263,636,16,0,28915
COUNTY CONTROLLER,Marie E. REBUCK,Berrysburg Borough,48,0,0,0,48,28263,636,16,0,28915
COUNTY CONTROLLER,Marie E. REBUCK,Dauphin Borough,137,1,0,0,138,28263,636,16,0,28915
COUNTY CONTROLLER,Marie E. REBUCK,Elizabethville Borough,159,1,0,0,160,28263,636,16,0,28915
COUNTY CONTROLLER,Marie E. REBUCK,Gratz Borough,72,2,0,0,74,28263,636,16,0,28915
COUNTY CONTROLLER,Marie E. REBUCK,Halifax Borough,76,2,0,0,78,28263,636,16,0,28915
COUNTY CONTROLLER,Marie E. REBUCK,Highspire--1st Precinct,112,3,0,0,115,28263,636,16,0,28915
COUNTY CONTROLLER,Marie E. REBUCK,Highspire--2nd Precinct,130,1,0,0,131,28263,636,16,0,28915
COUNTY CONTROLLER,Marie E. REBUCK,Hummelstown--1st Precinct,177,4,0,0,181,28263,636,16,0,28915
COUNTY CONTROLLER,Marie E. REBUCK,Hummelstown--2nd Precinct,372,4,0,0,376,28263,636,16,0,28915
COUNTY CONTROLLER,Marie E. REBUCK,Lykens Borough--1st Ward,80,1,0,0,81,28263,636,16,0,28915
COUNTY CONTROLLER,Marie E. REBUCK,Lykens Borough--2nd Ward,115,4,0,0,119,28263,636,16,0,28915
COUNTY CONTROLLER,Marie E. REBUCK,"Middletown--1st Ward, 1st Precinct",80,0,0,0,80,28263,636,16,0,28915
COUNTY CONTROLLER,Marie E. REBUCK,"Middletown--1st Ward, 2nd Precinct",127,8,1,0,136,28263,636,16,0,28915
COUNTY CONTROLLER,Marie E. REBUCK,"Middletown--2nd Ward, 1st Precinct",132,1,0,0,133,28263,636,16,0,28915
COUNTY CONTROLLER,Marie E. REBUCK,"Middletown--2nd Ward, 2nd Precinct",142,4,0,0,146,28263,636,16,0,28915
COUNTY CONTROLLER,Marie E. REBUCK,"Middletown--3rd Ward, 1st Precinct",116,1,0,0,117,28263,636,16,0,28915
COUNTY CONTROLLER,Marie E. REBUCK,"Middletown--3rd Ward, 2nd Precinct",174,0,0,0,174,28263,636,16,0,28915
COUNTY CONTROLLER,Marie E. REBUCK,Millersburg--1st Ward,127,4,0,0,131,28263,636,16,0,28915
COUNTY CONTROLLER,Marie E. REBUCK,Millersburg--2nd Ward,171,4,0,0,175,28263,636,16,0,28915
COUNTY CONTROLLER,Marie E. REBUCK,Paxtang Borough,221,3,0,0,224,28263,636,16,0,28915
COUNTY CONTROLLER,Marie E. REBUCK,Penbrook Borough--1st Ward,48,1,0,0,49,28263,636,16,0,28915
COUNTY CONTROLLER,Marie E. REBUCK,Penbrook Borough--2nd Ward,63,1,0,0,64,28263,636,16,0,28915
COUNTY CONTROLLER,Marie E. REBUCK,Penbrook Borough--3rd Ward,71,0,0,0,71,28263,636,16,0,28915
COUNTY CONTROLLER,Marie E. REBUCK,Penbrook Borough--4th Ward,74,1,0,0,75,28263,636,16,0,28915
COUNTY CONTROLLER,Marie E. REBUCK,Royalton Borough--1st Ward,31,0,0,0,31,28263,636,16,0,28915
COUNTY CONTROLLER,Marie E. REBUCK,Royalton Borough--2nd Ward,74,0,0,0,74,28263,636,16,0,28915
COUNTY CONTROLLER,Marie E. REBUCK,Steelton--1st Ward,112,5,0,0,117,28263,636,16,0,28915
COUNTY CONTROLLER,Marie E. REBUCK,"Steelton--2nd Ward, 1st Precinct",68,2,0,0,70,28263,636,16,0,28915
COUNTY CONTROLLER,Marie E. REBUCK,"Steelton--2nd Ward, 2nd Precinct",71,1,0,0,72,28263,636,16,0,28915
COUNTY CONTROLLER,Marie E. REBUCK,"Steelton--3rd Ward, 1st Precinct",33,0,0,0,33,28263,636,16,0,28915
COUNTY CONTROLLER,Marie E. REBUCK,"Steelton--3rd Ward, 2nd Precinct",63,0,0,0,63,28263,636,16,0,28915
COUNTY CONTROLLER,Marie E. REBUCK,Steelton--4th Ward,60,1,0,0,61,28263,636,16,0,28915
COUNTY CONTROLLER,Marie E. REBUCK,Pillow Borough,46,0,0,0,46,28263,636,16,0,28915
COUNTY CONTROLLER,Marie E. REBUCK,Williamstown--1st Ward,82,1,0,0,83,28263,636,16,0,28915
COUNTY CONTROLLER,Marie E. REBUCK,Williamstown--2nd Ward,66,0,0,0,66,28263,636,16,0,28915
COUNTY CONTROLLER,Marie E. REBUCK,Conewago Twp--1st Precinct,239,1,0,0,240,28263,636,16,0,28915
COUNTY CONTROLLER,Marie E. REBUCK,Conewago Twp--2nd Precinct,194,7,0,0,201,28263,636,16,0,28915
COUNTY CONTROLLER,Marie E. REBUCK,Derry Township--1st Precinct,274,4,0,0,278,28263,636,16,0,28915
COUNTY CONTROLLER,Marie E. REBUCK,Derry Township--2nd Precinct,230,6,0,0,236,28263,636,16,0,28915
COUNTY CONTROLLER,Marie E. REBUCK,Derry Township--3rd Precinct,161,6,0,0,167,28263,636,16,0,28915
COUNTY CONTROLLER,Marie E. REBUCK,Derry Township--4th Precinct,155,5,0,0,160,28263,636,16,0,28915
COUNTY CONTROLLER,Marie E. REBUCK,Derry Township--5th Precinct,118,3,0,0,121,28263,636,16,0,28915
COUNTY CONTROLLER,Marie E. REBUCK,Derry Township--6th Precinct,144,1,1,0,146,28263,636,16,0,28915
COUNTY CONTROLLER,Marie E. REBUCK,Derry Township--7th Precinct,314,16,0,0,330,28263,636,16,0,28915
COUNTY CONTROLLER,Marie E. REBUCK,Derry Township--8th Precinct,160,0,0,0,160,28263,636,16,0,28915
COUNTY CONTROLLER,Marie E. REBUCK,Derry Township--9th Precinct,96,3,0,0,99,28263,636,16,0,28915
COUNTY CONTROLLER,Marie E. REBUCK,Derry Township--10th Precinct,213,3,0,0,216,28263,636,16,0,28915
COUNTY CONTROLLER,Marie E. REBUCK,Derry Township--11th Precinct,273,7,0,0,280,28263,636,16,0,28915
COUNTY CONTROLLER,Marie E. REBUCK,Derry Township--12th Precinct,163,1,0,0,164,28263,636,16,0,28915
COUNTY CONTROLLER,Marie E. REBUCK,Derry Township--13th Precinct,220,7,0,0,227,28263,636,16,0,28915
COUNTY CONTROLLER,Marie E. REBUCK,Derry Township--14th Precinct,147,5,0,0,152,28263,636,16,0,28915
COUNTY CONTROLLER,Marie E. REBUCK,Derry Township--15th Precinct,292,5,1,0,298,28263,636,16,0,28915
COUNTY CONTROLLER,Marie E. REBUCK,East Hanover Township--1st Precinct,312,9,0,0,321,28263,636,16,0,28915
COUNTY CONTROLLER,Marie E. REBUCK,East Hanover Township--2nd Precinct,349,4,0,0,353,28263,636,16,0,28915
COUNTY CONTROLLER,Marie E. REBUCK,Halifax Twp--1st Precinct,252,3,0,0,255,28263,636,16,0,28915
COUNTY CONTROLLER,Marie E. REBUCK,Halifax Twp--2nd Precinct,293,12,0,0,305,28263,636,16,0,28915
COUNTY CONTROLLER,Marie E. REBUCK,Jackson Township,218,1,0,0,219,28263,636,16,0,28915
COUNTY CONTROLLER,Marie E. REBUCK,Jefferson Township,58,0,0,0,58,28263,636,16,0,28915
COUNTY CONTROLLER,Marie E. REBUCK,Londonderry Twp--1st Precinct,264,0,0,0,264,28263,636,16,0,28915
COUNTY CONTROLLER,Marie E. REBUCK,Londonderry Twp--2nd Precinct,246,3,0,0,249,28263,636,16,0,28915
COUNTY CONTROLLER,Marie E. REBUCK,Londonderry Twp--3rd Precinct,107,1,0,0,108,28263,636,16,0,28915
COUNTY CONTROLLER,Marie E. REBUCK,Lower Paxton Twp--1st Precinct,186,2,0,0,188,28263,636,16,0,28915
COUNTY CONTROLLER,Marie E. REBUCK,Lower Paxton Twp--2nd Precinct,194,8,0,0,202,28263,636,16,0,28915
COUNTY CONTROLLER,Marie E. REBUCK,Lower Paxton Twp--3rd precinct,369,11,0,0,380,28263,636,16,0,28915
COUNTY CONTROLLER,Marie E. REBUCK,Lower Paxton Twp--4th Precinct,270,4,0,0,274,28263,636,16,0,28915
COUNTY CONTROLLER,Marie E. REBUCK,Lower Paxton Twp--5th Precinct,222,4,1,0,227,28263,636,16,0,28915
COUNTY CONTROLLER,Marie E. REBUCK,Lower Paxton Twp--6th Precinct,170,5,0,0,175,28263,636,16,0,28915
COUNTY CONTROLLER,Marie E. REBUCK,Lower Paxton Twp--7th Precinct,337,7,0,0,344,28263,636,16,0,28915
COUNTY CONTROLLER,Marie E. REBUCK,Lower Paxton Twp--8th Precinct,144,1,0,0,145,28263,636,16,0,28915
COUNTY CONTROLLER,Marie E. REBUCK,Lower Paxton Twp--9th Precinct,195,7,0,0,202,28263,636,16,0,28915
COUNTY CONTROLLER,Marie E. REBUCK,Lower Paxton Twp--10th Precinct,108,3,0,0,111,28263,636,16,0,28915
COUNTY CONTROLLER,Marie E. REBUCK,Lower Paxton Twp--11th Precinct,187,2,1,0,190,28263,636,16,0,28915
COUNTY CONTROLLER,Marie E. REBUCK,Lower Paxton Twp--12th Precinct,285,8,1,0,294,28263,636,16,0,28915
COUNTY CONTROLLER,Marie E. REBUCK,Lower Paxton Twp--13th Precinct,250,6,0,0,256,28263,636,16,0,28915
COUNTY CONTROLLER,Marie E. REBUCK,Lower Paxton Twp--14th Precinct,147,3,3,0,153,28263,636,16,0,28915
COUNTY CONTROLLER,Marie E. REBUCK,Lower Paxton Twp--15th Precinct,236,3,0,0,239,28263,636,16,0,28915
COUNTY CONTROLLER,Marie E. REBUCK,Lower Paxton Twp--16th Precinct,400,9,0,0,409,28263,636,16,0,28915
COUNTY CONTROLLER,Marie E. REBUCK,Lower Paxton Twp--17th Precinct,181,7,0,0,188,28263,636,16,0,28915
COUNTY CONTROLLER,Marie E. REBUCK,Lower Paxton Twp--18th Precinct,167,2,0,0,169,28263,636,16,0,28915
COUNTY CONTROLLER,Marie E. REBUCK,Lower Paxton Twp--19th Precinct,302,15,0,0,317,28263,636,16,0,28915
COUNTY CONTROLLER,Marie E. REBUCK,Lower Paxton Twp--20th Precinct,259,5,0,0,264,28263,636,16,0,28915
COUNTY CONTROLLER,Marie E. REBUCK,Lower Paxton Twp--21st Precinct,299,7,0,0,306,28263,636,16,0,28915
COUNTY CONTROLLER,Marie E. REBUCK,Lower Paxton Twp--22nd Precinct,263,5,0,0,268,28263,636,16,0,28915
COUNTY CONTROLLER,Marie E. REBUCK,Lower Paxton Twp--23rd Precinct,253,3,0,0,256,28263,636,16,0,28915
COUNTY CONTROLLER,Marie E. REBUCK,Lower Paxton Twp--24th Precinct,247,6,0,0,253,28263,636,16,0,28915
COUNTY CONTROLLER,Marie E. REBUCK,Lower Paxton Twp--25th Precinct,151,4,0,0,155,28263,636,16,0,28915
COUNTY CONTROLLER,Marie E. REBUCK,Lower Paxton Twp--26th Precinct,243,7,0,0,250,28263,636,16,0,28915
COUNTY CONTROLLER,Marie E. REBUCK,Lower Paxton Twp--27th Precinct,207,2,0,0,209,28263,636,16,0,28915
COUNTY CONTROLLER,Marie E. REBUCK,Lower Swatara Twp--1st Precinct,328,3,0,0,331,28263,636,16,0,28915
COUNTY CONTROLLER,Marie E. REBUCK,Lower Swatara Twp--2nd Precinct,274,8,0,0,282,28263,636,16,0,28915
COUNTY CONTROLLER,Marie E. REBUCK,Lower Swatara Twp--3rd Precinct,234,26,0,0,260,28263,636,16,0,28915
COUNTY CONTROLLER,Marie E. REBUCK,Lower Swatara Twp--4th Precinct,231,0,0,0,231,28263,636,16,0,28915
COUNTY CONTROLLER,Marie E. REBUCK,Lykens Township,94,0,0,0,94,28263,636,16,0,28915
COUNTY CONTROLLER,Marie E. REBUCK,Middle Paxton Twp--1st Precinct,305,1,0,0,306,28263,636,16,0,28915
COUNTY CONTROLLER,Marie E. REBUCK,Middle Paxton Twp--2nd Precinct,240,1,0,0,241,28263,636,16,0,28915
COUNTY CONTROLLER,Marie E. REBUCK,Middle Paxton Twp--3rd Precinct,342,2,0,0,344,28263,636,16,0,28915
COUNTY CONTROLLER,Marie E. REBUCK,Mifflin Township,83,0,0,0,83,28263,636,16,0,28915
COUNTY CONTROLLER,Marie E. REBUCK,Reed Township,43,0,0,0,43,28263,636,16,0,28915
COUNTY CONTROLLER,Marie E. REBUCK,Rush Township,38,0,0,0,38,28263,636,16,0,28915
COUNTY CONTROLLER,Marie E. REBUCK,South Hanover Twp--1st Precinct,254,5,0,0,259,28263,636,16,0,28915
COUNTY CONTROLLER,Marie E. REBUCK,South Hanover Twp--2nd Precinct,350,8,0,0,358,28263,636,16,0,28915
COUNTY CONTROLLER,Marie E. REBUCK,South Hanover Twp--3rd Precinct,205,1,0,0,206,28263,636,16,0,28915
COUNTY CONTROLLER,Marie E. REBUCK,Susquehanna Twp--1st Ward,342,16,0,0,358,28263,636,16,0,28915
COUNTY CONTROLLER,Marie E. REBUCK,Susquehanna Twp--2nd Ward,510,22,0,0,532,28263,636,16,0,28915
COUNTY CONTROLLER,Marie E. REBUCK,Susquehanna Twp--3rd Ward,188,0,0,0,188,28263,636,16,0,28915
COUNTY CONTROLLER,Marie E. REBUCK,Susquehanna Twp--4th Ward,225,5,0,0,230,28263,636,16,0,28915
COUNTY CONTROLLER,Marie E. REBUCK,Susquehanna Twp--5th Ward,273,7,0,0,280,28263,636,16,0,28915
COUNTY CONTROLLER,Marie E. REBUCK,Susquehanna Twp--6th Ward,333,9,0,0,342,28263,636,16,0,28915
COUNTY CONTROLLER,Marie E. REBUCK,Susquehanna Twp--7th Ward,149,0,0,0,149,28263,636,16,0,28915
COUNTY CONTROLLER,Marie E. REBUCK,Susquehanna Twp--8th Ward,398,16,0,0,414,28263,636,16,0,28915
COUNTY CONTROLLER,Marie E. REBUCK,Susquehanna Twp--9th Ward,271,4,0,0,275,28263,636,16,0,28915
COUNTY CONTROLLER,Marie E. REBUCK,Swatara Township--1st Ward,238,3,0,0,241,28263,636,16,0,28915
COUNTY CONTROLLER,Marie E. REBUCK,Swatara Township--2nd Ward,148,11,0,0,159,28263,636,16,0,28915
COUNTY CONTROLLER,Marie E. REBUCK,Swatara Township--3rd Ward,188,5,0,0,193,28263,636,16,0,28915
COUNTY CONTROLLER,Marie E. REBUCK,Swatara Township--4th Ward,289,8,0,0,297,28263,636,16,0,28915
COUNTY CONTROLLER,Marie E. REBUCK,Swatara Township--5th Ward,388,4,0,0,392,28263,636,16,0,28915
COUNTY CONTROLLER,Marie E. REBUCK,Swatara Township--6th Ward,366,2,0,0,368,28263,636,16,0,28915
COUNTY CONTROLLER,Marie E. REBUCK,Swatara Township--7th Ward,333,10,0,0,343,28263,636,16,0,28915
COUNTY CONTROLLER,Marie E. REBUCK,Swatara Township--8th Ward,430,5,1,0,436,28263,636,16,0,28915
COUNTY CONTROLLER,Marie E. REBUCK,Swatara Township--9th Ward,152,7,0,0,159,28263,636,16,0,28915
COUNTY CONTROLLER,Marie E. REBUCK,Upper Paxton Twp--1st Precinct,262,2,0,0,264,28263,636,16,0,28915
COUNTY CONTROLLER,Marie E. REBUCK,Upper Paxton Twp--2nd Precinct,166,2,0,0,168,28263,636,16,0,28915
COUNTY CONTROLLER,Marie E. REBUCK,Washington Township,264,7,0,0,271,28263,636,16,0,28915
COUNTY CONTROLLER,Marie E. REBUCK,Wayne Township,253,1,1,0,255,28263,636,16,0,28915
COUNTY CONTROLLER,Marie E. REBUCK,West Hanover Twp--1st Precinct,252,5,0,0,257,28263,636,16,0,28915
COUNTY CONTROLLER,Marie E. REBUCK,West Hanover Twp--2nd Precinct,238,7,1,0,246,28263,636,16,0,28915
COUNTY CONTROLLER,Marie E. REBUCK,West Hanover Twp--3rd Precinct,567,15,1,0,583,28263,636,16,0,28915
COUNTY CONTROLLER,Marie E. REBUCK,West Hanover Twp--4th Precinct,339,1,0,0,340,28263,636,16,0,28915
COUNTY CONTROLLER,Marie E. REBUCK,Wiconisco Twp--1st Precinct,71,1,0,0,72,28263,636,16,0,28915
COUNTY CONTROLLER,Marie E. REBUCK,Wiconisco Twp--2nd Precinct,53,1,0,0,54,28263,636,16,0,28915
COUNTY CONTROLLER,Marie E. REBUCK,Williams Twp,135,1,0,0,136,28263,636,16,0,28915
COUNTY CONTROLLER,Write In  ,"City--1st Ward, 1st Precinct",0,0,0,0,0,30,0,0,0,30
COUNTY CONTROLLER,Write In  ,"City--1st Ward, 2nd Precinct",0,0,0,0,0,30,0,0,0,30
COUNTY CONTROLLER,Write In  ,"City--1st Ward, 3rd Precinct",0,0,0,0,0,30,0,0,0,30
COUNTY CONTROLLER,Write In  ,"City--2nd Ward, 1st Precinct",0,0,0,0,0,30,0,0,0,30
COUNTY CONTROLLER,Write In  ,"City--2nd Ward, 2nd Precinct",0,0,0,0,0,30,0,0,0,30
COUNTY CONTROLLER,Write In  ,City--3rd Ward,0,0,0,0,0,30,0,0,0,30
COUNTY CONTROLLER,Write In  ,City--4th Ward,1,0,0,0,1,30,0,0,0,30
COUNTY CONTROLLER,Write In  ,City--5th Ward,1,0,0,0,1,30,0,0,0,30
COUNTY CONTROLLER,Write In  ,City--6th Ward,0,0,0,0,0,30,0,0,0,30
COUNTY CONTROLLER,Write In  ,"City--7th Ward, 1st Precinct",0,0,0,0,0,30,0,0,0,30
COUNTY CONTROLLER,Write In  ,"City--7th Ward, 2nd Precinct",0,0,0,0,0,30,0,0,0,30
COUNTY CONTROLLER,Write In  ,City--8th Ward,1,0,0,0,1,30,0,0,0,30
COUNTY CONTROLLER,Write In  ,"City--9th Ward, 1st Precinct",0,0,0,0,0,30,0,0,0,30
COUNTY CONTROLLER,Write In  ,"City--9th Ward, 2nd Precinct",0,0,0,0,0,30,0,0,0,30
COUNTY CONTROLLER,Write In  ,"City--9th Ward, 3rd Precinct",0,0,0,0,0,30,0,0,0,30
COUNTY CONTROLLER,Write In  ,"City--9th Ward, 4th Precinct",0,0,0,0,0,30,0,0,0,30
COUNTY CONTROLLER,Write In  ,"City--9th Ward, 5th Precinct",0,0,0,0,0,30,0,0,0,30
COUNTY CONTROLLER,Write In  ,"City--10th Ward, 1st Precinct",0,0,0,0,0,30,0,0,0,30
COUNTY CONTROLLER,Write In  ,"City--10th Ward, 2nd Precinct",0,0,0,0,0,30,0,0,0,30
COUNTY CONTROLLER,Write In  ,"City--10th Ward, 3rd Precinct",1,0,0,0,1,30,0,0,0,30
COUNTY CONTROLLER,Write In  ,"City--10th Ward, 4th Precinct",1,0,0,0,1,30,0,0,0,30
COUNTY CONTROLLER,Write In  ,City--11th Ward,0,0,0,0,0,30,0,0,0,30
COUNTY CONTROLLER,Write In  ,City--12th Ward,1,0,0,0,1,30,0,0,0,30
COUNTY CONTROLLER,Write In  ,"City--13th Ward, 1st Precinct",0,0,0,0,0,30,0,0,0,30
COUNTY CONTROLLER,Write In  ,"City--13th Ward, 2nd Precinct",0,0,0,0,0,30,0,0,0,30
COUNTY CONTROLLER,Write In  ,"City--13th Ward, 3rd Precinct",0,0,0,0,0,30,0,0,0,30
COUNTY CONTROLLER,Write In  ,City--14th Ward,0,0,0,0,0,30,0,0,0,30
COUNTY CONTROLLER,Write In  ,City--15th Ward,0,0,0,0,0,30,0,0,0,30
COUNTY CONTROLLER,Write In  ,Berrysburg Borough,0,0,0,0,0,30,0,0,0,30
COUNTY CONTROLLER,Write In  ,Dauphin Borough,0,0,0,0,0,30,0,0,0,30
COUNTY CONTROLLER,Write In  ,Elizabethville Borough,0,0,0,0,0,30,0,0,0,30
COUNTY CONTROLLER,Write In  ,Gratz Borough,0,0,0,0,0,30,0,0,0,30
COUNTY CONTROLLER,Write In  ,Halifax Borough,1,0,0,0,1,30,0,0,0,30
COUNTY CONTROLLER,Write In  ,Highspire--1st Precinct,0,0,0,0,0,30,0,0,0,30
COUNTY CONTROLLER,Write In  ,Highspire--2nd Precinct,0,0,0,0,0,30,0,0,0,30
COUNTY CONTROLLER,Write In  ,Hummelstown--1st Precinct,0,0,0,0,0,30,0,0,0,30
COUNTY CONTROLLER,Write In  ,Hummelstown--2nd Precinct,0,0,0,0,0,30,0,0,0,30
COUNTY CONTROLLER,Write In  ,Lykens Borough--1st Ward,0,0,0,0,0,30,0,0,0,30
COUNTY CONTROLLER,Write In  ,Lykens Borough--2nd Ward,0,0,0,0,0,30,0,0,0,30
COUNTY CONTROLLER,Write In  ,"Middletown--1st Ward, 1st Precinct",0,0,0,0,0,30,0,0,0,30
COUNTY CONTROLLER,Write In  ,"Middletown--1st Ward, 2nd Precinct",0,0,0,0,0,30,0,0,0,30
COUNTY CONTROLLER,Write In  ,"Middletown--2nd Ward, 1st Precinct",0,0,0,0,0,30,0,0,0,30
COUNTY CONTROLLER,Write In  ,"Middletown--2nd Ward, 2nd Precinct",0,0,0,0,0,30,0,0,0,30
COUNTY CONTROLLER,Write In  ,"Middletown--3rd Ward, 1st Precinct",1,0,0,0,1,30,0,0,0,30
COUNTY CONTROLLER,Write In  ,"Middletown--3rd Ward, 2nd Precinct",0,0,0,0,0,30,0,0,0,30
COUNTY CONTROLLER,Write In  ,Millersburg--1st Ward,0,0,0,0,0,30,0,0,0,30
COUNTY CONTROLLER,Write In  ,Millersburg--2nd Ward,0,0,0,0,0,30,0,0,0,30
COUNTY CONTROLLER,Write In  ,Paxtang Borough,0,0,0,0,0,30,0,0,0,30
COUNTY CONTROLLER,Write In  ,Penbrook Borough--1st Ward,0,0,0,0,0,30,0,0,0,30
COUNTY CONTROLLER,Write In  ,Penbrook Borough--2nd Ward,0,0,0,0,0,30,0,0,0,30
COUNTY CONTROLLER,Write In  ,Penbrook Borough--3rd Ward,0,0,0,0,0,30,0,0,0,30
COUNTY CONTROLLER,Write In  ,Penbrook Borough--4th Ward,0,0,0,0,0,30,0,0,0,30
COUNTY CONTROLLER,Write In  ,Royalton Borough--1st Ward,0,0,0,0,0,30,0,0,0,30
COUNTY CONTROLLER,Write In  ,Royalton Borough--2nd Ward,0,0,0,0,0,30,0,0,0,30
COUNTY CONTROLLER,Write In  ,Steelton--1st Ward,0,0,0,0,0,30,0,0,0,30
COUNTY CONTROLLER,Write In  ,"Steelton--2nd Ward, 1st Precinct",0,0,0,0,0,30,0,0,0,30
COUNTY CONTROLLER,Write In  ,"Steelton--2nd Ward, 2nd Precinct",0,0,0,0,0,30,0,0,0,30
COUNTY CONTROLLER,Write In  ,"Steelton--3rd Ward, 1st Precinct",0,0,0,0,0,30,0,0,0,30
COUNTY CONTROLLER,Write In  ,"Steelton--3rd Ward, 2nd Precinct",2,0,0,0,2,30,0,0,0,30
COUNTY CONTROLLER,Write In  ,Steelton--4th Ward,0,0,0,0,0,30,0,0,0,30
COUNTY CONTROLLER,Write In  ,Pillow Borough,0,0,0,0,0,30,0,0,0,30
COUNTY CONTROLLER,Write In  ,Williamstown--1st Ward,0,0,0,0,0,30,0,0,0,30
COUNTY CONTROLLER,Write In  ,Williamstown--2nd Ward,0,0,0,0,0,30,0,0,0,30
COUNTY CONTROLLER,Write In  ,Conewago Twp--1st Precinct,0,0,0,0,0,30,0,0,0,30
COUNTY CONTROLLER,Write In  ,Conewago Twp--2nd Precinct,1,0,0,0,1,30,0,0,0,30
COUNTY CONTROLLER,Write In  ,Derry Township--1st Precinct,0,0,0,0,0,30,0,0,0,30
COUNTY CONTROLLER,Write In  ,Derry Township--2nd Precinct,0,0,0,0,0,30,0,0,0,30
COUNTY CONTROLLER,Write In  ,Derry Township--3rd Precinct,0,0,0,0,0,30,0,0,0,30
COUNTY CONTROLLER,Write In  ,Derry Township--4th Precinct,0,0,0,0,0,30,0,0,0,30
COUNTY CONTROLLER,Write In  ,Derry Township--5th Precinct,0,0,0,0,0,30,0,0,0,30
COUNTY CONTROLLER,Write In  ,Derry Township--6th Precinct,0,0,0,0,0,30,0,0,0,30
COUNTY CONTROLLER,Write In  ,Derry Township--7th Precinct,0,0,0,0,0,30,0,0,0,30
COUNTY CONTROLLER,Write In  ,Derry Township--8th Precinct,0,0,0,0,0,30,0,0,0,30
COUNTY CONTROLLER,Write In  ,Derry Township--9th Precinct,0,0,0,0,0,30,0,0,0,30
COUNTY CONTROLLER,Write In  ,Derry Township--10th Precinct,0,0,0,0,0,30,0,0,0,30
COUNTY CONTROLLER,Write In  ,Derry Township--11th Precinct,0,0,0,0,0,30,0,0,0,30
COUNTY CONTROLLER,Write In  ,Derry Township--12th Precinct,0,0,0,0,0,30,0,0,0,30
COUNTY CONTROLLER,Write In  ,Derry Township--13th Precinct,0,0,0,0,0,30,0,0,0,30
COUNTY CONTROLLER,Write In  ,Derry Township--14th Precinct,0,0,0,0,0,30,0,0,0,30
COUNTY CONTROLLER,Write In  ,Derry Township--15th Precinct,1,0,0,0,1,30,0,0,0,30
COUNTY CONTROLLER,Write In  ,East Hanover Township--1st Precinct,1,0,0,0,1,30,0,0,0,30
COUNTY CONTROLLER,Write In  ,East Hanover Township--2nd Precinct,0,0,0,0,0,30,0,0,0,30
COUNTY CONTROLLER,Write In  ,Halifax Twp--1st Precinct,0,0,0,0,0,30,0,0,0,30
COUNTY CONTROLLER,Write In  ,Halifax Twp--2nd Precinct,0,0,0,0,0,30,0,0,0,30
COUNTY CONTROLLER,Write In  ,Jackson Township,1,0,0,0,1,30,0,0,0,30
COUNTY CONTROLLER,Write In  ,Jefferson Township,0,0,0,0,0,30,0,0,0,30
COUNTY CONTROLLER,Write In  ,Londonderry Twp--1st Precinct,0,0,0,0,0,30,0,0,0,30
COUNTY CONTROLLER,Write In  ,Londonderry Twp--2nd Precinct,1,0,0,0,1,30,0,0,0,30
COUNTY CONTROLLER,Write In  ,Londonderry Twp--3rd Precinct,0,0,0,0,0,30,0,0,0,30
COUNTY CONTROLLER,Write In  ,Lower Paxton Twp--1st Precinct,0,0,0,0,0,30,0,0,0,30
COUNTY CONTROLLER,Write In  ,Lower Paxton Twp--2nd Precinct,0,0,0,0,0,30,0,0,0,30
COUNTY CONTROLLER,Write In  ,Lower Paxton Twp--3rd precinct,0,0,0,0,0,30,0,0,0,30
COUNTY CONTROLLER,Write In  ,Lower Paxton Twp--4th Precinct,0,0,0,0,0,30,0,0,0,30
COUNTY CONTROLLER,Write In  ,Lower Paxton Twp--5th Precinct,1,0,0,0,1,30,0,0,0,30
COUNTY CONTROLLER,Write In  ,Lower Paxton Twp--6th Precinct,0,0,0,0,0,30,0,0,0,30
COUNTY CONTROLLER,Write In  ,Lower Paxton Twp--7th Precinct,0,0,0,0,0,30,0,0,0,30
COUNTY CONTROLLER,Write In  ,Lower Paxton Twp--8th Precinct,0,0,0,0,0,30,0,0,0,30
COUNTY CONTROLLER,Write In  ,Lower Paxton Twp--9th Precinct,0,0,0,0,0,30,0,0,0,30
COUNTY CONTROLLER,Write In  ,Lower Paxton Twp--10th Precinct,1,0,0,0,1,30,0,0,0,30
COUNTY CONTROLLER,Write In  ,Lower Paxton Twp--11th Precinct,0,0,0,0,0,30,0,0,0,30
COUNTY CONTROLLER,Write In  ,Lower Paxton Twp--12th Precinct,2,0,0,0,2,30,0,0,0,30
COUNTY CONTROLLER,Write In  ,Lower Paxton Twp--13th Precinct,1,0,0,0,1,30,0,0,0,30
COUNTY CONTROLLER,Write In  ,Lower Paxton Twp--14th Precinct,0,0,0,0,0,30,0,0,0,30
COUNTY CONTROLLER,Write In  ,Lower Paxton Twp--15th Precinct,0,0,0,0,0,30,0,0,0,30
COUNTY CONTROLLER,Write In  ,Lower Paxton Twp--16th Precinct,0,0,0,0,0,30,0,0,0,30
COUNTY CONTROLLER,Write In  ,Lower Paxton Twp--17th Precinct,0,0,0,0,0,30,0,0,0,30
COUNTY CONTROLLER,Write In  ,Lower Paxton Twp--18th Precinct,0,0,0,0,0,30,0,0,0,30
COUNTY CONTROLLER,Write In  ,Lower Paxton Twp--19th Precinct,0,0,0,0,0,30,0,0,0,30
COUNTY CONTROLLER,Write In  ,Lower Paxton Twp--20th Precinct,0,0,0,0,0,30,0,0,0,30
COUNTY CONTROLLER,Write In  ,Lower Paxton Twp--21st Precinct,0,0,0,0,0,30,0,0,0,30
COUNTY CONTROLLER,Write In  ,Lower Paxton Twp--22nd Precinct,1,0,0,0,1,30,0,0,0,30
COUNTY CONTROLLER,Write In  ,Lower Paxton Twp--23rd Precinct,0,0,0,0,0,30,0,0,0,30
COUNTY CONTROLLER,Write In  ,Lower Paxton Twp--24th Precinct,0,0,0,0,0,30,0,0,0,30
COUNTY CONTROLLER,Write In  ,Lower Paxton Twp--25th Precinct,1,0,0,0,1,30,0,0,0,30
COUNTY CONTROLLER,Write In  ,Lower Paxton Twp--26th Precinct,0,0,0,0,0,30,0,0,0,30
COUNTY CONTROLLER,Write In  ,Lower Paxton Twp--27th Precinct,0,0,0,0,0,30,0,0,0,30
COUNTY CONTROLLER,Write In  ,Lower Swatara Twp--1st Precinct,0,0,0,0,0,30,0,0,0,30
COUNTY CONTROLLER,Write In  ,Lower Swatara Twp--2nd Precinct,0,0,0,0,0,30,0,0,0,30
COUNTY CONTROLLER,Write In  ,Lower Swatara Twp--3rd Precinct,0,0,0,0,0,30,0,0,0,30
COUNTY CONTROLLER,Write In  ,Lower Swatara Twp--4th Precinct,0,0,0,0,0,30,0,0,0,30
COUNTY CONTROLLER,Write In  ,Lykens Township,0,0,0,0,0,30,0,0,0,30
COUNTY CONTROLLER,Write In  ,Middle Paxton Twp--1st Precinct,0,0,0,0,0,30,0,0,0,30
COUNTY CONTROLLER,Write In  ,Middle Paxton Twp--2nd Precinct,0,0,0,0,0,30,0,0,0,30
COUNTY CONTROLLER,Write In  ,Middle Paxton Twp--3rd Precinct,0,0,0,0,0,30,0,0,0,30
COUNTY CONTROLLER,Write In  ,Mifflin Township,0,0,0,0,0,30,0,0,0,30
COUNTY CONTROLLER,Write In  ,Reed Township,0,0,0,0,0,30,0,0,0,30
COUNTY CONTROLLER,Write In  ,Rush Township,0,0,0,0,0,30,0,0,0,30
COUNTY CONTROLLER,Write In  ,South Hanover Twp--1st Precinct,0,0,0,0,0,30,0,0,0,30
COUNTY CONTROLLER,Write In  ,South Hanover Twp--2nd Precinct,0,0,0,0,0,30,0,0,0,30
COUNTY CONTROLLER,Write In  ,South Hanover Twp--3rd Precinct,0,0,0,0,0,30,0,0,0,30
COUNTY CONTROLLER,Write In  ,Susquehanna Twp--1st Ward,1,0,0,0,1,30,0,0,0,30
COUNTY CONTROLLER,Write In  ,Susquehanna Twp--2nd Ward,1,0,0,0,1,30,0,0,0,30
COUNTY CONTROLLER,Write In  ,Susquehanna Twp--3rd Ward,1,0,0,0,1,30,0,0,0,30
COUNTY CONTROLLER,Write In  ,Susquehanna Twp--4th Ward,2,0,0,0,2,30,0,0,0,30
COUNTY CONTROLLER,Write In  ,Susquehanna Twp--5th Ward,0,0,0,0,0,30,0,0,0,30
COUNTY CONTROLLER,Write In  ,Susquehanna Twp--6th Ward,0,0,0,0,0,30,0,0,0,30
COUNTY CONTROLLER,Write In  ,Susquehanna Twp--7th Ward,0,0,0,0,0,30,0,0,0,30
COUNTY CONTROLLER,Write In  ,Susquehanna Twp--8th Ward,0,0,0,0,0,30,0,0,0,30
COUNTY CONTROLLER,Write In  ,Susquehanna Twp--9th Ward,1,0,0,0,1,30,0,0,0,30
COUNTY CONTROLLER,Write In  ,Swatara Township--1st Ward,0,0,0,0,0,30,0,0,0,30
COUNTY CONTROLLER,Write In  ,Swatara Township--2nd Ward,1,0,0,0,1,30,0,0,0,30
COUNTY CONTROLLER,Write In  ,Swatara Township--3rd Ward,0,0,0,0,0,30,0,0,0,30
COUNTY CONTROLLER,Write In  ,Swatara Township--4th Ward,0,0,0,0,0,30,0,0,0,30
COUNTY CONTROLLER,Write In  ,Swatara Township--5th Ward,0,0,0,0,0,30,0,0,0,30
COUNTY CONTROLLER,Write In  ,Swatara Township--6th Ward,0,0,0,0,0,30,0,0,0,30
COUNTY CONTROLLER,Write In  ,Swatara Township--7th Ward,0,0,0,0,0,30,0,0,0,30
COUNTY CONTROLLER,Write In  ,Swatara Township--8th Ward,0,0,0,0,0,30,0,0,0,30
COUNTY CONTROLLER,Write In  ,Swatara Township--9th Ward,1,0,0,0,1,30,0,0,0,30
COUNTY CONTROLLER,Write In  ,Upper Paxton Twp--1st Precinct,0,0,0,0,0,30,0,0,0,30
COUNTY CONTROLLER,Write In  ,Upper Paxton Twp--2nd Precinct,0,0,0,0,0,30,0,0,0,30
COUNTY CONTROLLER,Write In  ,Washington Township,0,0,0,0,0,30,0,0,0,30
COUNTY CONTROLLER,Write In  ,Wayne Township,0,0,0,0,0,30,0,0,0,30
COUNTY CONTROLLER,Write In  ,West Hanover Twp--1st Precinct,0,0,0,0,0,30,0,0,0,30
COUNTY CONTROLLER,Write In  ,West Hanover Twp--2nd Precinct,0,0,0,0,0,30,0,0,0,30
COUNTY CONTROLLER,Write In  ,West Hanover Twp--3rd Precinct,0,0,0,0,0,30,0,0,0,30
COUNTY CONTROLLER,Write In  ,West Hanover Twp--4th Precinct,0,0,0,0,0,30,0,0,0,30
COUNTY CONTROLLER,Write In  ,Wiconisco Twp--1st Precinct,0,0,0,0,0,30,0,0,0,30
COUNTY CONTROLLER,Write In  ,Wiconisco Twp--2nd Precinct,0,0,0,0,0,30,0,0,0,30
COUNTY CONTROLLER,Write In  ,Williams Twp,0,0,0,0,0,30,0,0,0,30
COUNTY TREASURER,Janis  CREASON,"City--1st Ward, 1st Precinct",93,3,0,0,96,37577,705,19,0,38301
COUNTY TREASURER,Janis  CREASON,"City--1st Ward, 2nd Precinct",173,2,1,0,176,37577,705,19,0,38301
COUNTY TREASURER,Janis  CREASON,"City--1st Ward, 3rd Precinct",77,1,0,0,78,37577,705,19,0,38301
COUNTY TREASURER,Janis  CREASON,"City--2nd Ward, 1st Precinct",39,0,0,0,39,37577,705,19,0,38301
COUNTY TREASURER,Janis  CREASON,"City--2nd Ward, 2nd Precinct",76,1,0,0,77,37577,705,19,0,38301
COUNTY TREASURER,Janis  CREASON,City--3rd Ward,119,1,0,0,120,37577,705,19,0,38301
COUNTY TREASURER,Janis  CREASON,City--4th Ward,155,4,0,0,159,37577,705,19,0,38301
COUNTY TREASURER,Janis  CREASON,City--5th Ward,310,7,0,0,317,37577,705,19,0,38301
COUNTY TREASURER,Janis  CREASON,City--6th Ward,168,2,3,0,173,37577,705,19,0,38301
COUNTY TREASURER,Janis  CREASON,"City--7th Ward, 1st Precinct",61,2,0,0,63,37577,705,19,0,38301
COUNTY TREASURER,Janis  CREASON,"City--7th Ward, 2nd Precinct",141,2,0,0,143,37577,705,19,0,38301
COUNTY TREASURER,Janis  CREASON,City--8th Ward,127,1,0,0,128,37577,705,19,0,38301
COUNTY TREASURER,Janis  CREASON,"City--9th Ward, 1st Precinct",55,2,0,0,57,37577,705,19,0,38301
COUNTY TREASURER,Janis  CREASON,"City--9th Ward, 2nd Precinct",91,1,0,0,92,37577,705,19,0,38301
COUNTY TREASURER,Janis  CREASON,"City--9th Ward, 3rd Precinct",162,2,0,0,164,37577,705,19,0,38301
COUNTY TREASURER,Janis  CREASON,"City--9th Ward, 4th Precinct",193,3,0,0,196,37577,705,19,0,38301
COUNTY TREASURER,Janis  CREASON,"City--9th Ward, 5th Precinct",129,5,0,0,134,37577,705,19,0,38301
COUNTY TREASURER,Janis  CREASON,"City--10th Ward, 1st Precinct",229,5,0,0,234,37577,705,19,0,38301
COUNTY TREASURER,Janis  CREASON,"City--10th Ward, 2nd Precinct",91,0,0,0,91,37577,705,19,0,38301
COUNTY TREASURER,Janis  CREASON,"City--10th Ward, 3rd Precinct",97,1,0,0,98,37577,705,19,0,38301
COUNTY TREASURER,Janis  CREASON,"City--10th Ward, 4th Precinct",115,0,0,0,115,37577,705,19,0,38301
COUNTY TREASURER,Janis  CREASON,City--11th Ward,103,39,0,0,142,37577,705,19,0,38301
COUNTY TREASURER,Janis  CREASON,City--12th Ward,241,6,0,0,247,37577,705,19,0,38301
COUNTY TREASURER,Janis  CREASON,"City--13th Ward, 1st Precinct",131,0,0,0,131,37577,705,19,0,38301
COUNTY TREASURER,Janis  CREASON,"City--13th Ward, 2nd Precinct",176,4,0,0,180,37577,705,19,0,38301
COUNTY TREASURER,Janis  CREASON,"City--13th Ward, 3rd Precinct",207,2,0,0,209,37577,705,19,0,38301
COUNTY TREASURER,Janis  CREASON,City--14th Ward,339,5,0,0,344,37577,705,19,0,38301
COUNTY TREASURER,Janis  CREASON,City--15th Ward,80,0,0,0,80,37577,705,19,0,38301
COUNTY TREASURER,Janis  CREASON,Berrysburg Borough,65,0,0,0,65,37577,705,19,0,38301
COUNTY TREASURER,Janis  CREASON,Dauphin Borough,169,1,0,0,170,37577,705,19,0,38301
COUNTY TREASURER,Janis  CREASON,Elizabethville Borough,182,3,0,0,185,37577,705,19,0,38301
COUNTY TREASURER,Janis  CREASON,Gratz Borough,83,2,0,0,85,37577,705,19,0,38301
COUNTY TREASURER,Janis  CREASON,Halifax Borough,85,3,0,0,88,37577,705,19,0,38301
COUNTY TREASURER,Janis  CREASON,Highspire--1st Precinct,151,2,0,0,153,37577,705,19,0,38301
COUNTY TREASURER,Janis  CREASON,Highspire--2nd Precinct,166,1,0,0,167,37577,705,19,0,38301
COUNTY TREASURER,Janis  CREASON,Hummelstown--1st Precinct,206,5,0,0,211,37577,705,19,0,38301
COUNTY TREASURER,Janis  CREASON,Hummelstown--2nd Precinct,423,5,0,0,428,37577,705,19,0,38301
COUNTY TREASURER,Janis  CREASON,Lykens Borough--1st Ward,102,1,0,0,103,37577,705,19,0,38301
COUNTY TREASURER,Janis  CREASON,Lykens Borough--2nd Ward,133,3,0,0,136,37577,705,19,0,38301
COUNTY TREASURER,Janis  CREASON,"Middletown--1st Ward, 1st Precinct",101,0,0,0,101,37577,705,19,0,38301
COUNTY TREASURER,Janis  CREASON,"Middletown--1st Ward, 2nd Precinct",167,7,1,0,175,37577,705,19,0,38301
COUNTY TREASURER,Janis  CREASON,"Middletown--2nd Ward, 1st Precinct",166,1,0,0,167,37577,705,19,0,38301
COUNTY TREASURER,Janis  CREASON,"Middletown--2nd Ward, 2nd Precinct",170,3,0,0,173,37577,705,19,0,38301
COUNTY TREASURER,Janis  CREASON,"Middletown--3rd Ward, 1st Precinct",132,2,0,0,134,37577,705,19,0,38301
COUNTY TREASURER,Janis  CREASON,"Middletown--3rd Ward, 2nd Precinct",217,0,0,0,217,37577,705,19,0,38301
COUNTY TREASURER,Janis  CREASON,Millersburg--1st Ward,136,4,0,0,140,37577,705,19,0,38301
COUNTY TREASURER,Janis  CREASON,Millersburg--2nd Ward,178,4,0,0,182,37577,705,19,0,38301
COUNTY TREASURER,Janis  CREASON,Paxtang Borough,282,3,0,0,285,37577,705,19,0,38301
COUNTY TREASURER,Janis  CREASON,Penbrook Borough--1st Ward,66,1,0,0,67,37577,705,19,0,38301
COUNTY TREASURER,Janis  CREASON,Penbrook Borough--2nd Ward,81,1,0,0,82,37577,705,19,0,38301
COUNTY TREASURER,Janis  CREASON,Penbrook Borough--3rd Ward,86,0,0,0,86,37577,705,19,0,38301
COUNTY TREASURER,Janis  CREASON,Penbrook Borough--4th Ward,106,1,0,0,107,37577,705,19,0,38301
COUNTY TREASURER,Janis  CREASON,Royalton Borough--1st Ward,48,0,0,0,48,37577,705,19,0,38301
COUNTY TREASURER,Janis  CREASON,Royalton Borough--2nd Ward,79,0,0,0,79,37577,705,19,0,38301
COUNTY TREASURER,Janis  CREASON,Steelton--1st Ward,145,6,0,0,151,37577,705,19,0,38301
COUNTY TREASURER,Janis  CREASON,"Steelton--2nd Ward, 1st Precinct",124,2,0,0,126,37577,705,19,0,38301
COUNTY TREASURER,Janis  CREASON,"Steelton--2nd Ward, 2nd Precinct",88,1,0,0,89,37577,705,19,0,38301
COUNTY TREASURER,Janis  CREASON,"Steelton--3rd Ward, 1st Precinct",55,0,0,0,55,37577,705,19,0,38301
COUNTY TREASURER,Janis  CREASON,"Steelton--3rd Ward, 2nd Precinct",115,0,0,0,115,37577,705,19,0,38301
COUNTY TREASURER,Janis  CREASON,Steelton--4th Ward,99,2,1,0,102,37577,705,19,0,38301
COUNTY TREASURER,Janis  CREASON,Pillow Borough,57,0,0,0,57,37577,705,19,0,38301
COUNTY TREASURER,Janis  CREASON,Williamstown--1st Ward,107,1,0,0,108,37577,705,19,0,38301
COUNTY TREASURER,Janis  CREASON,Williamstown--2nd Ward,70,0,0,0,70,37577,705,19,0,38301
COUNTY TREASURER,Janis  CREASON,Conewago Twp--1st Precinct,301,2,0,0,303,37577,705,19,0,38301
COUNTY TREASURER,Janis  CREASON,Conewago Twp--2nd Precinct,221,5,0,0,226,37577,705,19,0,38301
COUNTY TREASURER,Janis  CREASON,Derry Township--1st Precinct,361,5,0,0,366,37577,705,19,0,38301
COUNTY TREASURER,Janis  CREASON,Derry Township--2nd Precinct,286,7,0,0,293,37577,705,19,0,38301
COUNTY TREASURER,Janis  CREASON,Derry Township--3rd Precinct,240,6,1,0,247,37577,705,19,0,38301
COUNTY TREASURER,Janis  CREASON,Derry Township--4th Precinct,197,5,0,0,202,37577,705,19,0,38301
COUNTY TREASURER,Janis  CREASON,Derry Township--5th Precinct,146,3,0,0,149,37577,705,19,0,38301
COUNTY TREASURER,Janis  CREASON,Derry Township--6th Precinct,188,1,0,0,189,37577,705,19,0,38301
COUNTY TREASURER,Janis  CREASON,Derry Township--7th Precinct,386,16,0,0,402,37577,705,19,0,38301
COUNTY TREASURER,Janis  CREASON,Derry Township--8th Precinct,194,0,0,0,194,37577,705,19,0,38301
COUNTY TREASURER,Janis  CREASON,Derry Township--9th Precinct,141,4,0,0,145,37577,705,19,0,38301
COUNTY TREASURER,Janis  CREASON,Derry Township--10th Precinct,260,4,0,0,264,37577,705,19,0,38301
COUNTY TREASURER,Janis  CREASON,Derry Township--11th Precinct,361,7,0,0,368,37577,705,19,0,38301
COUNTY TREASURER,Janis  CREASON,Derry Township--12th Precinct,203,3,0,0,206,37577,705,19,0,38301
COUNTY TREASURER,Janis  CREASON,Derry Township--13th Precinct,294,7,0,0,301,37577,705,19,0,38301
COUNTY TREASURER,Janis  CREASON,Derry Township--14th Precinct,198,5,0,0,203,37577,705,19,0,38301
COUNTY TREASURER,Janis  CREASON,Derry Township--15th Precinct,353,6,1,0,360,37577,705,19,0,38301
COUNTY TREASURER,Janis  CREASON,East Hanover Township--1st Precinct,357,9,0,0,366,37577,705,19,0,38301
COUNTY TREASURER,Janis  CREASON,East Hanover Township--2nd Precinct,416,5,0,0,421,37577,705,19,0,38301
COUNTY TREASURER,Janis  CREASON,Halifax Twp--1st Precinct,285,5,0,0,290,37577,705,19,0,38301
COUNTY TREASURER,Janis  CREASON,Halifax Twp--2nd Precinct,328,10,0,0,338,37577,705,19,0,38301
COUNTY TREASURER,Janis  CREASON,Jackson Township,240,1,0,0,241,37577,705,19,0,38301
COUNTY TREASURER,Janis  CREASON,Jefferson Township,77,0,0,0,77,37577,705,19,0,38301
COUNTY TREASURER,Janis  CREASON,Londonderry Twp--1st Precinct,315,0,0,0,315,37577,705,19,0,38301
COUNTY TREASURER,Janis  CREASON,Londonderry Twp--2nd Precinct,303,4,0,0,307,37577,705,19,0,38301
COUNTY TREASURER,Janis  CREASON,Londonderry Twp--3rd Precinct,137,1,0,0,138,37577,705,19,0,38301
COUNTY TREASURER,Janis  CREASON,Lower Paxton Twp--1st Precinct,240,2,0,0,242,37577,705,19,0,38301
COUNTY TREASURER,Janis  CREASON,Lower Paxton Twp--2nd Precinct,255,10,0,0,265,37577,705,19,0,38301
COUNTY TREASURER,Janis  CREASON,Lower Paxton Twp--3rd precinct,451,12,0,0,463,37577,705,19,0,38301
COUNTY TREASURER,Janis  CREASON,Lower Paxton Twp--4th Precinct,334,4,0,0,338,37577,705,19,0,38301
COUNTY TREASURER,Janis  CREASON,Lower Paxton Twp--5th Precinct,290,3,1,0,294,37577,705,19,0,38301
COUNTY TREASURER,Janis  CREASON,Lower Paxton Twp--6th Precinct,237,4,0,0,241,37577,705,19,0,38301
COUNTY TREASURER,Janis  CREASON,Lower Paxton Twp--7th Precinct,400,7,0,0,407,37577,705,19,0,38301
COUNTY TREASURER,Janis  CREASON,Lower Paxton Twp--8th Precinct,196,4,0,0,200,37577,705,19,0,38301
COUNTY TREASURER,Janis  CREASON,Lower Paxton Twp--9th Precinct,236,4,0,0,240,37577,705,19,0,38301
COUNTY TREASURER,Janis  CREASON,Lower Paxton Twp--10th Precinct,178,6,0,0,184,37577,705,19,0,38301
COUNTY TREASURER,Janis  CREASON,Lower Paxton Twp--11th Precinct,233,4,1,0,238,37577,705,19,0,38301
COUNTY TREASURER,Janis  CREASON,Lower Paxton Twp--12th Precinct,335,8,1,0,344,37577,705,19,0,38301
COUNTY TREASURER,Janis  CREASON,Lower Paxton Twp--13th Precinct,329,6,0,0,335,37577,705,19,0,38301
COUNTY TREASURER,Janis  CREASON,Lower Paxton Twp--14th Precinct,196,3,3,0,202,37577,705,19,0,38301
COUNTY TREASURER,Janis  CREASON,Lower Paxton Twp--15th Precinct,290,3,0,0,293,37577,705,19,0,38301
COUNTY TREASURER,Janis  CREASON,Lower Paxton Twp--16th Precinct,490,9,0,0,499,37577,705,19,0,38301
COUNTY TREASURER,Janis  CREASON,Lower Paxton Twp--17th Precinct,259,7,0,0,266,37577,705,19,0,38301
COUNTY TREASURER,Janis  CREASON,Lower Paxton Twp--18th Precinct,235,2,0,0,237,37577,705,19,0,38301
COUNTY TREASURER,Janis  CREASON,Lower Paxton Twp--19th Precinct,412,15,0,0,427,37577,705,19,0,38301
COUNTY TREASURER,Janis  CREASON,Lower Paxton Twp--20th Precinct,312,5,0,0,317,37577,705,19,0,38301
COUNTY TREASURER,Janis  CREASON,Lower Paxton Twp--21st Precinct,391,9,0,0,400,37577,705,19,0,38301
COUNTY TREASURER,Janis  CREASON,Lower Paxton Twp--22nd Precinct,325,3,0,0,328,37577,705,19,0,38301
COUNTY TREASURER,Janis  CREASON,Lower Paxton Twp--23rd Precinct,281,3,0,0,284,37577,705,19,0,38301
COUNTY TREASURER,Janis  CREASON,Lower Paxton Twp--24th Precinct,304,6,0,0,310,37577,705,19,0,38301
COUNTY TREASURER,Janis  CREASON,Lower Paxton Twp--25th Precinct,217,4,0,0,221,37577,705,19,0,38301
COUNTY TREASURER,Janis  CREASON,Lower Paxton Twp--26th Precinct,311,7,0,0,318,37577,705,19,0,38301
COUNTY TREASURER,Janis  CREASON,Lower Paxton Twp--27th Precinct,272,2,0,0,274,37577,705,19,0,38301
COUNTY TREASURER,Janis  CREASON,Lower Swatara Twp--1st Precinct,384,3,0,0,387,37577,705,19,0,38301
COUNTY TREASURER,Janis  CREASON,Lower Swatara Twp--2nd Precinct,336,7,0,0,343,37577,705,19,0,38301
COUNTY TREASURER,Janis  CREASON,Lower Swatara Twp--3rd Precinct,301,29,0,0,330,37577,705,19,0,38301
COUNTY TREASURER,Janis  CREASON,Lower Swatara Twp--4th Precinct,285,1,0,0,286,37577,705,19,0,38301
COUNTY TREASURER,Janis  CREASON,Lykens Township,105,0,0,0,105,37577,705,19,0,38301
COUNTY TREASURER,Janis  CREASON,Middle Paxton Twp--1st Precinct,357,1,0,0,358,37577,705,19,0,38301
COUNTY TREASURER,Janis  CREASON,Middle Paxton Twp--2nd Precinct,300,1,0,0,301,37577,705,19,0,38301
COUNTY TREASURER,Janis  CREASON,Middle Paxton Twp--3rd Precinct,395,2,0,0,397,37577,705,19,0,38301
COUNTY TREASURER,Janis  CREASON,Mifflin Township,89,0,0,0,89,37577,705,19,0,38301
COUNTY TREASURER,Janis  CREASON,Reed Township,48,0,0,0,48,37577,705,19,0,38301
COUNTY TREASURER,Janis  CREASON,Rush Township,42,0,0,0,42,37577,705,19,0,38301
COUNTY TREASURER,Janis  CREASON,South Hanover Twp--1st Precinct,316,5,0,0,321,37577,705,19,0,38301
COUNTY TREASURER,Janis  CREASON,South Hanover Twp--2nd Precinct,424,8,0,0,432,37577,705,19,0,38301
COUNTY TREASURER,Janis  CREASON,South Hanover Twp--3rd Precinct,244,2,0,0,246,37577,705,19,0,38301
COUNTY TREASURER,Janis  CREASON,Susquehanna Twp--1st Ward,513,16,0,0,529,37577,705,19,0,38301
COUNTY TREASURER,Janis  CREASON,Susquehanna Twp--2nd Ward,720,25,0,0,745,37577,705,19,0,38301
COUNTY TREASURER,Janis  CREASON,Susquehanna Twp--3rd Ward,320,3,0,0,323,37577,705,19,0,38301
COUNTY TREASURER,Janis  CREASON,Susquehanna Twp--4th Ward,357,6,0,0,363,37577,705,19,0,38301
COUNTY TREASURER,Janis  CREASON,Susquehanna Twp--5th Ward,378,6,0,0,384,37577,705,19,0,38301
COUNTY TREASURER,Janis  CREASON,Susquehanna Twp--6th Ward,423,9,0,0,432,37577,705,19,0,38301
COUNTY TREASURER,Janis  CREASON,Susquehanna Twp--7th Ward,238,0,0,0,238,37577,705,19,0,38301
COUNTY TREASURER,Janis  CREASON,Susquehanna Twp--8th Ward,594,19,0,0,613,37577,705,19,0,38301
COUNTY TREASURER,Janis  CREASON,Susquehanna Twp--9th Ward,447,4,0,0,451,37577,705,19,0,38301
COUNTY TREASURER,Janis  CREASON,Swatara Township--1st Ward,363,5,0,0,368,37577,705,19,0,38301
COUNTY TREASURER,Janis  CREASON,Swatara Township--2nd Ward,222,23,0,0,245,37577,705,19,0,38301
COUNTY TREASURER,Janis  CREASON,Swatara Township--3rd Ward,261,5,0,0,266,37577,705,19,0,38301
COUNTY TREASURER,Janis  CREASON,Swatara Township--4th Ward,377,9,0,0,386,37577,705,19,0,38301
COUNTY TREASURER,Janis  CREASON,Swatara Township--5th Ward,506,5,0,0,511,37577,705,19,0,38301
COUNTY TREASURER,Janis  CREASON,Swatara Township--6th Ward,461,2,1,0,464,37577,705,19,0,38301
COUNTY TREASURER,Janis  CREASON,Swatara Township--7th Ward,478,12,0,0,490,37577,705,19,0,38301
COUNTY TREASURER,Janis  CREASON,Swatara Township--8th Ward,516,6,1,0,523,37577,705,19,0,38301
COUNTY TREASURER,Janis  CREASON,Swatara Township--9th Ward,227,10,0,0,237,37577,705,19,0,38301
COUNTY TREASURER,Janis  CREASON,Upper Paxton Twp--1st Precinct,300,1,0,0,301,37577,705,19,0,38301
COUNTY TREASURER,Janis  CREASON,Upper Paxton Twp--2nd Precinct,193,2,0,0,195,37577,705,19,0,38301
COUNTY TREASURER,Janis  CREASON,Washington Township,292,7,0,0,299,37577,705,19,0,38301
COUNTY TREASURER,Janis  CREASON,Wayne Township,262,0,1,0,263,37577,705,19,0,38301
COUNTY TREASURER,Janis  CREASON,West Hanover Twp--1st Precinct,320,5,0,0,325,37577,705,19,0,38301
COUNTY TREASURER,Janis  CREASON,West Hanover Twp--2nd Precinct,326,7,1,0,334,37577,705,19,0,38301
COUNTY TREASURER,Janis  CREASON,West Hanover Twp--3rd Precinct,712,16,1,0,729,37577,705,19,0,38301
COUNTY TREASURER,Janis  CREASON,West Hanover Twp--4th Precinct,409,1,0,0,410,37577,705,19,0,38301
COUNTY TREASURER,Janis  CREASON,Wiconisco Twp--1st Precinct,97,1,0,0,98,37577,705,19,0,38301
COUNTY TREASURER,Janis  CREASON,Wiconisco Twp--2nd Precinct,76,1,0,0,77,37577,705,19,0,38301
COUNTY TREASURER,Janis  CREASON,Williams Twp,148,1,0,0,149,37577,705,19,0,38301
COUNTY TREASURER,Write In  ,"City--1st Ward, 1st Precinct",0,0,0,0,0,49,0,0,0,49
COUNTY TREASURER,Write In  ,"City--1st Ward, 2nd Precinct",0,0,0,0,0,49,0,0,0,49
COUNTY TREASURER,Write In  ,"City--1st Ward, 3rd Precinct",0,0,0,0,0,49,0,0,0,49
COUNTY TREASURER,Write In  ,"City--2nd Ward, 1st Precinct",0,0,0,0,0,49,0,0,0,49
COUNTY TREASURER,Write In  ,"City--2nd Ward, 2nd Precinct",0,0,0,0,0,49,0,0,0,49
COUNTY TREASURER,Write In  ,City--3rd Ward,0,0,0,0,0,49,0,0,0,49
COUNTY TREASURER,Write In  ,City--4th Ward,0,0,0,0,0,49,0,0,0,49
COUNTY TREASURER,Write In  ,City--5th Ward,1,0,0,0,1,49,0,0,0,49
COUNTY TREASURER,Write In  ,City--6th Ward,0,0,0,0,0,49,0,0,0,49
COUNTY TREASURER,Write In  ,"City--7th Ward, 1st Precinct",0,0,0,0,0,49,0,0,0,49
COUNTY TREASURER,Write In  ,"City--7th Ward, 2nd Precinct",0,0,0,0,0,49,0,0,0,49
COUNTY TREASURER,Write In  ,City--8th Ward,0,0,0,0,0,49,0,0,0,49
COUNTY TREASURER,Write In  ,"City--9th Ward, 1st Precinct",0,0,0,0,0,49,0,0,0,49
COUNTY TREASURER,Write In  ,"City--9th Ward, 2nd Precinct",0,0,0,0,0,49,0,0,0,49
COUNTY TREASURER,Write In  ,"City--9th Ward, 3rd Precinct",0,0,0,0,0,49,0,0,0,49
COUNTY TREASURER,Write In  ,"City--9th Ward, 4th Precinct",0,0,0,0,0,49,0,0,0,49
COUNTY TREASURER,Write In  ,"City--9th Ward, 5th Precinct",0,0,0,0,0,49,0,0,0,49
COUNTY TREASURER,Write In  ,"City--10th Ward, 1st Precinct",0,0,0,0,0,49,0,0,0,49
COUNTY TREASURER,Write In  ,"City--10th Ward, 2nd Precinct",0,0,0,0,0,49,0,0,0,49
COUNTY TREASURER,Write In  ,"City--10th Ward, 3rd Precinct",1,0,0,0,1,49,0,0,0,49
COUNTY TREASURER,Write In  ,"City--10th Ward, 4th Precinct",0,0,0,0,0,49,0,0,0,49
COUNTY TREASURER,Write In  ,City--11th Ward,0,0,0,0,0,49,0,0,0,49
COUNTY TREASURER,Write In  ,City--12th Ward,1,0,0,0,1,49,0,0,0,49
COUNTY TREASURER,Write In  ,"City--13th Ward, 1st Precinct",0,0,0,0,0,49,0,0,0,49
COUNTY TREASURER,Write In  ,"City--13th Ward, 2nd Precinct",0,0,0,0,0,49,0,0,0,49
COUNTY TREASURER,Write In  ,"City--13th Ward, 3rd Precinct",1,0,0,0,1,49,0,0,0,49
COUNTY TREASURER,Write In  ,City--14th Ward,0,0,0,0,0,49,0,0,0,49
COUNTY TREASURER,Write In  ,City--15th Ward,0,0,0,0,0,49,0,0,0,49
COUNTY TREASURER,Write In  ,Berrysburg Borough,0,0,0,0,0,49,0,0,0,49
COUNTY TREASURER,Write In  ,Dauphin Borough,0,0,0,0,0,49,0,0,0,49
COUNTY TREASURER,Write In  ,Elizabethville Borough,0,0,0,0,0,49,0,0,0,49
COUNTY TREASURER,Write In  ,Gratz Borough,0,0,0,0,0,49,0,0,0,49
COUNTY TREASURER,Write In  ,Halifax Borough,0,0,0,0,0,49,0,0,0,49
COUNTY TREASURER,Write In  ,Highspire--1st Precinct,0,0,0,0,0,49,0,0,0,49
COUNTY TREASURER,Write In  ,Highspire--2nd Precinct,0,0,0,0,0,49,0,0,0,49
COUNTY TREASURER,Write In  ,Hummelstown--1st Precinct,0,0,0,0,0,49,0,0,0,49
COUNTY TREASURER,Write In  ,Hummelstown--2nd Precinct,0,0,0,0,0,49,0,0,0,49
COUNTY TREASURER,Write In  ,Lykens Borough--1st Ward,0,0,0,0,0,49,0,0,0,49
COUNTY TREASURER,Write In  ,Lykens Borough--2nd Ward,1,0,0,0,1,49,0,0,0,49
COUNTY TREASURER,Write In  ,"Middletown--1st Ward, 1st Precinct",0,0,0,0,0,49,0,0,0,49
COUNTY TREASURER,Write In  ,"Middletown--1st Ward, 2nd Precinct",0,0,0,0,0,49,0,0,0,49
COUNTY TREASURER,Write In  ,"Middletown--2nd Ward, 1st Precinct",1,0,0,0,1,49,0,0,0,49
COUNTY TREASURER,Write In  ,"Middletown--2nd Ward, 2nd Precinct",0,0,0,0,0,49,0,0,0,49
COUNTY TREASURER,Write In  ,"Middletown--3rd Ward, 1st Precinct",0,0,0,0,0,49,0,0,0,49
COUNTY TREASURER,Write In  ,"Middletown--3rd Ward, 2nd Precinct",0,0,0,0,0,49,0,0,0,49
COUNTY TREASURER,Write In  ,Millersburg--1st Ward,0,0,0,0,0,49,0,0,0,49
COUNTY TREASURER,Write In  ,Millersburg--2nd Ward,3,0,0,0,3,49,0,0,0,49
COUNTY TREASURER,Write In  ,Paxtang Borough,0,0,0,0,0,49,0,0,0,49
COUNTY TREASURER,Write In  ,Penbrook Borough--1st Ward,0,0,0,0,0,49,0,0,0,49
COUNTY TREASURER,Write In  ,Penbrook Borough--2nd Ward,0,0,0,0,0,49,0,0,0,49
COUNTY TREASURER,Write In  ,Penbrook Borough--3rd Ward,0,0,0,0,0,49,0,0,0,49
COUNTY TREASURER,Write In  ,Penbrook Borough--4th Ward,0,0,0,0,0,49,0,0,0,49
COUNTY TREASURER,Write In  ,Royalton Borough--1st Ward,0,0,0,0,0,49,0,0,0,49
COUNTY TREASURER,Write In  ,Royalton Borough--2nd Ward,0,0,0,0,0,49,0,0,0,49
COUNTY TREASURER,Write In  ,Steelton--1st Ward,0,0,0,0,0,49,0,0,0,49
COUNTY TREASURER,Write In  ,"Steelton--2nd Ward, 1st Precinct",0,0,0,0,0,49,0,0,0,49
COUNTY TREASURER,Write In  ,"Steelton--2nd Ward, 2nd Precinct",0,0,0,0,0,49,0,0,0,49
COUNTY TREASURER,Write In  ,"Steelton--3rd Ward, 1st Precinct",0,0,0,0,0,49,0,0,0,49
COUNTY TREASURER,Write In  ,"Steelton--3rd Ward, 2nd Precinct",1,0,0,0,1,49,0,0,0,49
COUNTY TREASURER,Write In  ,Steelton--4th Ward,0,0,0,0,0,49,0,0,0,49
COUNTY TREASURER,Write In  ,Pillow Borough,0,0,0,0,0,49,0,0,0,49
COUNTY TREASURER,Write In  ,Williamstown--1st Ward,0,0,0,0,0,49,0,0,0,49
COUNTY TREASURER,Write In  ,Williamstown--2nd Ward,0,0,0,0,0,49,0,0,0,49
COUNTY TREASURER,Write In  ,Conewago Twp--1st Precinct,0,0,0,0,0,49,0,0,0,49
COUNTY TREASURER,Write In  ,Conewago Twp--2nd Precinct,0,0,0,0,0,49,0,0,0,49
COUNTY TREASURER,Write In  ,Derry Township--1st Precinct,0,0,0,0,0,49,0,0,0,49
COUNTY TREASURER,Write In  ,Derry Township--2nd Precinct,0,0,0,0,0,49,0,0,0,49
COUNTY TREASURER,Write In  ,Derry Township--3rd Precinct,0,0,0,0,0,49,0,0,0,49
COUNTY TREASURER,Write In  ,Derry Township--4th Precinct,0,0,0,0,0,49,0,0,0,49
COUNTY TREASURER,Write In  ,Derry Township--5th Precinct,0,0,0,0,0,49,0,0,0,49
COUNTY TREASURER,Write In  ,Derry Township--6th Precinct,0,0,0,0,0,49,0,0,0,49
COUNTY TREASURER,Write In  ,Derry Township--7th Precinct,0,0,0,0,0,49,0,0,0,49
COUNTY TREASURER,Write In  ,Derry Township--8th Precinct,0,0,0,0,0,49,0,0,0,49
COUNTY TREASURER,Write In  ,Derry Township--9th Precinct,0,0,0,0,0,49,0,0,0,49
COUNTY TREASURER,Write In  ,Derry Township--10th Precinct,0,0,0,0,0,49,0,0,0,49
COUNTY TREASURER,Write In  ,Derry Township--11th Precinct,0,0,0,0,0,49,0,0,0,49
COUNTY TREASURER,Write In  ,Derry Township--12th Precinct,0,0,0,0,0,49,0,0,0,49
COUNTY TREASURER,Write In  ,Derry Township--13th Precinct,0,0,0,0,0,49,0,0,0,49
COUNTY TREASURER,Write In  ,Derry Township--14th Precinct,0,0,0,0,0,49,0,0,0,49
COUNTY TREASURER,Write In  ,Derry Township--15th Precinct,0,0,0,0,0,49,0,0,0,49
COUNTY TREASURER,Write In  ,East Hanover Township--1st Precinct,0,0,0,0,0,49,0,0,0,49
COUNTY TREASURER,Write In  ,East Hanover Township--2nd Precinct,1,0,0,0,1,49,0,0,0,49
COUNTY TREASURER,Write In  ,Halifax Twp--1st Precinct,1,0,0,0,1,49,0,0,0,49
COUNTY TREASURER,Write In  ,Halifax Twp--2nd Precinct,2,0,0,0,2,49,0,0,0,49
COUNTY TREASURER,Write In  ,Jackson Township,0,0,0,0,0,49,0,0,0,49
COUNTY TREASURER,Write In  ,Jefferson Township,0,0,0,0,0,49,0,0,0,49
COUNTY TREASURER,Write In  ,Londonderry Twp--1st Precinct,0,0,0,0,0,49,0,0,0,49
COUNTY TREASURER,Write In  ,Londonderry Twp--2nd Precinct,0,0,0,0,0,49,0,0,0,49
COUNTY TREASURER,Write In  ,Londonderry Twp--3rd Precinct,0,0,0,0,0,49,0,0,0,49
COUNTY TREASURER,Write In  ,Lower Paxton Twp--1st Precinct,1,0,0,0,1,49,0,0,0,49
COUNTY TREASURER,Write In  ,Lower Paxton Twp--2nd Precinct,0,0,0,0,0,49,0,0,0,49
COUNTY TREASURER,Write In  ,Lower Paxton Twp--3rd precinct,1,0,0,0,1,49,0,0,0,49
COUNTY TREASURER,Write In  ,Lower Paxton Twp--4th Precinct,0,0,0,0,0,49,0,0,0,49
COUNTY TREASURER,Write In  ,Lower Paxton Twp--5th Precinct,2,0,0,0,2,49,0,0,0,49
COUNTY TREASURER,Write In  ,Lower Paxton Twp--6th Precinct,0,0,0,0,0,49,0,0,0,49
COUNTY TREASURER,Write In  ,Lower Paxton Twp--7th Precinct,0,0,0,0,0,49,0,0,0,49
COUNTY TREASURER,Write In  ,Lower Paxton Twp--8th Precinct,0,0,0,0,0,49,0,0,0,49
COUNTY TREASURER,Write In  ,Lower Paxton Twp--9th Precinct,1,0,0,0,1,49,0,0,0,49
COUNTY TREASURER,Write In  ,Lower Paxton Twp--10th Precinct,0,0,0,0,0,49,0,0,0,49
COUNTY TREASURER,Write In  ,Lower Paxton Twp--11th Precinct,1,0,0,0,1,49,0,0,0,49
COUNTY TREASURER,Write In  ,Lower Paxton Twp--12th Precinct,3,0,0,0,3,49,0,0,0,49
COUNTY TREASURER,Write In  ,Lower Paxton Twp--13th Precinct,2,0,0,0,2,49,0,0,0,49
COUNTY TREASURER,Write In  ,Lower Paxton Twp--14th Precinct,1,0,0,0,1,49,0,0,0,49
COUNTY TREASURER,Write In  ,Lower Paxton Twp--15th Precinct,1,0,0,0,1,49,0,0,0,49
COUNTY TREASURER,Write In  ,Lower Paxton Twp--16th Precinct,0,0,0,0,0,49,0,0,0,49
COUNTY TREASURER,Write In  ,Lower Paxton Twp--17th Precinct,3,0,0,0,3,49,0,0,0,49
COUNTY TREASURER,Write In  ,Lower Paxton Twp--18th Precinct,0,0,0,0,0,49,0,0,0,49
COUNTY TREASURER,Write In  ,Lower Paxton Twp--19th Precinct,1,0,0,0,1,49,0,0,0,49
COUNTY TREASURER,Write In  ,Lower Paxton Twp--20th Precinct,0,0,0,0,0,49,0,0,0,49
COUNTY TREASURER,Write In  ,Lower Paxton Twp--21st Precinct,0,0,0,0,0,49,0,0,0,49
COUNTY TREASURER,Write In  ,Lower Paxton Twp--22nd Precinct,0,0,0,0,0,49,0,0,0,49
COUNTY TREASURER,Write In  ,Lower Paxton Twp--23rd Precinct,1,0,0,0,1,49,0,0,0,49
COUNTY TREASURER,Write In  ,Lower Paxton Twp--24th Precinct,1,0,0,0,1,49,0,0,0,49
COUNTY TREASURER,Write In  ,Lower Paxton Twp--25th Precinct,0,0,0,0,0,49,0,0,0,49
COUNTY TREASURER,Write In  ,Lower Paxton Twp--26th Precinct,0,0,0,0,0,49,0,0,0,49
COUNTY TREASURER,Write In  ,Lower Paxton Twp--27th Precinct,1,0,0,0,1,49,0,0,0,49
COUNTY TREASURER,Write In  ,Lower Swatara Twp--1st Precinct,1,0,0,0,1,49,0,0,0,49
COUNTY TREASURER,Write In  ,Lower Swatara Twp--2nd Precinct,0,0,0,0,0,49,0,0,0,49
COUNTY TREASURER,Write In  ,Lower Swatara Twp--3rd Precinct,0,0,0,0,0,49,0,0,0,49
COUNTY TREASURER,Write In  ,Lower Swatara Twp--4th Precinct,0,0,0,0,0,49,0,0,0,49
COUNTY TREASURER,Write In  ,Lykens Township,0,0,0,0,0,49,0,0,0,49
COUNTY TREASURER,Write In  ,Middle Paxton Twp--1st Precinct,0,0,0,0,0,49,0,0,0,49
COUNTY TREASURER,Write In  ,Middle Paxton Twp--2nd Precinct,2,0,0,0,2,49,0,0,0,49
COUNTY TREASURER,Write In  ,Middle Paxton Twp--3rd Precinct,0,0,0,0,0,49,0,0,0,49
COUNTY TREASURER,Write In  ,Mifflin Township,0,0,0,0,0,49,0,0,0,49
COUNTY TREASURER,Write In  ,Reed Township,0,0,0,0,0,49,0,0,0,49
COUNTY TREASURER,Write In  ,Rush Township,0,0,0,0,0,49,0,0,0,49
COUNTY TREASURER,Write In  ,South Hanover Twp--1st Precinct,0,0,0,0,0,49,0,0,0,49
COUNTY TREASURER,Write In  ,South Hanover Twp--2nd Precinct,0,0,0,0,0,49,0,0,0,49
COUNTY TREASURER,Write In  ,South Hanover Twp--3rd Precinct,0,0,0,0,0,49,0,0,0,49
COUNTY TREASURER,Write In  ,Susquehanna Twp--1st Ward,1,0,0,0,1,49,0,0,0,49
COUNTY TREASURER,Write In  ,Susquehanna Twp--2nd Ward,1,0,0,0,1,49,0,0,0,49
COUNTY TREASURER,Write In  ,Susquehanna Twp--3rd Ward,0,0,0,0,0,49,0,0,0,49
COUNTY TREASURER,Write In  ,Susquehanna Twp--4th Ward,0,0,0,0,0,49,0,0,0,49
COUNTY TREASURER,Write In  ,Susquehanna Twp--5th Ward,0,0,0,0,0,49,0,0,0,49
COUNTY TREASURER,Write In  ,Susquehanna Twp--6th Ward,0,0,0,0,0,49,0,0,0,49
COUNTY TREASURER,Write In  ,Susquehanna Twp--7th Ward,2,0,0,0,2,49,0,0,0,49
COUNTY TREASURER,Write In  ,Susquehanna Twp--8th Ward,3,0,0,0,3,49,0,0,0,49
COUNTY TREASURER,Write In  ,Susquehanna Twp--9th Ward,1,0,0,0,1,49,0,0,0,49
COUNTY TREASURER,Write In  ,Swatara Township--1st Ward,1,0,0,0,1,49,0,0,0,49
COUNTY TREASURER,Write In  ,Swatara Township--2nd Ward,0,0,0,0,0,49,0,0,0,49
COUNTY TREASURER,Write In  ,Swatara Township--3rd Ward,0,0,0,0,0,49,0,0,0,49
COUNTY TREASURER,Write In  ,Swatara Township--4th Ward,0,0,0,0,0,49,0,0,0,49
COUNTY TREASURER,Write In  ,Swatara Township--5th Ward,0,0,0,0,0,49,0,0,0,49
COUNTY TREASURER,Write In  ,Swatara Township--6th Ward,0,0,0,0,0,49,0,0,0,49
COUNTY TREASURER,Write In  ,Swatara Township--7th Ward,0,0,0,0,0,49,0,0,0,49
COUNTY TREASURER,Write In  ,Swatara Township--8th Ward,0,0,0,0,0,49,0,0,0,49
COUNTY TREASURER,Write In  ,Swatara Township--9th Ward,1,0,0,0,1,49,0,0,0,49
COUNTY TREASURER,Write In  ,Upper Paxton Twp--1st Precinct,0,0,0,0,0,49,0,0,0,49
COUNTY TREASURER,Write In  ,Upper Paxton Twp--2nd Precinct,0,0,0,0,0,49,0,0,0,49
COUNTY TREASURER,Write In  ,Washington Township,0,0,0,0,0,49,0,0,0,49
COUNTY TREASURER,Write In  ,Wayne Township,0,0,0,0,0,49,0,0,0,49
COUNTY TREASURER,Write In  ,West Hanover Twp--1st Precinct,1,0,0,0,1,49,0,0,0,49
COUNTY TREASURER,Write In  ,West Hanover Twp--2nd Precinct,0,0,0,0,0,49,0,0,0,49
COUNTY TREASURER,Write In  ,West Hanover Twp--3rd Precinct,0,0,0,0,0,49,0,0,0,49
COUNTY TREASURER,Write In  ,West Hanover Twp--4th Precinct,1,0,0,0,1,49,0,0,0,49
COUNTY TREASURER,Write In  ,Wiconisco Twp--1st Precinct,0,0,0,0,0,49,0,0,0,49
COUNTY TREASURER,Write In  ,Wiconisco Twp--2nd Precinct,0,0,0,0,0,49,0,0,0,49
COUNTY TREASURER,Write In  ,Williams Twp,0,0,0,0,0,49,0,0,0,49
DISTRICT ATTORNEY,Edward  MARSICO,"City--1st Ward, 1st Precinct",69,3,0,0,72,33717,700,19,0,34436
DISTRICT ATTORNEY,Edward  MARSICO,"City--1st Ward, 2nd Precinct",132,1,1,0,134,33717,700,19,0,34436
DISTRICT ATTORNEY,Edward  MARSICO,"City--1st Ward, 3rd Precinct",34,0,0,0,34,33717,700,19,0,34436
DISTRICT ATTORNEY,Edward  MARSICO,"City--2nd Ward, 1st Precinct",43,0,0,0,43,33717,700,19,0,34436
DISTRICT ATTORNEY,Edward  MARSICO,"City--2nd Ward, 2nd Precinct",58,1,0,0,59,33717,700,19,0,34436
DISTRICT ATTORNEY,Edward  MARSICO,City--3rd Ward,67,1,0,0,68,33717,700,19,0,34436
DISTRICT ATTORNEY,Edward  MARSICO,City--4th Ward,110,5,0,0,115,33717,700,19,0,34436
DISTRICT ATTORNEY,Edward  MARSICO,City--5th Ward,223,10,0,0,233,33717,700,19,0,34436
DISTRICT ATTORNEY,Edward  MARSICO,City--6th Ward,125,1,2,0,128,33717,700,19,0,34436
DISTRICT ATTORNEY,Edward  MARSICO,"City--7th Ward, 1st Precinct",43,2,0,0,45,33717,700,19,0,34436
DISTRICT ATTORNEY,Edward  MARSICO,"City--7th Ward, 2nd Precinct",72,2,0,0,74,33717,700,19,0,34436
DISTRICT ATTORNEY,Edward  MARSICO,City--8th Ward,72,2,0,0,74,33717,700,19,0,34436
DISTRICT ATTORNEY,Edward  MARSICO,"City--9th Ward, 1st Precinct",35,2,0,0,37,33717,700,19,0,34436
DISTRICT ATTORNEY,Edward  MARSICO,"City--9th Ward, 2nd Precinct",45,1,0,0,46,33717,700,19,0,34436
DISTRICT ATTORNEY,Edward  MARSICO,"City--9th Ward, 3rd Precinct",92,2,0,0,94,33717,700,19,0,34436
DISTRICT ATTORNEY,Edward  MARSICO,"City--9th Ward, 4th Precinct",159,4,0,0,163,33717,700,19,0,34436
DISTRICT ATTORNEY,Edward  MARSICO,"City--9th Ward, 5th Precinct",100,5,0,0,105,33717,700,19,0,34436
DISTRICT ATTORNEY,Edward  MARSICO,"City--10th Ward, 1st Precinct",142,6,0,0,148,33717,700,19,0,34436
DISTRICT ATTORNEY,Edward  MARSICO,"City--10th Ward, 2nd Precinct",48,0,0,0,48,33717,700,19,0,34436
DISTRICT ATTORNEY,Edward  MARSICO,"City--10th Ward, 3rd Precinct",95,1,0,0,96,33717,700,19,0,34436
DISTRICT ATTORNEY,Edward  MARSICO,"City--10th Ward, 4th Precinct",57,0,0,0,57,33717,700,19,0,34436
DISTRICT ATTORNEY,Edward  MARSICO,City--11th Ward,70,34,0,0,104,33717,700,19,0,34436
DISTRICT ATTORNEY,Edward  MARSICO,City--12th Ward,177,6,0,0,183,33717,700,19,0,34436
DISTRICT ATTORNEY,Edward  MARSICO,"City--13th Ward, 1st Precinct",109,0,0,0,109,33717,700,19,0,34436
DISTRICT ATTORNEY,Edward  MARSICO,"City--13th Ward, 2nd Precinct",156,4,0,0,160,33717,700,19,0,34436
DISTRICT ATTORNEY,Edward  MARSICO,"City--13th Ward, 3rd Precinct",171,2,0,0,173,33717,700,19,0,34436
DISTRICT ATTORNEY,Edward  MARSICO,City--14th Ward,286,3,0,0,289,33717,700,19,0,34436
DISTRICT ATTORNEY,Edward  MARSICO,City--15th Ward,49,0,0,0,49,33717,700,19,0,34436
DISTRICT ATTORNEY,Edward  MARSICO,Berrysburg Borough,58,0,0,0,58,33717,700,19,0,34436
DISTRICT ATTORNEY,Edward  MARSICO,Dauphin Borough,163,1,0,0,164,33717,700,19,0,34436
DISTRICT ATTORNEY,Edward  MARSICO,Elizabethville Borough,165,1,0,0,166,33717,700,19,0,34436
DISTRICT ATTORNEY,Edward  MARSICO,Gratz Borough,83,2,0,0,85,33717,700,19,0,34436
DISTRICT ATTORNEY,Edward  MARSICO,Halifax Borough,77,3,0,0,80,33717,700,19,0,34436
DISTRICT ATTORNEY,Edward  MARSICO,Highspire--1st Precinct,135,2,0,0,137,33717,700,19,0,34436
DISTRICT ATTORNEY,Edward  MARSICO,Highspire--2nd Precinct,149,1,0,0,150,33717,700,19,0,34436
DISTRICT ATTORNEY,Edward  MARSICO,Hummelstown--1st Precinct,191,4,0,0,195,33717,700,19,0,34436
DISTRICT ATTORNEY,Edward  MARSICO,Hummelstown--2nd Precinct,406,4,0,0,410,33717,700,19,0,34436
DISTRICT ATTORNEY,Edward  MARSICO,Lykens Borough--1st Ward,82,1,0,0,83,33717,700,19,0,34436
DISTRICT ATTORNEY,Edward  MARSICO,Lykens Borough--2nd Ward,117,4,0,0,121,33717,700,19,0,34436
DISTRICT ATTORNEY,Edward  MARSICO,"Middletown--1st Ward, 1st Precinct",93,0,0,0,93,33717,700,19,0,34436
DISTRICT ATTORNEY,Edward  MARSICO,"Middletown--1st Ward, 2nd Precinct",143,8,1,0,152,33717,700,19,0,34436
DISTRICT ATTORNEY,Edward  MARSICO,"Middletown--2nd Ward, 1st Precinct",155,2,0,0,157,33717,700,19,0,34436
DISTRICT ATTORNEY,Edward  MARSICO,"Middletown--2nd Ward, 2nd Precinct",160,6,0,0,166,33717,700,19,0,34436
DISTRICT ATTORNEY,Edward  MARSICO,"Middletown--3rd Ward, 1st Precinct",129,1,0,0,130,33717,700,19,0,34436
DISTRICT ATTORNEY,Edward  MARSICO,"Middletown--3rd Ward, 2nd Precinct",207,0,0,0,207,33717,700,19,0,34436
DISTRICT ATTORNEY,Edward  MARSICO,Millersburg--1st Ward,132,4,0,0,136,33717,700,19,0,34436
DISTRICT ATTORNEY,Edward  MARSICO,Millersburg--2nd Ward,177,4,0,0,181,33717,700,19,0,34436
DISTRICT ATTORNEY,Edward  MARSICO,Paxtang Borough,259,2,0,0,261,33717,700,19,0,34436
DISTRICT ATTORNEY,Edward  MARSICO,Penbrook Borough--1st Ward,58,1,0,0,59,33717,700,19,0,34436
DISTRICT ATTORNEY,Edward  MARSICO,Penbrook Borough--2nd Ward,69,1,0,0,70,33717,700,19,0,34436
DISTRICT ATTORNEY,Edward  MARSICO,Penbrook Borough--3rd Ward,75,0,0,0,75,33717,700,19,0,34436
DISTRICT ATTORNEY,Edward  MARSICO,Penbrook Borough--4th Ward,85,2,0,0,87,33717,700,19,0,34436
DISTRICT ATTORNEY,Edward  MARSICO,Royalton Borough--1st Ward,42,0,0,0,42,33717,700,19,0,34436
DISTRICT ATTORNEY,Edward  MARSICO,Royalton Borough--2nd Ward,77,0,0,0,77,33717,700,19,0,34436
DISTRICT ATTORNEY,Edward  MARSICO,Steelton--1st Ward,146,6,0,0,152,33717,700,19,0,34436
DISTRICT ATTORNEY,Edward  MARSICO,"Steelton--2nd Ward, 1st Precinct",96,2,0,0,98,33717,700,19,0,34436
DISTRICT ATTORNEY,Edward  MARSICO,"Steelton--2nd Ward, 2nd Precinct",88,1,0,0,89,33717,700,19,0,34436
DISTRICT ATTORNEY,Edward  MARSICO,"Steelton--3rd Ward, 1st Precinct",43,0,0,0,43,33717,700,19,0,34436
DISTRICT ATTORNEY,Edward  MARSICO,"Steelton--3rd Ward, 2nd Precinct",79,0,0,0,79,33717,700,19,0,34436
DISTRICT ATTORNEY,Edward  MARSICO,Steelton--4th Ward,84,2,1,0,87,33717,700,19,0,34436
DISTRICT ATTORNEY,Edward  MARSICO,Pillow Borough,49,0,0,0,49,33717,700,19,0,34436
DISTRICT ATTORNEY,Edward  MARSICO,Williamstown--1st Ward,86,1,0,0,87,33717,700,19,0,34436
DISTRICT ATTORNEY,Edward  MARSICO,Williamstown--2nd Ward,65,0,0,0,65,33717,700,19,0,34436
DISTRICT ATTORNEY,Edward  MARSICO,Conewago Twp--1st Precinct,271,1,0,0,272,33717,700,19,0,34436
DISTRICT ATTORNEY,Edward  MARSICO,Conewago Twp--2nd Precinct,205,7,0,0,212,33717,700,19,0,34436
DISTRICT ATTORNEY,Edward  MARSICO,Derry Township--1st Precinct,341,6,0,0,347,33717,700,19,0,34436
DISTRICT ATTORNEY,Edward  MARSICO,Derry Township--2nd Precinct,275,7,0,0,282,33717,700,19,0,34436
DISTRICT ATTORNEY,Edward  MARSICO,Derry Township--3rd Precinct,212,6,0,0,218,33717,700,19,0,34436
DISTRICT ATTORNEY,Edward  MARSICO,Derry Township--4th Precinct,174,5,0,0,179,33717,700,19,0,34436
DISTRICT ATTORNEY,Edward  MARSICO,Derry Township--5th Precinct,141,3,0,0,144,33717,700,19,0,34436
DISTRICT ATTORNEY,Edward  MARSICO,Derry Township--6th Precinct,165,2,1,0,168,33717,700,19,0,34436
DISTRICT ATTORNEY,Edward  MARSICO,Derry Township--7th Precinct,377,18,0,0,395,33717,700,19,0,34436
DISTRICT ATTORNEY,Edward  MARSICO,Derry Township--8th Precinct,186,0,0,0,186,33717,700,19,0,34436
DISTRICT ATTORNEY,Edward  MARSICO,Derry Township--9th Precinct,112,3,0,0,115,33717,700,19,0,34436
DISTRICT ATTORNEY,Edward  MARSICO,Derry Township--10th Precinct,258,4,0,0,262,33717,700,19,0,34436
DISTRICT ATTORNEY,Edward  MARSICO,Derry Township--11th Precinct,326,7,0,0,333,33717,700,19,0,34436
DISTRICT ATTORNEY,Edward  MARSICO,Derry Township--12th Precinct,191,4,0,0,195,33717,700,19,0,34436
DISTRICT ATTORNEY,Edward  MARSICO,Derry Township--13th Precinct,269,7,0,0,276,33717,700,19,0,34436
DISTRICT ATTORNEY,Edward  MARSICO,Derry Township--14th Precinct,180,5,0,0,185,33717,700,19,0,34436
DISTRICT ATTORNEY,Edward  MARSICO,Derry Township--15th Precinct,336,5,1,0,342,33717,700,19,0,34436
DISTRICT ATTORNEY,Edward  MARSICO,East Hanover Township--1st Precinct,360,9,0,0,369,33717,700,19,0,34436
DISTRICT ATTORNEY,Edward  MARSICO,East Hanover Township--2nd Precinct,398,5,0,0,403,33717,700,19,0,34436
DISTRICT ATTORNEY,Edward  MARSICO,Halifax Twp--1st Precinct,274,3,0,0,277,33717,700,19,0,34436
DISTRICT ATTORNEY,Edward  MARSICO,Halifax Twp--2nd Precinct,328,11,0,0,339,33717,700,19,0,34436
DISTRICT ATTORNEY,Edward  MARSICO,Jackson Township,226,1,0,0,227,33717,700,19,0,34436
DISTRICT ATTORNEY,Edward  MARSICO,Jefferson Township,62,0,0,0,62,33717,700,19,0,34436
DISTRICT ATTORNEY,Edward  MARSICO,Londonderry Twp--1st Precinct,295,0,0,0,295,33717,700,19,0,34436
DISTRICT ATTORNEY,Edward  MARSICO,Londonderry Twp--2nd Precinct,276,3,0,0,279,33717,700,19,0,34436
DISTRICT ATTORNEY,Edward  MARSICO,Londonderry Twp--3rd Precinct,124,1,0,0,125,33717,700,19,0,34436
DISTRICT ATTORNEY,Edward  MARSICO,Lower Paxton Twp--1st Precinct,224,3,0,0,227,33717,700,19,0,34436
DISTRICT ATTORNEY,Edward  MARSICO,Lower Paxton Twp--2nd Precinct,227,8,0,0,235,33717,700,19,0,34436
DISTRICT ATTORNEY,Edward  MARSICO,Lower Paxton Twp--3rd precinct,439,11,0,0,450,33717,700,19,0,34436
DISTRICT ATTORNEY,Edward  MARSICO,Lower Paxton Twp--4th Precinct,325,4,0,0,329,33717,700,19,0,34436
DISTRICT ATTORNEY,Edward  MARSICO,Lower Paxton Twp--5th Precinct,258,4,1,0,263,33717,700,19,0,34436
DISTRICT ATTORNEY,Edward  MARSICO,Lower Paxton Twp--6th Precinct,204,4,0,0,208,33717,700,19,0,34436
DISTRICT ATTORNEY,Edward  MARSICO,Lower Paxton Twp--7th Precinct,383,7,0,0,390,33717,700,19,0,34436
DISTRICT ATTORNEY,Edward  MARSICO,Lower Paxton Twp--8th Precinct,176,2,0,0,178,33717,700,19,0,34436
DISTRICT ATTORNEY,Edward  MARSICO,Lower Paxton Twp--9th Precinct,229,4,0,0,233,33717,700,19,0,34436
DISTRICT ATTORNEY,Edward  MARSICO,Lower Paxton Twp--10th Precinct,133,4,0,0,137,33717,700,19,0,34436
DISTRICT ATTORNEY,Edward  MARSICO,Lower Paxton Twp--11th Precinct,214,3,1,0,218,33717,700,19,0,34436
DISTRICT ATTORNEY,Edward  MARSICO,Lower Paxton Twp--12th Precinct,340,8,1,0,349,33717,700,19,0,34436
DISTRICT ATTORNEY,Edward  MARSICO,Lower Paxton Twp--13th Precinct,298,6,0,0,304,33717,700,19,0,34436
DISTRICT ATTORNEY,Edward  MARSICO,Lower Paxton Twp--14th Precinct,173,3,3,0,179,33717,700,19,0,34436
DISTRICT ATTORNEY,Edward  MARSICO,Lower Paxton Twp--15th Precinct,279,5,0,0,284,33717,700,19,0,34436
DISTRICT ATTORNEY,Edward  MARSICO,Lower Paxton Twp--16th Precinct,472,11,0,0,483,33717,700,19,0,34436
DISTRICT ATTORNEY,Edward  MARSICO,Lower Paxton Twp--17th Precinct,209,7,0,0,216,33717,700,19,0,34436
DISTRICT ATTORNEY,Edward  MARSICO,Lower Paxton Twp--18th Precinct,207,2,0,0,209,33717,700,19,0,34436
DISTRICT ATTORNEY,Edward  MARSICO,Lower Paxton Twp--19th Precinct,385,17,0,0,402,33717,700,19,0,34436
DISTRICT ATTORNEY,Edward  MARSICO,Lower Paxton Twp--20th Precinct,292,5,0,0,297,33717,700,19,0,34436
DISTRICT ATTORNEY,Edward  MARSICO,Lower Paxton Twp--21st Precinct,371,9,0,0,380,33717,700,19,0,34436
DISTRICT ATTORNEY,Edward  MARSICO,Lower Paxton Twp--22nd Precinct,338,7,0,0,345,33717,700,19,0,34436
DISTRICT ATTORNEY,Edward  MARSICO,Lower Paxton Twp--23rd Precinct,288,5,0,0,293,33717,700,19,0,34436
DISTRICT ATTORNEY,Edward  MARSICO,Lower Paxton Twp--24th Precinct,290,6,0,0,296,33717,700,19,0,34436
DISTRICT ATTORNEY,Edward  MARSICO,Lower Paxton Twp--25th Precinct,178,4,0,0,182,33717,700,19,0,34436
DISTRICT ATTORNEY,Edward  MARSICO,Lower Paxton Twp--26th Precinct,291,7,0,0,298,33717,700,19,0,34436
DISTRICT ATTORNEY,Edward  MARSICO,Lower Paxton Twp--27th Precinct,244,2,0,0,246,33717,700,19,0,34436
DISTRICT ATTORNEY,Edward  MARSICO,Lower Swatara Twp--1st Precinct,374,4,0,0,378,33717,700,19,0,34436
DISTRICT ATTORNEY,Edward  MARSICO,Lower Swatara Twp--2nd Precinct,304,8,0,0,312,33717,700,19,0,34436
DISTRICT ATTORNEY,Edward  MARSICO,Lower Swatara Twp--3rd Precinct,263,29,0,0,292,33717,700,19,0,34436
DISTRICT ATTORNEY,Edward  MARSICO,Lower Swatara Twp--4th Precinct,267,1,0,0,268,33717,700,19,0,34436
DISTRICT ATTORNEY,Edward  MARSICO,Lykens Township,98,0,0,0,98,33717,700,19,0,34436
DISTRICT ATTORNEY,Edward  MARSICO,Middle Paxton Twp--1st Precinct,334,0,0,0,334,33717,700,19,0,34436
DISTRICT ATTORNEY,Edward  MARSICO,Middle Paxton Twp--2nd Precinct,277,2,0,0,279,33717,700,19,0,34436
DISTRICT ATTORNEY,Edward  MARSICO,Middle Paxton Twp--3rd Precinct,381,2,0,0,383,33717,700,19,0,34436
DISTRICT ATTORNEY,Edward  MARSICO,Mifflin Township,86,0,0,0,86,33717,700,19,0,34436
DISTRICT ATTORNEY,Edward  MARSICO,Reed Township,44,0,0,0,44,33717,700,19,0,34436
DISTRICT ATTORNEY,Edward  MARSICO,Rush Township,38,0,0,0,38,33717,700,19,0,34436
DISTRICT ATTORNEY,Edward  MARSICO,South Hanover Twp--1st Precinct,299,5,0,0,304,33717,700,19,0,34436
DISTRICT ATTORNEY,Edward  MARSICO,South Hanover Twp--2nd Precinct,392,8,0,0,400,33717,700,19,0,34436
DISTRICT ATTORNEY,Edward  MARSICO,South Hanover Twp--3rd Precinct,233,2,0,0,235,33717,700,19,0,34436
DISTRICT ATTORNEY,Edward  MARSICO,Susquehanna Twp--1st Ward,407,17,0,0,424,33717,700,19,0,34436
DISTRICT ATTORNEY,Edward  MARSICO,Susquehanna Twp--2nd Ward,625,25,0,0,650,33717,700,19,0,34436
DISTRICT ATTORNEY,Edward  MARSICO,Susquehanna Twp--3rd Ward,239,0,0,0,239,33717,700,19,0,34436
DISTRICT ATTORNEY,Edward  MARSICO,Susquehanna Twp--4th Ward,288,5,0,0,293,33717,700,19,0,34436
DISTRICT ATTORNEY,Edward  MARSICO,Susquehanna Twp--5th Ward,338,8,0,0,346,33717,700,19,0,34436
DISTRICT ATTORNEY,Edward  MARSICO,Susquehanna Twp--6th Ward,399,10,0,0,409,33717,700,19,0,34436
DISTRICT ATTORNEY,Edward  MARSICO,Susquehanna Twp--7th Ward,184,0,0,0,184,33717,700,19,0,34436
DISTRICT ATTORNEY,Edward  MARSICO,Susquehanna Twp--8th Ward,505,17,0,0,522,33717,700,19,0,34436
DISTRICT ATTORNEY,Edward  MARSICO,Susquehanna Twp--9th Ward,346,4,0,0,350,33717,700,19,0,34436
DISTRICT ATTORNEY,Edward  MARSICO,Swatara Township--1st Ward,323,2,0,0,325,33717,700,19,0,34436
DISTRICT ATTORNEY,Edward  MARSICO,Swatara Township--2nd Ward,186,12,0,0,198,33717,700,19,0,34436
DISTRICT ATTORNEY,Edward  MARSICO,Swatara Township--3rd Ward,227,7,0,0,234,33717,700,19,0,34436
DISTRICT ATTORNEY,Edward  MARSICO,Swatara Township--4th Ward,337,10,0,0,347,33717,700,19,0,34436
DISTRICT ATTORNEY,Edward  MARSICO,Swatara Township--5th Ward,468,5,0,0,473,33717,700,19,0,34436
DISTRICT ATTORNEY,Edward  MARSICO,Swatara Township--6th Ward,424,2,1,0,427,33717,700,19,0,34436
DISTRICT ATTORNEY,Edward  MARSICO,Swatara Township--7th Ward,417,10,0,0,427,33717,700,19,0,34436
DISTRICT ATTORNEY,Edward  MARSICO,Swatara Township--8th Ward,484,5,1,0,490,33717,700,19,0,34436
DISTRICT ATTORNEY,Edward  MARSICO,Swatara Township--9th Ward,190,9,0,0,199,33717,700,19,0,34436
DISTRICT ATTORNEY,Edward  MARSICO,Upper Paxton Twp--1st Precinct,288,3,0,0,291,33717,700,19,0,34436
DISTRICT ATTORNEY,Edward  MARSICO,Upper Paxton Twp--2nd Precinct,185,2,0,0,187,33717,700,19,0,34436
DISTRICT ATTORNEY,Edward  MARSICO,Washington Township,272,7,0,0,279,33717,700,19,0,34436
DISTRICT ATTORNEY,Edward  MARSICO,Wayne Township,255,0,1,0,256,33717,700,19,0,34436
DISTRICT ATTORNEY,Edward  MARSICO,West Hanover Twp--1st Precinct,337,5,1,0,343,33717,700,19,0,34436
DISTRICT ATTORNEY,Edward  MARSICO,West Hanover Twp--2nd Precinct,308,7,1,0,316,33717,700,19,0,34436
DISTRICT ATTORNEY,Edward  MARSICO,West Hanover Twp--3rd Precinct,713,18,1,0,732,33717,700,19,0,34436
DISTRICT ATTORNEY,Edward  MARSICO,West Hanover Twp--4th Precinct,405,1,0,0,406,33717,700,19,0,34436
DISTRICT ATTORNEY,Edward  MARSICO,Wiconisco Twp--1st Precinct,79,1,0,0,80,33717,700,19,0,34436
DISTRICT ATTORNEY,Edward  MARSICO,Wiconisco Twp--2nd Precinct,61,1,0,0,62,33717,700,19,0,34436
DISTRICT ATTORNEY,Edward  MARSICO,Williams Twp,146,1,0,0,147,33717,700,19,0,34436
DISTRICT ATTORNEY,Write In  ,"City--1st Ward, 1st Precinct",0,0,0,0,0,83,0,0,0,83
DISTRICT ATTORNEY,Write In  ,"City--1st Ward, 2nd Precinct",0,0,0,0,0,83,0,0,0,83
DISTRICT ATTORNEY,Write In  ,"City--1st Ward, 3rd Precinct",0,0,0,0,0,83,0,0,0,83
DISTRICT ATTORNEY,Write In  ,"City--2nd Ward, 1st Precinct",0,0,0,0,0,83,0,0,0,83
DISTRICT ATTORNEY,Write In  ,"City--2nd Ward, 2nd Precinct",0,0,0,0,0,83,0,0,0,83
DISTRICT ATTORNEY,Write In  ,City--3rd Ward,0,0,0,0,0,83,0,0,0,83
DISTRICT ATTORNEY,Write In  ,City--4th Ward,1,0,0,0,1,83,0,0,0,83
DISTRICT ATTORNEY,Write In  ,City--5th Ward,1,0,0,0,1,83,0,0,0,83
DISTRICT ATTORNEY,Write In  ,City--6th Ward,1,0,0,0,1,83,0,0,0,83
DISTRICT ATTORNEY,Write In  ,"City--7th Ward, 1st Precinct",0,0,0,0,0,83,0,0,0,83
DISTRICT ATTORNEY,Write In  ,"City--7th Ward, 2nd Precinct",0,0,0,0,0,83,0,0,0,83
DISTRICT ATTORNEY,Write In  ,City--8th Ward,1,0,0,0,1,83,0,0,0,83
DISTRICT ATTORNEY,Write In  ,"City--9th Ward, 1st Precinct",0,0,0,0,0,83,0,0,0,83
DISTRICT ATTORNEY,Write In  ,"City--9th Ward, 2nd Precinct",0,0,0,0,0,83,0,0,0,83
DISTRICT ATTORNEY,Write In  ,"City--9th Ward, 3rd Precinct",0,0,0,0,0,83,0,0,0,83
DISTRICT ATTORNEY,Write In  ,"City--9th Ward, 4th Precinct",0,0,0,0,0,83,0,0,0,83
DISTRICT ATTORNEY,Write In  ,"City--9th Ward, 5th Precinct",0,0,0,0,0,83,0,0,0,83
DISTRICT ATTORNEY,Write In  ,"City--10th Ward, 1st Precinct",0,0,0,0,0,83,0,0,0,83
DISTRICT ATTORNEY,Write In  ,"City--10th Ward, 2nd Precinct",0,0,0,0,0,83,0,0,0,83
DISTRICT ATTORNEY,Write In  ,"City--10th Ward, 3rd Precinct",1,0,0,0,1,83,0,0,0,83
DISTRICT ATTORNEY,Write In  ,"City--10th Ward, 4th Precinct",1,0,0,0,1,83,0,0,0,83
DISTRICT ATTORNEY,Write In  ,City--11th Ward,0,0,0,0,0,83,0,0,0,83
DISTRICT ATTORNEY,Write In  ,City--12th Ward,3,0,0,0,3,83,0,0,0,83
DISTRICT ATTORNEY,Write In  ,"City--13th Ward, 1st Precinct",1,0,0,0,1,83,0,0,0,83
DISTRICT ATTORNEY,Write In  ,"City--13th Ward, 2nd Precinct",1,0,0,0,1,83,0,0,0,83
DISTRICT ATTORNEY,Write In  ,"City--13th Ward, 3rd Precinct",0,0,0,0,0,83,0,0,0,83
DISTRICT ATTORNEY,Write In  ,City--14th Ward,0,0,0,0,0,83,0,0,0,83
DISTRICT ATTORNEY,Write In  ,City--15th Ward,0,0,0,0,0,83,0,0,0,83
DISTRICT ATTORNEY,Write In  ,Berrysburg Borough,0,0,0,0,0,83,0,0,0,83
DISTRICT ATTORNEY,Write In  ,Dauphin Borough,0,0,0,0,0,83,0,0,0,83
DISTRICT ATTORNEY,Write In  ,Elizabethville Borough,0,0,0,0,0,83,0,0,0,83
DISTRICT ATTORNEY,Write In  ,Gratz Borough,1,0,0,0,1,83,0,0,0,83
DISTRICT ATTORNEY,Write In  ,Halifax Borough,2,0,0,0,2,83,0,0,0,83
DISTRICT ATTORNEY,Write In  ,Highspire--1st Precinct,0,0,0,0,0,83,0,0,0,83
DISTRICT ATTORNEY,Write In  ,Highspire--2nd Precinct,0,0,0,0,0,83,0,0,0,83
DISTRICT ATTORNEY,Write In  ,Hummelstown--1st Precinct,0,0,0,0,0,83,0,0,0,83
DISTRICT ATTORNEY,Write In  ,Hummelstown--2nd Precinct,0,0,0,0,0,83,0,0,0,83
DISTRICT ATTORNEY,Write In  ,Lykens Borough--1st Ward,0,0,0,0,0,83,0,0,0,83
DISTRICT ATTORNEY,Write In  ,Lykens Borough--2nd Ward,1,0,0,0,1,83,0,0,0,83
DISTRICT ATTORNEY,Write In  ,"Middletown--1st Ward, 1st Precinct",1,0,0,0,1,83,0,0,0,83
DISTRICT ATTORNEY,Write In  ,"Middletown--1st Ward, 2nd Precinct",0,0,0,0,0,83,0,0,0,83
DISTRICT ATTORNEY,Write In  ,"Middletown--2nd Ward, 1st Precinct",0,0,0,0,0,83,0,0,0,83
DISTRICT ATTORNEY,Write In  ,"Middletown--2nd Ward, 2nd Precinct",0,0,0,0,0,83,0,0,0,83
DISTRICT ATTORNEY,Write In  ,"Middletown--3rd Ward, 1st Precinct",1,0,0,0,1,83,0,0,0,83
DISTRICT ATTORNEY,Write In  ,"Middletown--3rd Ward, 2nd Precinct",0,0,0,0,0,83,0,0,0,83
DISTRICT ATTORNEY,Write In  ,Millersburg--1st Ward,0,0,0,0,0,83,0,0,0,83
DISTRICT ATTORNEY,Write In  ,Millersburg--2nd Ward,0,0,0,0,0,83,0,0,0,83
DISTRICT ATTORNEY,Write In  ,Paxtang Borough,1,0,0,0,1,83,0,0,0,83
DISTRICT ATTORNEY,Write In  ,Penbrook Borough--1st Ward,2,0,0,0,2,83,0,0,0,83
DISTRICT ATTORNEY,Write In  ,Penbrook Borough--2nd Ward,0,0,0,0,0,83,0,0,0,83
DISTRICT ATTORNEY,Write In  ,Penbrook Borough--3rd Ward,2,0,0,0,2,83,0,0,0,83
DISTRICT ATTORNEY,Write In  ,Penbrook Borough--4th Ward,1,0,0,0,1,83,0,0,0,83
DISTRICT ATTORNEY,Write In  ,Royalton Borough--1st Ward,0,0,0,0,0,83,0,0,0,83
DISTRICT ATTORNEY,Write In  ,Royalton Borough--2nd Ward,1,0,0,0,1,83,0,0,0,83
DISTRICT ATTORNEY,Write In  ,Steelton--1st Ward,0,0,0,0,0,83,0,0,0,83
DISTRICT ATTORNEY,Write In  ,"Steelton--2nd Ward, 1st Precinct",1,0,0,0,1,83,0,0,0,83
DISTRICT ATTORNEY,Write In  ,"Steelton--2nd Ward, 2nd Precinct",0,0,0,0,0,83,0,0,0,83
DISTRICT ATTORNEY,Write In  ,"Steelton--3rd Ward, 1st Precinct",0,0,0,0,0,83,0,0,0,83
DISTRICT ATTORNEY,Write In  ,"Steelton--3rd Ward, 2nd Precinct",1,0,0,0,1,83,0,0,0,83
DISTRICT ATTORNEY,Write In  ,Steelton--4th Ward,0,0,0,0,0,83,0,0,0,83
DISTRICT ATTORNEY,Write In  ,Pillow Borough,0,0,0,0,0,83,0,0,0,83
DISTRICT ATTORNEY,Write In  ,Williamstown--1st Ward,0,0,0,0,0,83,0,0,0,83
DISTRICT ATTORNEY,Write In  ,Williamstown--2nd Ward,1,0,0,0,1,83,0,0,0,83
DISTRICT ATTORNEY,Write In  ,Conewago Twp--1st Precinct,0,0,0,0,0,83,0,0,0,83
DISTRICT ATTORNEY,Write In  ,Conewago Twp--2nd Precinct,1,0,0,0,1,83,0,0,0,83
DISTRICT ATTORNEY,Write In  ,Derry Township--1st Precinct,0,0,0,0,0,83,0,0,0,83
DISTRICT ATTORNEY,Write In  ,Derry Township--2nd Precinct,0,0,0,0,0,83,0,0,0,83
DISTRICT ATTORNEY,Write In  ,Derry Township--3rd Precinct,0,0,0,0,0,83,0,0,0,83
DISTRICT ATTORNEY,Write In  ,Derry Township--4th Precinct,1,0,0,0,1,83,0,0,0,83
DISTRICT ATTORNEY,Write In  ,Derry Township--5th Precinct,0,0,0,0,0,83,0,0,0,83
DISTRICT ATTORNEY,Write In  ,Derry Township--6th Precinct,0,0,0,0,0,83,0,0,0,83
DISTRICT ATTORNEY,Write In  ,Derry Township--7th Precinct,0,0,0,0,0,83,0,0,0,83
DISTRICT ATTORNEY,Write In  ,Derry Township--8th Precinct,1,0,0,0,1,83,0,0,0,83
DISTRICT ATTORNEY,Write In  ,Derry Township--9th Precinct,0,0,0,0,0,83,0,0,0,83
DISTRICT ATTORNEY,Write In  ,Derry Township--10th Precinct,0,0,0,0,0,83,0,0,0,83
DISTRICT ATTORNEY,Write In  ,Derry Township--11th Precinct,0,0,0,0,0,83,0,0,0,83
DISTRICT ATTORNEY,Write In  ,Derry Township--12th Precinct,0,0,0,0,0,83,0,0,0,83
DISTRICT ATTORNEY,Write In  ,Derry Township--13th Precinct,1,0,0,0,1,83,0,0,0,83
DISTRICT ATTORNEY,Write In  ,Derry Township--14th Precinct,0,0,0,0,0,83,0,0,0,83
DISTRICT ATTORNEY,Write In  ,Derry Township--15th Precinct,2,0,0,0,2,83,0,0,0,83
DISTRICT ATTORNEY,Write In  ,East Hanover Township--1st Precinct,0,0,0,0,0,83,0,0,0,83
DISTRICT ATTORNEY,Write In  ,East Hanover Township--2nd Precinct,0,0,0,0,0,83,0,0,0,83
DISTRICT ATTORNEY,Write In  ,Halifax Twp--1st Precinct,1,0,0,0,1,83,0,0,0,83
DISTRICT ATTORNEY,Write In  ,Halifax Twp--2nd Precinct,0,0,0,0,0,83,0,0,0,83
DISTRICT ATTORNEY,Write In  ,Jackson Township,0,0,0,0,0,83,0,0,0,83
DISTRICT ATTORNEY,Write In  ,Jefferson Township,0,0,0,0,0,83,0,0,0,83
DISTRICT ATTORNEY,Write In  ,Londonderry Twp--1st Precinct,1,0,0,0,1,83,0,0,0,83
DISTRICT ATTORNEY,Write In  ,Londonderry Twp--2nd Precinct,1,0,0,0,1,83,0,0,0,83
DISTRICT ATTORNEY,Write In  ,Londonderry Twp--3rd Precinct,0,0,0,0,0,83,0,0,0,83
DISTRICT ATTORNEY,Write In  ,Lower Paxton Twp--1st Precinct,0,0,0,0,0,83,0,0,0,83
DISTRICT ATTORNEY,Write In  ,Lower Paxton Twp--2nd Precinct,2,0,0,0,2,83,0,0,0,83
DISTRICT ATTORNEY,Write In  ,Lower Paxton Twp--3rd precinct,1,0,0,0,1,83,0,0,0,83
DISTRICT ATTORNEY,Write In  ,Lower Paxton Twp--4th Precinct,0,0,0,0,0,83,0,0,0,83
DISTRICT ATTORNEY,Write In  ,Lower Paxton Twp--5th Precinct,1,0,0,0,1,83,0,0,0,83
DISTRICT ATTORNEY,Write In  ,Lower Paxton Twp--6th Precinct,0,0,0,0,0,83,0,0,0,83
DISTRICT ATTORNEY,Write In  ,Lower Paxton Twp--7th Precinct,1,0,0,0,1,83,0,0,0,83
DISTRICT ATTORNEY,Write In  ,Lower Paxton Twp--8th Precinct,0,0,0,0,0,83,0,0,0,83
DISTRICT ATTORNEY,Write In  ,Lower Paxton Twp--9th Precinct,1,0,0,0,1,83,0,0,0,83
DISTRICT ATTORNEY,Write In  ,Lower Paxton Twp--10th Precinct,0,0,0,0,0,83,0,0,0,83
DISTRICT ATTORNEY,Write In  ,Lower Paxton Twp--11th Precinct,1,0,0,0,1,83,0,0,0,83
DISTRICT ATTORNEY,Write In  ,Lower Paxton Twp--12th Precinct,1,0,0,0,1,83,0,0,0,83
DISTRICT ATTORNEY,Write In  ,Lower Paxton Twp--13th Precinct,1,0,0,0,1,83,0,0,0,83
DISTRICT ATTORNEY,Write In  ,Lower Paxton Twp--14th Precinct,0,0,0,0,0,83,0,0,0,83
DISTRICT ATTORNEY,Write In  ,Lower Paxton Twp--15th Precinct,0,0,0,0,0,83,0,0,0,83
DISTRICT ATTORNEY,Write In  ,Lower Paxton Twp--16th Precinct,0,0,0,0,0,83,0,0,0,83
DISTRICT ATTORNEY,Write In  ,Lower Paxton Twp--17th Precinct,1,0,0,0,1,83,0,0,0,83
DISTRICT ATTORNEY,Write In  ,Lower Paxton Twp--18th Precinct,0,0,0,0,0,83,0,0,0,83
DISTRICT ATTORNEY,Write In  ,Lower Paxton Twp--19th Precinct,0,0,0,0,0,83,0,0,0,83
DISTRICT ATTORNEY,Write In  ,Lower Paxton Twp--20th Precinct,4,0,0,0,4,83,0,0,0,83
DISTRICT ATTORNEY,Write In  ,Lower Paxton Twp--21st Precinct,2,0,0,0,2,83,0,0,0,83
DISTRICT ATTORNEY,Write In  ,Lower Paxton Twp--22nd Precinct,1,0,0,0,1,83,0,0,0,83
DISTRICT ATTORNEY,Write In  ,Lower Paxton Twp--23rd Precinct,0,0,0,0,0,83,0,0,0,83
DISTRICT ATTORNEY,Write In  ,Lower Paxton Twp--24th Precinct,0,0,0,0,0,83,0,0,0,83
DISTRICT ATTORNEY,Write In  ,Lower Paxton Twp--25th Precinct,0,0,0,0,0,83,0,0,0,83
DISTRICT ATTORNEY,Write In  ,Lower Paxton Twp--26th Precinct,0,0,0,0,0,83,0,0,0,83
DISTRICT ATTORNEY,Write In  ,Lower Paxton Twp--27th Precinct,0,0,0,0,0,83,0,0,0,83
DISTRICT ATTORNEY,Write In  ,Lower Swatara Twp--1st Precinct,0,0,0,0,0,83,0,0,0,83
DISTRICT ATTORNEY,Write In  ,Lower Swatara Twp--2nd Precinct,1,0,0,0,1,83,0,0,0,83
DISTRICT ATTORNEY,Write In  ,Lower Swatara Twp--3rd Precinct,0,0,0,0,0,83,0,0,0,83
DISTRICT ATTORNEY,Write In  ,Lower Swatara Twp--4th Precinct,0,0,0,0,0,83,0,0,0,83
DISTRICT ATTORNEY,Write In  ,Lykens Township,0,0,0,0,0,83,0,0,0,83
DISTRICT ATTORNEY,Write In  ,Middle Paxton Twp--1st Precinct,0,0,0,0,0,83,0,0,0,83
DISTRICT ATTORNEY,Write In  ,Middle Paxton Twp--2nd Precinct,0,0,0,0,0,83,0,0,0,83
DISTRICT ATTORNEY,Write In  ,Middle Paxton Twp--3rd Precinct,0,0,0,0,0,83,0,0,0,83
DISTRICT ATTORNEY,Write In  ,Mifflin Township,0,0,0,0,0,83,0,0,0,83
DISTRICT ATTORNEY,Write In  ,Reed Township,0,0,0,0,0,83,0,0,0,83
DISTRICT ATTORNEY,Write In  ,Rush Township,0,0,0,0,0,83,0,0,0,83
DISTRICT ATTORNEY,Write In  ,South Hanover Twp--1st Precinct,1,0,0,0,1,83,0,0,0,83
DISTRICT ATTORNEY,Write In  ,South Hanover Twp--2nd Precinct,3,0,0,0,3,83,0,0,0,83
DISTRICT ATTORNEY,Write In  ,South Hanover Twp--3rd Precinct,0,0,0,0,0,83,0,0,0,83
DISTRICT ATTORNEY,Write In  ,Susquehanna Twp--1st Ward,2,0,0,0,2,83,0,0,0,83
DISTRICT ATTORNEY,Write In  ,Susquehanna Twp--2nd Ward,3,0,0,0,3,83,0,0,0,83
DISTRICT ATTORNEY,Write In  ,Susquehanna Twp--3rd Ward,2,0,0,0,2,83,0,0,0,83
DISTRICT ATTORNEY,Write In  ,Susquehanna Twp--4th Ward,3,0,0,0,3,83,0,0,0,83
DISTRICT ATTORNEY,Write In  ,Susquehanna Twp--5th Ward,1,0,0,0,1,83,0,0,0,83
DISTRICT ATTORNEY,Write In  ,Susquehanna Twp--6th Ward,0,0,0,0,0,83,0,0,0,83
DISTRICT ATTORNEY,Write In  ,Susquehanna Twp--7th Ward,0,0,0,0,0,83,0,0,0,83
DISTRICT ATTORNEY,Write In  ,Susquehanna Twp--8th Ward,1,0,0,0,1,83,0,0,0,83
DISTRICT ATTORNEY,Write In  ,Susquehanna Twp--9th Ward,1,0,0,0,1,83,0,0,0,83
DISTRICT ATTORNEY,Write In  ,Swatara Township--1st Ward,0,0,0,0,0,83,0,0,0,83
DISTRICT ATTORNEY,Write In  ,Swatara Township--2nd Ward,1,0,0,0,1,83,0,0,0,83
DISTRICT ATTORNEY,Write In  ,Swatara Township--3rd Ward,0,0,0,0,0,83,0,0,0,83
DISTRICT ATTORNEY,Write In  ,Swatara Township--4th Ward,0,0,0,0,0,83,0,0,0,83
DISTRICT ATTORNEY,Write In  ,Swatara Township--5th Ward,1,0,0,0,1,83,0,0,0,83
DISTRICT ATTORNEY,Write In  ,Swatara Township--6th Ward,3,0,0,0,3,83,0,0,0,83
DISTRICT ATTORNEY,Write In  ,Swatara Township--7th Ward,3,0,0,0,3,83,0,0,0,83
DISTRICT ATTORNEY,Write In  ,Swatara Township--8th Ward,0,0,0,0,0,83,0,0,0,83
DISTRICT ATTORNEY,Write In  ,Swatara Township--9th Ward,0,0,0,0,0,83,0,0,0,83
DISTRICT ATTORNEY,Write In  ,Upper Paxton Twp--1st Precinct,2,0,0,0,2,83,0,0,0,83
DISTRICT ATTORNEY,Write In  ,Upper Paxton Twp--2nd Precinct,0,0,0,0,0,83,0,0,0,83
DISTRICT ATTORNEY,Write In  ,Washington Township,0,0,0,0,0,83,0,0,0,83
DISTRICT ATTORNEY,Write In  ,Wayne Township,0,0,0,0,0,83,0,0,0,83
DISTRICT ATTORNEY,Write In  ,West Hanover Twp--1st Precinct,0,0,0,0,0,83,0,0,0,83
DISTRICT ATTORNEY,Write In  ,West Hanover Twp--2nd Precinct,0,0,0,0,0,83,0,0,0,83
DISTRICT ATTORNEY,Write In  ,West Hanover Twp--3rd Precinct,1,0,0,0,1,83,0,0,0,83
DISTRICT ATTORNEY,Write In  ,West Hanover Twp--4th Precinct,1,0,0,0,1,83,0,0,0,83
DISTRICT ATTORNEY,Write In  ,Wiconisco Twp--1st Precinct,0,0,0,0,0,83,0,0,0,83
DISTRICT ATTORNEY,Write In  ,Wiconisco Twp--2nd Precinct,0,0,0,0,0,83,0,0,0,83
DISTRICT ATTORNEY,Write In  ,Williams Twp,0,0,0,0,0,83,0,0,0,83
JUDGE/SUPERIOR COURT,Bruce F. BRATTON,"City--1st Ward, 1st Precinct",41,3,0,0,44,23277,499,11,0,23787
JUDGE/SUPERIOR COURT,Bruce F. BRATTON,"City--1st Ward, 2nd Precinct",85,1,0,0,86,23277,499,11,0,23787
JUDGE/SUPERIOR COURT,Bruce F. BRATTON,"City--1st Ward, 3rd Precinct",16,0,0,0,16,23277,499,11,0,23787
JUDGE/SUPERIOR COURT,Bruce F. BRATTON,"City--2nd Ward, 1st Precinct",21,0,0,0,21,23277,499,11,0,23787
JUDGE/SUPERIOR COURT,Bruce F. BRATTON,"City--2nd Ward, 2nd Precinct",22,1,0,0,23,23277,499,11,0,23787
JUDGE/SUPERIOR COURT,Bruce F. BRATTON,City--3rd Ward,44,0,0,0,44,23277,499,11,0,23787
JUDGE/SUPERIOR COURT,Bruce F. BRATTON,City--4th Ward,67,2,0,0,69,23277,499,11,0,23787
JUDGE/SUPERIOR COURT,Bruce F. BRATTON,City--5th Ward,107,5,0,0,112,23277,499,11,0,23787
JUDGE/SUPERIOR COURT,Bruce F. BRATTON,City--6th Ward,63,1,0,0,64,23277,499,11,0,23787
JUDGE/SUPERIOR COURT,Bruce F. BRATTON,"City--7th Ward, 1st Precinct",21,0,0,0,21,23277,499,11,0,23787
JUDGE/SUPERIOR COURT,Bruce F. BRATTON,"City--7th Ward, 2nd Precinct",18,2,0,0,20,23277,499,11,0,23787
JUDGE/SUPERIOR COURT,Bruce F. BRATTON,City--8th Ward,20,0,0,0,20,23277,499,11,0,23787
JUDGE/SUPERIOR COURT,Bruce F. BRATTON,"City--9th Ward, 1st Precinct",21,0,0,0,21,23277,499,11,0,23787
JUDGE/SUPERIOR COURT,Bruce F. BRATTON,"City--9th Ward, 2nd Precinct",15,0,0,0,15,23277,499,11,0,23787
JUDGE/SUPERIOR COURT,Bruce F. BRATTON,"City--9th Ward, 3rd Precinct",34,1,0,0,35,23277,499,11,0,23787
JUDGE/SUPERIOR COURT,Bruce F. BRATTON,"City--9th Ward, 4th Precinct",104,3,0,0,107,23277,499,11,0,23787
JUDGE/SUPERIOR COURT,Bruce F. BRATTON,"City--9th Ward, 5th Precinct",64,3,0,0,67,23277,499,11,0,23787
JUDGE/SUPERIOR COURT,Bruce F. BRATTON,"City--10th Ward, 1st Precinct",61,4,0,0,65,23277,499,11,0,23787
JUDGE/SUPERIOR COURT,Bruce F. BRATTON,"City--10th Ward, 2nd Precinct",17,0,0,0,17,23277,499,11,0,23787
JUDGE/SUPERIOR COURT,Bruce F. BRATTON,"City--10th Ward, 3rd Precinct",68,1,0,0,69,23277,499,11,0,23787
JUDGE/SUPERIOR COURT,Bruce F. BRATTON,"City--10th Ward, 4th Precinct",30,0,0,0,30,23277,499,11,0,23787
JUDGE/SUPERIOR COURT,Bruce F. BRATTON,City--11th Ward,30,25,0,0,55,23277,499,11,0,23787
JUDGE/SUPERIOR COURT,Bruce F. BRATTON,City--12th Ward,70,3,0,0,73,23277,499,11,0,23787
JUDGE/SUPERIOR COURT,Bruce F. BRATTON,"City--13th Ward, 1st Precinct",51,0,0,0,51,23277,499,11,0,23787
JUDGE/SUPERIOR COURT,Bruce F. BRATTON,"City--13th Ward, 2nd Precinct",79,3,0,0,82,23277,499,11,0,23787
JUDGE/SUPERIOR COURT,Bruce F. BRATTON,"City--13th Ward, 3rd Precinct",88,1,0,0,89,23277,499,11,0,23787
JUDGE/SUPERIOR COURT,Bruce F. BRATTON,City--14th Ward,163,0,0,0,163,23277,499,11,0,23787
JUDGE/SUPERIOR COURT,Bruce F. BRATTON,City--15th Ward,20,0,0,0,20,23277,499,11,0,23787
JUDGE/SUPERIOR COURT,Bruce F. BRATTON,Berrysburg Borough,37,0,0,0,37,23277,499,11,0,23787
JUDGE/SUPERIOR COURT,Bruce F. BRATTON,Dauphin Borough,103,0,0,0,103,23277,499,11,0,23787
JUDGE/SUPERIOR COURT,Bruce F. BRATTON,Elizabethville Borough,125,1,0,0,126,23277,499,11,0,23787
JUDGE/SUPERIOR COURT,Bruce F. BRATTON,Gratz Borough,60,2,0,0,62,23277,499,11,0,23787
JUDGE/SUPERIOR COURT,Bruce F. BRATTON,Halifax Borough,62,3,0,0,65,23277,499,11,0,23787
JUDGE/SUPERIOR COURT,Bruce F. BRATTON,Highspire--1st Precinct,89,2,0,0,91,23277,499,11,0,23787
JUDGE/SUPERIOR COURT,Bruce F. BRATTON,Highspire--2nd Precinct,92,0,0,0,92,23277,499,11,0,23787
JUDGE/SUPERIOR COURT,Bruce F. BRATTON,Hummelstown--1st Precinct,131,3,0,0,134,23277,499,11,0,23787
JUDGE/SUPERIOR COURT,Bruce F. BRATTON,Hummelstown--2nd Precinct,311,4,0,0,315,23277,499,11,0,23787
JUDGE/SUPERIOR COURT,Bruce F. BRATTON,Lykens Borough--1st Ward,65,1,0,0,66,23277,499,11,0,23787
JUDGE/SUPERIOR COURT,Bruce F. BRATTON,Lykens Borough--2nd Ward,85,3,0,0,88,23277,499,11,0,23787
JUDGE/SUPERIOR COURT,Bruce F. BRATTON,"Middletown--1st Ward, 1st Precinct",64,0,0,0,64,23277,499,11,0,23787
JUDGE/SUPERIOR COURT,Bruce F. BRATTON,"Middletown--1st Ward, 2nd Precinct",117,6,1,0,124,23277,499,11,0,23787
JUDGE/SUPERIOR COURT,Bruce F. BRATTON,"Middletown--2nd Ward, 1st Precinct",108,2,0,0,110,23277,499,11,0,23787
JUDGE/SUPERIOR COURT,Bruce F. BRATTON,"Middletown--2nd Ward, 2nd Precinct",109,5,0,0,114,23277,499,11,0,23787
JUDGE/SUPERIOR COURT,Bruce F. BRATTON,"Middletown--3rd Ward, 1st Precinct",94,1,0,0,95,23277,499,11,0,23787
JUDGE/SUPERIOR COURT,Bruce F. BRATTON,"Middletown--3rd Ward, 2nd Precinct",147,0,0,0,147,23277,499,11,0,23787
JUDGE/SUPERIOR COURT,Bruce F. BRATTON,Millersburg--1st Ward,101,3,0,0,104,23277,499,11,0,23787
JUDGE/SUPERIOR COURT,Bruce F. BRATTON,Millersburg--2nd Ward,142,4,0,0,146,23277,499,11,0,23787
JUDGE/SUPERIOR COURT,Bruce F. BRATTON,Paxtang Borough,170,1,0,0,171,23277,499,11,0,23787
JUDGE/SUPERIOR COURT,Bruce F. BRATTON,Penbrook Borough--1st Ward,35,1,0,0,36,23277,499,11,0,23787
JUDGE/SUPERIOR COURT,Bruce F. BRATTON,Penbrook Borough--2nd Ward,48,1,0,0,49,23277,499,11,0,23787
JUDGE/SUPERIOR COURT,Bruce F. BRATTON,Penbrook Borough--3rd Ward,56,0,0,0,56,23277,499,11,0,23787
JUDGE/SUPERIOR COURT,Bruce F. BRATTON,Penbrook Borough--4th Ward,57,1,0,0,58,23277,499,11,0,23787
JUDGE/SUPERIOR COURT,Bruce F. BRATTON,Royalton Borough--1st Ward,20,0,0,0,20,23277,499,11,0,23787
JUDGE/SUPERIOR COURT,Bruce F. BRATTON,Royalton Borough--2nd Ward,55,0,0,0,55,23277,499,11,0,23787
JUDGE/SUPERIOR COURT,Bruce F. BRATTON,Steelton--1st Ward,88,3,0,0,91,23277,499,11,0,23787
JUDGE/SUPERIOR COURT,Bruce F. BRATTON,"Steelton--2nd Ward, 1st Precinct",40,2,0,0,42,23277,499,11,0,23787
JUDGE/SUPERIOR COURT,Bruce F. BRATTON,"Steelton--2nd Ward, 2nd Precinct",46,0,0,0,46,23277,499,11,0,23787
JUDGE/SUPERIOR COURT,Bruce F. BRATTON,"Steelton--3rd Ward, 1st Precinct",20,0,0,0,20,23277,499,11,0,23787
JUDGE/SUPERIOR COURT,Bruce F. BRATTON,"Steelton--3rd Ward, 2nd Precinct",45,0,0,0,45,23277,499,11,0,23787
JUDGE/SUPERIOR COURT,Bruce F. BRATTON,Steelton--4th Ward,47,0,0,0,47,23277,499,11,0,23787
JUDGE/SUPERIOR COURT,Bruce F. BRATTON,Pillow Borough,36,0,0,0,36,23277,499,11,0,23787
JUDGE/SUPERIOR COURT,Bruce F. BRATTON,Williamstown--1st Ward,60,0,0,0,60,23277,499,11,0,23787
JUDGE/SUPERIOR COURT,Bruce F. BRATTON,Williamstown--2nd Ward,39,0,0,0,39,23277,499,11,0,23787
JUDGE/SUPERIOR COURT,Bruce F. BRATTON,Conewago Twp--1st Precinct,227,1,0,0,228,23277,499,11,0,23787
JUDGE/SUPERIOR COURT,Bruce F. BRATTON,Conewago Twp--2nd Precinct,173,7,0,0,180,23277,499,11,0,23787
JUDGE/SUPERIOR COURT,Bruce F. BRATTON,Derry Township--1st Precinct,242,3,0,0,245,23277,499,11,0,23787
JUDGE/SUPERIOR COURT,Bruce F. BRATTON,Derry Township--2nd Precinct,194,4,0,0,198,23277,499,11,0,23787
JUDGE/SUPERIOR COURT,Bruce F. BRATTON,Derry Township--3rd Precinct,129,2,0,0,131,23277,499,11,0,23787
JUDGE/SUPERIOR COURT,Bruce F. BRATTON,Derry Township--4th Precinct,107,4,0,0,111,23277,499,11,0,23787
JUDGE/SUPERIOR COURT,Bruce F. BRATTON,Derry Township--5th Precinct,106,3,0,0,109,23277,499,11,0,23787
JUDGE/SUPERIOR COURT,Bruce F. BRATTON,Derry Township--6th Precinct,120,0,1,0,121,23277,499,11,0,23787
JUDGE/SUPERIOR COURT,Bruce F. BRATTON,Derry Township--7th Precinct,291,12,0,0,303,23277,499,11,0,23787
JUDGE/SUPERIOR COURT,Bruce F. BRATTON,Derry Township--8th Precinct,136,0,0,0,136,23277,499,11,0,23787
JUDGE/SUPERIOR COURT,Bruce F. BRATTON,Derry Township--9th Precinct,83,3,0,0,86,23277,499,11,0,23787
JUDGE/SUPERIOR COURT,Bruce F. BRATTON,Derry Township--10th Precinct,202,1,0,0,203,23277,499,11,0,23787
JUDGE/SUPERIOR COURT,Bruce F. BRATTON,Derry Township--11th Precinct,226,7,0,0,233,23277,499,11,0,23787
JUDGE/SUPERIOR COURT,Bruce F. BRATTON,Derry Township--12th Precinct,135,2,0,0,137,23277,499,11,0,23787
JUDGE/SUPERIOR COURT,Bruce F. BRATTON,Derry Township--13th Precinct,193,5,0,0,198,23277,499,11,0,23787
JUDGE/SUPERIOR COURT,Bruce F. BRATTON,Derry Township--14th Precinct,107,5,0,0,112,23277,499,11,0,23787
JUDGE/SUPERIOR COURT,Bruce F. BRATTON,Derry Township--15th Precinct,249,5,1,0,255,23277,499,11,0,23787
JUDGE/SUPERIOR COURT,Bruce F. BRATTON,East Hanover Township--1st Precinct,265,8,0,0,273,23277,499,11,0,23787
JUDGE/SUPERIOR COURT,Bruce F. BRATTON,East Hanover Township--2nd Precinct,301,4,0,0,305,23277,499,11,0,23787
JUDGE/SUPERIOR COURT,Bruce F. BRATTON,Halifax Twp--1st Precinct,198,2,0,0,200,23277,499,11,0,23787
JUDGE/SUPERIOR COURT,Bruce F. BRATTON,Halifax Twp--2nd Precinct,248,8,0,0,256,23277,499,11,0,23787
JUDGE/SUPERIOR COURT,Bruce F. BRATTON,Jackson Township,172,1,0,0,173,23277,499,11,0,23787
JUDGE/SUPERIOR COURT,Bruce F. BRATTON,Jefferson Township,56,0,0,0,56,23277,499,11,0,23787
JUDGE/SUPERIOR COURT,Bruce F. BRATTON,Londonderry Twp--1st Precinct,238,0,0,0,238,23277,499,11,0,23787
JUDGE/SUPERIOR COURT,Bruce F. BRATTON,Londonderry Twp--2nd Precinct,206,4,0,0,210,23277,499,11,0,23787
JUDGE/SUPERIOR COURT,Bruce F. BRATTON,Londonderry Twp--3rd Precinct,99,1,0,0,100,23277,499,11,0,23787
JUDGE/SUPERIOR COURT,Bruce F. BRATTON,Lower Paxton Twp--1st Precinct,166,2,0,0,168,23277,499,11,0,23787
JUDGE/SUPERIOR COURT,Bruce F. BRATTON,Lower Paxton Twp--2nd Precinct,164,5,0,0,169,23277,499,11,0,23787
JUDGE/SUPERIOR COURT,Bruce F. BRATTON,Lower Paxton Twp--3rd precinct,302,8,0,0,310,23277,499,11,0,23787
JUDGE/SUPERIOR COURT,Bruce F. BRATTON,Lower Paxton Twp--4th Precinct,227,3,0,0,230,23277,499,11,0,23787
JUDGE/SUPERIOR COURT,Bruce F. BRATTON,Lower Paxton Twp--5th Precinct,176,3,0,0,179,23277,499,11,0,23787
JUDGE/SUPERIOR COURT,Bruce F. BRATTON,Lower Paxton Twp--6th Precinct,132,2,0,0,134,23277,499,11,0,23787
JUDGE/SUPERIOR COURT,Bruce F. BRATTON,Lower Paxton Twp--7th Precinct,290,5,0,0,295,23277,499,11,0,23787
JUDGE/SUPERIOR COURT,Bruce F. BRATTON,Lower Paxton Twp--8th Precinct,108,2,0,0,110,23277,499,11,0,23787
JUDGE/SUPERIOR COURT,Bruce F. BRATTON,Lower Paxton Twp--9th Precinct,168,4,0,0,172,23277,499,11,0,23787
JUDGE/SUPERIOR COURT,Bruce F. BRATTON,Lower Paxton Twp--10th Precinct,89,1,0,0,90,23277,499,11,0,23787
JUDGE/SUPERIOR COURT,Bruce F. BRATTON,Lower Paxton Twp--11th Precinct,152,1,1,0,154,23277,499,11,0,23787
JUDGE/SUPERIOR COURT,Bruce F. BRATTON,Lower Paxton Twp--12th Precinct,242,7,1,0,250,23277,499,11,0,23787
JUDGE/SUPERIOR COURT,Bruce F. BRATTON,Lower Paxton Twp--13th Precinct,211,1,0,0,212,23277,499,11,0,23787
JUDGE/SUPERIOR COURT,Bruce F. BRATTON,Lower Paxton Twp--14th Precinct,109,4,3,0,116,23277,499,11,0,23787
JUDGE/SUPERIOR COURT,Bruce F. BRATTON,Lower Paxton Twp--15th Precinct,197,5,0,0,202,23277,499,11,0,23787
JUDGE/SUPERIOR COURT,Bruce F. BRATTON,Lower Paxton Twp--16th Precinct,316,10,0,0,326,23277,499,11,0,23787
JUDGE/SUPERIOR COURT,Bruce F. BRATTON,Lower Paxton Twp--17th Precinct,136,3,0,0,139,23277,499,11,0,23787
JUDGE/SUPERIOR COURT,Bruce F. BRATTON,Lower Paxton Twp--18th Precinct,136,2,0,0,138,23277,499,11,0,23787
JUDGE/SUPERIOR COURT,Bruce F. BRATTON,Lower Paxton Twp--19th Precinct,280,14,0,0,294,23277,499,11,0,23787
JUDGE/SUPERIOR COURT,Bruce F. BRATTON,Lower Paxton Twp--20th Precinct,208,5,0,0,213,23277,499,11,0,23787
JUDGE/SUPERIOR COURT,Bruce F. BRATTON,Lower Paxton Twp--21st Precinct,267,6,0,0,273,23277,499,11,0,23787
JUDGE/SUPERIOR COURT,Bruce F. BRATTON,Lower Paxton Twp--22nd Precinct,225,4,0,0,229,23277,499,11,0,23787
JUDGE/SUPERIOR COURT,Bruce F. BRATTON,Lower Paxton Twp--23rd Precinct,209,5,0,0,214,23277,499,11,0,23787
JUDGE/SUPERIOR COURT,Bruce F. BRATTON,Lower Paxton Twp--24th Precinct,196,6,0,0,202,23277,499,11,0,23787
JUDGE/SUPERIOR COURT,Bruce F. BRATTON,Lower Paxton Twp--25th Precinct,132,3,0,0,135,23277,499,11,0,23787
JUDGE/SUPERIOR COURT,Bruce F. BRATTON,Lower Paxton Twp--26th Precinct,197,4,0,0,201,23277,499,11,0,23787
JUDGE/SUPERIOR COURT,Bruce F. BRATTON,Lower Paxton Twp--27th Precinct,170,1,0,0,171,23277,499,11,0,23787
JUDGE/SUPERIOR COURT,Bruce F. BRATTON,Lower Swatara Twp--1st Precinct,288,3,0,0,291,23277,499,11,0,23787
JUDGE/SUPERIOR COURT,Bruce F. BRATTON,Lower Swatara Twp--2nd Precinct,223,3,0,0,226,23277,499,11,0,23787
JUDGE/SUPERIOR COURT,Bruce F. BRATTON,Lower Swatara Twp--3rd Precinct,199,20,0,0,219,23277,499,11,0,23787
JUDGE/SUPERIOR COURT,Bruce F. BRATTON,Lower Swatara Twp--4th Precinct,197,1,0,0,198,23277,499,11,0,23787
JUDGE/SUPERIOR COURT,Bruce F. BRATTON,Lykens Township,76,0,0,0,76,23277,499,11,0,23787
JUDGE/SUPERIOR COURT,Bruce F. BRATTON,Middle Paxton Twp--1st Precinct,251,0,0,0,251,23277,499,11,0,23787
JUDGE/SUPERIOR COURT,Bruce F. BRATTON,Middle Paxton Twp--2nd Precinct,199,1,0,0,200,23277,499,11,0,23787
JUDGE/SUPERIOR COURT,Bruce F. BRATTON,Middle Paxton Twp--3rd Precinct,283,2,0,0,285,23277,499,11,0,23787
JUDGE/SUPERIOR COURT,Bruce F. BRATTON,Mifflin Township,66,0,0,0,66,23277,499,11,0,23787
JUDGE/SUPERIOR COURT,Bruce F. BRATTON,Reed Township,29,0,0,0,29,23277,499,11,0,23787
JUDGE/SUPERIOR COURT,Bruce F. BRATTON,Rush Township,31,0,0,0,31,23277,499,11,0,23787
JUDGE/SUPERIOR COURT,Bruce F. BRATTON,South Hanover Twp--1st Precinct,236,3,0,0,239,23277,499,11,0,23787
JUDGE/SUPERIOR COURT,Bruce F. BRATTON,South Hanover Twp--2nd Precinct,273,5,0,0,278,23277,499,11,0,23787
JUDGE/SUPERIOR COURT,Bruce F. BRATTON,South Hanover Twp--3rd Precinct,172,1,0,0,173,23277,499,11,0,23787
JUDGE/SUPERIOR COURT,Bruce F. BRATTON,Susquehanna Twp--1st Ward,259,10,0,0,269,23277,499,11,0,23787
JUDGE/SUPERIOR COURT,Bruce F. BRATTON,Susquehanna Twp--2nd Ward,477,19,0,0,496,23277,499,11,0,23787
JUDGE/SUPERIOR COURT,Bruce F. BRATTON,Susquehanna Twp--3rd Ward,138,0,0,0,138,23277,499,11,0,23787
JUDGE/SUPERIOR COURT,Bruce F. BRATTON,Susquehanna Twp--4th Ward,191,5,0,0,196,23277,499,11,0,23787
JUDGE/SUPERIOR COURT,Bruce F. BRATTON,Susquehanna Twp--5th Ward,221,6,0,0,227,23277,499,11,0,23787
JUDGE/SUPERIOR COURT,Bruce F. BRATTON,Susquehanna Twp--6th Ward,270,5,0,0,275,23277,499,11,0,23787
JUDGE/SUPERIOR COURT,Bruce F. BRATTON,Susquehanna Twp--7th Ward,130,0,0,0,130,23277,499,11,0,23787
JUDGE/SUPERIOR COURT,Bruce F. BRATTON,Susquehanna Twp--8th Ward,357,12,0,0,369,23277,499,11,0,23787
JUDGE/SUPERIOR COURT,Bruce F. BRATTON,Susquehanna Twp--9th Ward,215,3,0,0,218,23277,499,11,0,23787
JUDGE/SUPERIOR COURT,Bruce F. BRATTON,Swatara Township--1st Ward,194,3,0,0,197,23277,499,11,0,23787
JUDGE/SUPERIOR COURT,Bruce F. BRATTON,Swatara Township--2nd Ward,105,10,0,0,115,23277,499,11,0,23787
JUDGE/SUPERIOR COURT,Bruce F. BRATTON,Swatara Township--3rd Ward,135,4,0,0,139,23277,499,11,0,23787
JUDGE/SUPERIOR COURT,Bruce F. BRATTON,Swatara Township--4th Ward,232,7,0,0,239,23277,499,11,0,23787
JUDGE/SUPERIOR COURT,Bruce F. BRATTON,Swatara Township--5th Ward,331,2,0,0,333,23277,499,11,0,23787
JUDGE/SUPERIOR COURT,Bruce F. BRATTON,Swatara Township--6th Ward,278,2,1,0,281,23277,499,11,0,23787
JUDGE/SUPERIOR COURT,Bruce F. BRATTON,Swatara Township--7th Ward,264,9,0,0,273,23277,499,11,0,23787
JUDGE/SUPERIOR COURT,Bruce F. BRATTON,Swatara Township--8th Ward,361,4,0,0,365,23277,499,11,0,23787
JUDGE/SUPERIOR COURT,Bruce F. BRATTON,Swatara Township--9th Ward,127,6,0,0,133,23277,499,11,0,23787
JUDGE/SUPERIOR COURT,Bruce F. BRATTON,Upper Paxton Twp--1st Precinct,237,1,0,0,238,23277,499,11,0,23787
JUDGE/SUPERIOR COURT,Bruce F. BRATTON,Upper Paxton Twp--2nd Precinct,150,2,0,0,152,23277,499,11,0,23787
JUDGE/SUPERIOR COURT,Bruce F. BRATTON,Washington Township,209,6,0,0,215,23277,499,11,0,23787
JUDGE/SUPERIOR COURT,Bruce F. BRATTON,Wayne Township,187,0,0,0,187,23277,499,11,0,23787
JUDGE/SUPERIOR COURT,Bruce F. BRATTON,West Hanover Twp--1st Precinct,233,3,0,0,236,23277,499,11,0,23787
JUDGE/SUPERIOR COURT,Bruce F. BRATTON,West Hanover Twp--2nd Precinct,223,7,1,0,231,23277,499,11,0,23787
JUDGE/SUPERIOR COURT,Bruce F. BRATTON,West Hanover Twp--3rd Precinct,488,13,1,0,502,23277,499,11,0,23787
JUDGE/SUPERIOR COURT,Bruce F. BRATTON,West Hanover Twp--4th Precinct,293,2,0,0,295,23277,499,11,0,23787
JUDGE/SUPERIOR COURT,Bruce F. BRATTON,Wiconisco Twp--1st Precinct,53,1,0,0,54,23277,499,11,0,23787
JUDGE/SUPERIOR COURT,Bruce F. BRATTON,Wiconisco Twp--2nd Precinct,40,1,0,0,41,23277,499,11,0,23787
JUDGE/SUPERIOR COURT,Bruce F. BRATTON,Williams Twp,104,1,0,0,105,23277,499,11,0,23787
JUDGE/SUPERIOR COURT,Cheryl Lynn ALLEN,"City--1st Ward, 1st Precinct",26,3,0,0,29,21088,470,10,0,21568
JUDGE/SUPERIOR COURT,Cheryl Lynn ALLEN,"City--1st Ward, 2nd Precinct",57,1,0,0,58,21088,470,10,0,21568
JUDGE/SUPERIOR COURT,Cheryl Lynn ALLEN,"City--1st Ward, 3rd Precinct",17,0,0,0,17,21088,470,10,0,21568
JUDGE/SUPERIOR COURT,Cheryl Lynn ALLEN,"City--2nd Ward, 1st Precinct",20,0,0,0,20,21088,470,10,0,21568
JUDGE/SUPERIOR COURT,Cheryl Lynn ALLEN,"City--2nd Ward, 2nd Precinct",26,1,0,0,27,21088,470,10,0,21568
JUDGE/SUPERIOR COURT,Cheryl Lynn ALLEN,City--3rd Ward,41,1,0,0,42,21088,470,10,0,21568
JUDGE/SUPERIOR COURT,Cheryl Lynn ALLEN,City--4th Ward,48,1,0,0,49,21088,470,10,0,21568
JUDGE/SUPERIOR COURT,Cheryl Lynn ALLEN,City--5th Ward,84,6,0,0,90,21088,470,10,0,21568
JUDGE/SUPERIOR COURT,Cheryl Lynn ALLEN,City--6th Ward,53,0,0,0,53,21088,470,10,0,21568
JUDGE/SUPERIOR COURT,Cheryl Lynn ALLEN,"City--7th Ward, 1st Precinct",23,1,0,0,24,21088,470,10,0,21568
JUDGE/SUPERIOR COURT,Cheryl Lynn ALLEN,"City--7th Ward, 2nd Precinct",27,1,0,0,28,21088,470,10,0,21568
JUDGE/SUPERIOR COURT,Cheryl Lynn ALLEN,City--8th Ward,31,0,0,0,31,21088,470,10,0,21568
JUDGE/SUPERIOR COURT,Cheryl Lynn ALLEN,"City--9th Ward, 1st Precinct",25,1,0,0,26,21088,470,10,0,21568
JUDGE/SUPERIOR COURT,Cheryl Lynn ALLEN,"City--9th Ward, 2nd Precinct",17,1,0,0,18,21088,470,10,0,21568
JUDGE/SUPERIOR COURT,Cheryl Lynn ALLEN,"City--9th Ward, 3rd Precinct",45,0,0,0,45,21088,470,10,0,21568
JUDGE/SUPERIOR COURT,Cheryl Lynn ALLEN,"City--9th Ward, 4th Precinct",72,3,0,0,75,21088,470,10,0,21568
JUDGE/SUPERIOR COURT,Cheryl Lynn ALLEN,"City--9th Ward, 5th Precinct",47,0,0,0,47,21088,470,10,0,21568
JUDGE/SUPERIOR COURT,Cheryl Lynn ALLEN,"City--10th Ward, 1st Precinct",60,3,0,0,63,21088,470,10,0,21568
JUDGE/SUPERIOR COURT,Cheryl Lynn ALLEN,"City--10th Ward, 2nd Precinct",18,0,0,0,18,21088,470,10,0,21568
JUDGE/SUPERIOR COURT,Cheryl Lynn ALLEN,"City--10th Ward, 3rd Precinct",44,1,0,0,45,21088,470,10,0,21568
JUDGE/SUPERIOR COURT,Cheryl Lynn ALLEN,"City--10th Ward, 4th Precinct",42,0,0,0,42,21088,470,10,0,21568
JUDGE/SUPERIOR COURT,Cheryl Lynn ALLEN,City--11th Ward,34,25,0,0,59,21088,470,10,0,21568
JUDGE/SUPERIOR COURT,Cheryl Lynn ALLEN,City--12th Ward,67,6,0,0,73,21088,470,10,0,21568
JUDGE/SUPERIOR COURT,Cheryl Lynn ALLEN,"City--13th Ward, 1st Precinct",51,0,0,0,51,21088,470,10,0,21568
JUDGE/SUPERIOR COURT,Cheryl Lynn ALLEN,"City--13th Ward, 2nd Precinct",80,3,0,0,83,21088,470,10,0,21568
JUDGE/SUPERIOR COURT,Cheryl Lynn ALLEN,"City--13th Ward, 3rd Precinct",77,1,0,0,78,21088,470,10,0,21568
JUDGE/SUPERIOR COURT,Cheryl Lynn ALLEN,City--14th Ward,124,0,0,0,124,21088,470,10,0,21568
JUDGE/SUPERIOR COURT,Cheryl Lynn ALLEN,City--15th Ward,21,0,0,0,21,21088,470,10,0,21568
JUDGE/SUPERIOR COURT,Cheryl Lynn ALLEN,Berrysburg Borough,39,0,0,0,39,21088,470,10,0,21568
JUDGE/SUPERIOR COURT,Cheryl Lynn ALLEN,Dauphin Borough,100,1,0,0,101,21088,470,10,0,21568
JUDGE/SUPERIOR COURT,Cheryl Lynn ALLEN,Elizabethville Borough,111,1,0,0,112,21088,470,10,0,21568
JUDGE/SUPERIOR COURT,Cheryl Lynn ALLEN,Gratz Borough,64,2,0,0,66,21088,470,10,0,21568
JUDGE/SUPERIOR COURT,Cheryl Lynn ALLEN,Halifax Borough,56,3,0,0,59,21088,470,10,0,21568
JUDGE/SUPERIOR COURT,Cheryl Lynn ALLEN,Highspire--1st Precinct,73,0,0,0,73,21088,470,10,0,21568
JUDGE/SUPERIOR COURT,Cheryl Lynn ALLEN,Highspire--2nd Precinct,85,1,0,0,86,21088,470,10,0,21568
JUDGE/SUPERIOR COURT,Cheryl Lynn ALLEN,Hummelstown--1st Precinct,94,4,0,0,98,21088,470,10,0,21568
JUDGE/SUPERIOR COURT,Cheryl Lynn ALLEN,Hummelstown--2nd Precinct,182,5,0,0,187,21088,470,10,0,21568
JUDGE/SUPERIOR COURT,Cheryl Lynn ALLEN,Lykens Borough--1st Ward,51,0,0,0,51,21088,470,10,0,21568
JUDGE/SUPERIOR COURT,Cheryl Lynn ALLEN,Lykens Borough--2nd Ward,75,1,0,0,76,21088,470,10,0,21568
JUDGE/SUPERIOR COURT,Cheryl Lynn ALLEN,"Middletown--1st Ward, 1st Precinct",60,0,0,0,60,21088,470,10,0,21568
JUDGE/SUPERIOR COURT,Cheryl Lynn ALLEN,"Middletown--1st Ward, 2nd Precinct",104,6,1,0,111,21088,470,10,0,21568
JUDGE/SUPERIOR COURT,Cheryl Lynn ALLEN,"Middletown--2nd Ward, 1st Precinct",101,0,0,0,101,21088,470,10,0,21568
JUDGE/SUPERIOR COURT,Cheryl Lynn ALLEN,"Middletown--2nd Ward, 2nd Precinct",112,2,0,0,114,21088,470,10,0,21568
JUDGE/SUPERIOR COURT,Cheryl Lynn ALLEN,"Middletown--3rd Ward, 1st Precinct",90,1,0,0,91,21088,470,10,0,21568
JUDGE/SUPERIOR COURT,Cheryl Lynn ALLEN,"Middletown--3rd Ward, 2nd Precinct",140,0,0,0,140,21088,470,10,0,21568
JUDGE/SUPERIOR COURT,Cheryl Lynn ALLEN,Millersburg--1st Ward,97,4,0,0,101,21088,470,10,0,21568
JUDGE/SUPERIOR COURT,Cheryl Lynn ALLEN,Millersburg--2nd Ward,112,3,0,0,115,21088,470,10,0,21568
JUDGE/SUPERIOR COURT,Cheryl Lynn ALLEN,Paxtang Borough,150,1,0,0,151,21088,470,10,0,21568
JUDGE/SUPERIOR COURT,Cheryl Lynn ALLEN,Penbrook Borough--1st Ward,28,1,0,0,29,21088,470,10,0,21568
JUDGE/SUPERIOR COURT,Cheryl Lynn ALLEN,Penbrook Borough--2nd Ward,46,1,0,0,47,21088,470,10,0,21568
JUDGE/SUPERIOR COURT,Cheryl Lynn ALLEN,Penbrook Borough--3rd Ward,52,0,0,0,52,21088,470,10,0,21568
JUDGE/SUPERIOR COURT,Cheryl Lynn ALLEN,Penbrook Borough--4th Ward,58,1,0,0,59,21088,470,10,0,21568
JUDGE/SUPERIOR COURT,Cheryl Lynn ALLEN,Royalton Borough--1st Ward,22,0,0,0,22,21088,470,10,0,21568
JUDGE/SUPERIOR COURT,Cheryl Lynn ALLEN,Royalton Borough--2nd Ward,56,0,0,0,56,21088,470,10,0,21568
JUDGE/SUPERIOR COURT,Cheryl Lynn ALLEN,Steelton--1st Ward,73,2,0,0,75,21088,470,10,0,21568
JUDGE/SUPERIOR COURT,Cheryl Lynn ALLEN,"Steelton--2nd Ward, 1st Precinct",41,2,0,0,43,21088,470,10,0,21568
JUDGE/SUPERIOR COURT,Cheryl Lynn ALLEN,"Steelton--2nd Ward, 2nd Precinct",46,0,0,0,46,21088,470,10,0,21568
JUDGE/SUPERIOR COURT,Cheryl Lynn ALLEN,"Steelton--3rd Ward, 1st Precinct",24,0,0,0,24,21088,470,10,0,21568
JUDGE/SUPERIOR COURT,Cheryl Lynn ALLEN,"Steelton--3rd Ward, 2nd Precinct",41,0,0,0,41,21088,470,10,0,21568
JUDGE/SUPERIOR COURT,Cheryl Lynn ALLEN,Steelton--4th Ward,49,0,1,0,50,21088,470,10,0,21568
JUDGE/SUPERIOR COURT,Cheryl Lynn ALLEN,Pillow Borough,30,0,0,0,30,21088,470,10,0,21568
JUDGE/SUPERIOR COURT,Cheryl Lynn ALLEN,Williamstown--1st Ward,69,1,0,0,70,21088,470,10,0,21568
JUDGE/SUPERIOR COURT,Cheryl Lynn ALLEN,Williamstown--2nd Ward,43,0,0,0,43,21088,470,10,0,21568
JUDGE/SUPERIOR COURT,Cheryl Lynn ALLEN,Conewago Twp--1st Precinct,213,1,0,0,214,21088,470,10,0,21568
JUDGE/SUPERIOR COURT,Cheryl Lynn ALLEN,Conewago Twp--2nd Precinct,174,7,0,0,181,21088,470,10,0,21568
JUDGE/SUPERIOR COURT,Cheryl Lynn ALLEN,Derry Township--1st Precinct,226,3,0,0,229,21088,470,10,0,21568
JUDGE/SUPERIOR COURT,Cheryl Lynn ALLEN,Derry Township--2nd Precinct,178,3,0,0,181,21088,470,10,0,21568
JUDGE/SUPERIOR COURT,Cheryl Lynn ALLEN,Derry Township--3rd Precinct,131,1,0,0,132,21088,470,10,0,21568
JUDGE/SUPERIOR COURT,Cheryl Lynn ALLEN,Derry Township--4th Precinct,119,3,0,0,122,21088,470,10,0,21568
JUDGE/SUPERIOR COURT,Cheryl Lynn ALLEN,Derry Township--5th Precinct,99,3,0,0,102,21088,470,10,0,21568
JUDGE/SUPERIOR COURT,Cheryl Lynn ALLEN,Derry Township--6th Precinct,117,1,1,0,119,21088,470,10,0,21568
JUDGE/SUPERIOR COURT,Cheryl Lynn ALLEN,Derry Township--7th Precinct,266,12,0,0,278,21088,470,10,0,21568
JUDGE/SUPERIOR COURT,Cheryl Lynn ALLEN,Derry Township--8th Precinct,119,0,0,0,119,21088,470,10,0,21568
JUDGE/SUPERIOR COURT,Cheryl Lynn ALLEN,Derry Township--9th Precinct,74,3,0,0,77,21088,470,10,0,21568
JUDGE/SUPERIOR COURT,Cheryl Lynn ALLEN,Derry Township--10th Precinct,181,3,0,0,184,21088,470,10,0,21568
JUDGE/SUPERIOR COURT,Cheryl Lynn ALLEN,Derry Township--11th Precinct,214,7,0,0,221,21088,470,10,0,21568
JUDGE/SUPERIOR COURT,Cheryl Lynn ALLEN,Derry Township--12th Precinct,112,0,0,0,112,21088,470,10,0,21568
JUDGE/SUPERIOR COURT,Cheryl Lynn ALLEN,Derry Township--13th Precinct,169,7,0,0,176,21088,470,10,0,21568
JUDGE/SUPERIOR COURT,Cheryl Lynn ALLEN,Derry Township--14th Precinct,111,4,0,0,115,21088,470,10,0,21568
JUDGE/SUPERIOR COURT,Cheryl Lynn ALLEN,Derry Township--15th Precinct,223,3,0,0,226,21088,470,10,0,21568
JUDGE/SUPERIOR COURT,Cheryl Lynn ALLEN,East Hanover Township--1st Precinct,253,7,0,0,260,21088,470,10,0,21568
JUDGE/SUPERIOR COURT,Cheryl Lynn ALLEN,East Hanover Township--2nd Precinct,287,2,0,0,289,21088,470,10,0,21568
JUDGE/SUPERIOR COURT,Cheryl Lynn ALLEN,Halifax Twp--1st Precinct,167,3,0,0,170,21088,470,10,0,21568
JUDGE/SUPERIOR COURT,Cheryl Lynn ALLEN,Halifax Twp--2nd Precinct,203,8,0,0,211,21088,470,10,0,21568
JUDGE/SUPERIOR COURT,Cheryl Lynn ALLEN,Jackson Township,124,1,0,0,125,21088,470,10,0,21568
JUDGE/SUPERIOR COURT,Cheryl Lynn ALLEN,Jefferson Township,46,0,0,0,46,21088,470,10,0,21568
JUDGE/SUPERIOR COURT,Cheryl Lynn ALLEN,Londonderry Twp--1st Precinct,221,0,0,0,221,21088,470,10,0,21568
JUDGE/SUPERIOR COURT,Cheryl Lynn ALLEN,Londonderry Twp--2nd Precinct,197,3,0,0,200,21088,470,10,0,21568
JUDGE/SUPERIOR COURT,Cheryl Lynn ALLEN,Londonderry Twp--3rd Precinct,81,1,0,0,82,21088,470,10,0,21568
JUDGE/SUPERIOR COURT,Cheryl Lynn ALLEN,Lower Paxton Twp--1st Precinct,154,2,0,0,156,21088,470,10,0,21568
JUDGE/SUPERIOR COURT,Cheryl Lynn ALLEN,Lower Paxton Twp--2nd Precinct,143,7,0,0,150,21088,470,10,0,21568
JUDGE/SUPERIOR COURT,Cheryl Lynn ALLEN,Lower Paxton Twp--3rd precinct,285,9,0,0,294,21088,470,10,0,21568
JUDGE/SUPERIOR COURT,Cheryl Lynn ALLEN,Lower Paxton Twp--4th Precinct,203,2,0,0,205,21088,470,10,0,21568
JUDGE/SUPERIOR COURT,Cheryl Lynn ALLEN,Lower Paxton Twp--5th Precinct,162,4,0,0,166,21088,470,10,0,21568
JUDGE/SUPERIOR COURT,Cheryl Lynn ALLEN,Lower Paxton Twp--6th Precinct,114,4,0,0,118,21088,470,10,0,21568
JUDGE/SUPERIOR COURT,Cheryl Lynn ALLEN,Lower Paxton Twp--7th Precinct,266,4,0,0,270,21088,470,10,0,21568
JUDGE/SUPERIOR COURT,Cheryl Lynn ALLEN,Lower Paxton Twp--8th Precinct,103,3,0,0,106,21088,470,10,0,21568
JUDGE/SUPERIOR COURT,Cheryl Lynn ALLEN,Lower Paxton Twp--9th Precinct,146,4,0,0,150,21088,470,10,0,21568
JUDGE/SUPERIOR COURT,Cheryl Lynn ALLEN,Lower Paxton Twp--10th Precinct,84,3,0,0,87,21088,470,10,0,21568
JUDGE/SUPERIOR COURT,Cheryl Lynn ALLEN,Lower Paxton Twp--11th Precinct,133,2,1,0,136,21088,470,10,0,21568
JUDGE/SUPERIOR COURT,Cheryl Lynn ALLEN,Lower Paxton Twp--12th Precinct,210,8,1,0,219,21088,470,10,0,21568
JUDGE/SUPERIOR COURT,Cheryl Lynn ALLEN,Lower Paxton Twp--13th Precinct,182,3,0,0,185,21088,470,10,0,21568
JUDGE/SUPERIOR COURT,Cheryl Lynn ALLEN,Lower Paxton Twp--14th Precinct,106,3,2,0,111,21088,470,10,0,21568
JUDGE/SUPERIOR COURT,Cheryl Lynn ALLEN,Lower Paxton Twp--15th Precinct,174,4,0,0,178,21088,470,10,0,21568
JUDGE/SUPERIOR COURT,Cheryl Lynn ALLEN,Lower Paxton Twp--16th Precinct,303,8,0,0,311,21088,470,10,0,21568
JUDGE/SUPERIOR COURT,Cheryl Lynn ALLEN,Lower Paxton Twp--17th Precinct,129,2,0,0,131,21088,470,10,0,21568
JUDGE/SUPERIOR COURT,Cheryl Lynn ALLEN,Lower Paxton Twp--18th Precinct,125,1,0,0,126,21088,470,10,0,21568
JUDGE/SUPERIOR COURT,Cheryl Lynn ALLEN,Lower Paxton Twp--19th Precinct,236,9,0,0,245,21088,470,10,0,21568
JUDGE/SUPERIOR COURT,Cheryl Lynn ALLEN,Lower Paxton Twp--20th Precinct,200,5,0,0,205,21088,470,10,0,21568
JUDGE/SUPERIOR COURT,Cheryl Lynn ALLEN,Lower Paxton Twp--21st Precinct,230,5,0,0,235,21088,470,10,0,21568
JUDGE/SUPERIOR COURT,Cheryl Lynn ALLEN,Lower Paxton Twp--22nd Precinct,204,4,0,0,208,21088,470,10,0,21568
JUDGE/SUPERIOR COURT,Cheryl Lynn ALLEN,Lower Paxton Twp--23rd Precinct,192,2,0,0,194,21088,470,10,0,21568
JUDGE/SUPERIOR COURT,Cheryl Lynn ALLEN,Lower Paxton Twp--24th Precinct,192,6,0,0,198,21088,470,10,0,21568
JUDGE/SUPERIOR COURT,Cheryl Lynn ALLEN,Lower Paxton Twp--25th Precinct,110,3,0,0,113,21088,470,10,0,21568
JUDGE/SUPERIOR COURT,Cheryl Lynn ALLEN,Lower Paxton Twp--26th Precinct,176,5,0,0,181,21088,470,10,0,21568
JUDGE/SUPERIOR COURT,Cheryl Lynn ALLEN,Lower Paxton Twp--27th Precinct,157,0,0,0,157,21088,470,10,0,21568
JUDGE/SUPERIOR COURT,Cheryl Lynn ALLEN,Lower Swatara Twp--1st Precinct,264,3,0,0,267,21088,470,10,0,21568
JUDGE/SUPERIOR COURT,Cheryl Lynn ALLEN,Lower Swatara Twp--2nd Precinct,219,4,0,0,223,21088,470,10,0,21568
JUDGE/SUPERIOR COURT,Cheryl Lynn ALLEN,Lower Swatara Twp--3rd Precinct,176,17,0,0,193,21088,470,10,0,21568
JUDGE/SUPERIOR COURT,Cheryl Lynn ALLEN,Lower Swatara Twp--4th Precinct,171,0,0,0,171,21088,470,10,0,21568
JUDGE/SUPERIOR COURT,Cheryl Lynn ALLEN,Lykens Township,78,0,0,0,78,21088,470,10,0,21568
JUDGE/SUPERIOR COURT,Cheryl Lynn ALLEN,Middle Paxton Twp--1st Precinct,211,0,0,0,211,21088,470,10,0,21568
JUDGE/SUPERIOR COURT,Cheryl Lynn ALLEN,Middle Paxton Twp--2nd Precinct,172,0,0,0,172,21088,470,10,0,21568
JUDGE/SUPERIOR COURT,Cheryl Lynn ALLEN,Middle Paxton Twp--3rd Precinct,253,2,0,0,255,21088,470,10,0,21568
JUDGE/SUPERIOR COURT,Cheryl Lynn ALLEN,Mifflin Township,63,0,0,0,63,21088,470,10,0,21568
JUDGE/SUPERIOR COURT,Cheryl Lynn ALLEN,Reed Township,29,0,0,0,29,21088,470,10,0,21568
JUDGE/SUPERIOR COURT,Cheryl Lynn ALLEN,Rush Township,33,0,0,0,33,21088,470,10,0,21568
JUDGE/SUPERIOR COURT,Cheryl Lynn ALLEN,South Hanover Twp--1st Precinct,198,4,0,0,202,21088,470,10,0,21568
JUDGE/SUPERIOR COURT,Cheryl Lynn ALLEN,South Hanover Twp--2nd Precinct,271,7,0,0,278,21088,470,10,0,21568
JUDGE/SUPERIOR COURT,Cheryl Lynn ALLEN,South Hanover Twp--3rd Precinct,153,1,0,0,154,21088,470,10,0,21568
JUDGE/SUPERIOR COURT,Cheryl Lynn ALLEN,Susquehanna Twp--1st Ward,233,8,0,0,241,21088,470,10,0,21568
JUDGE/SUPERIOR COURT,Cheryl Lynn ALLEN,Susquehanna Twp--2nd Ward,373,18,0,0,391,21088,470,10,0,21568
JUDGE/SUPERIOR COURT,Cheryl Lynn ALLEN,Susquehanna Twp--3rd Ward,145,0,0,0,145,21088,470,10,0,21568
JUDGE/SUPERIOR COURT,Cheryl Lynn ALLEN,Susquehanna Twp--4th Ward,180,2,0,0,182,21088,470,10,0,21568
JUDGE/SUPERIOR COURT,Cheryl Lynn ALLEN,Susquehanna Twp--5th Ward,201,2,0,0,203,21088,470,10,0,21568
JUDGE/SUPERIOR COURT,Cheryl Lynn ALLEN,Susquehanna Twp--6th Ward,251,7,0,0,258,21088,470,10,0,21568
JUDGE/SUPERIOR COURT,Cheryl Lynn ALLEN,Susquehanna Twp--7th Ward,114,0,0,0,114,21088,470,10,0,21568
JUDGE/SUPERIOR COURT,Cheryl Lynn ALLEN,Susquehanna Twp--8th Ward,299,10,0,0,309,21088,470,10,0,21568
JUDGE/SUPERIOR COURT,Cheryl Lynn ALLEN,Susquehanna Twp--9th Ward,197,3,0,0,200,21088,470,10,0,21568
JUDGE/SUPERIOR COURT,Cheryl Lynn ALLEN,Swatara Township--1st Ward,189,3,0,0,192,21088,470,10,0,21568
JUDGE/SUPERIOR COURT,Cheryl Lynn ALLEN,Swatara Township--2nd Ward,118,10,0,0,128,21088,470,10,0,21568
JUDGE/SUPERIOR COURT,Cheryl Lynn ALLEN,Swatara Township--3rd Ward,118,4,0,0,122,21088,470,10,0,21568
JUDGE/SUPERIOR COURT,Cheryl Lynn ALLEN,Swatara Township--4th Ward,214,8,0,0,222,21088,470,10,0,21568
JUDGE/SUPERIOR COURT,Cheryl Lynn ALLEN,Swatara Township--5th Ward,320,3,0,0,323,21088,470,10,0,21568
JUDGE/SUPERIOR COURT,Cheryl Lynn ALLEN,Swatara Township--6th Ward,259,2,1,0,262,21088,470,10,0,21568
JUDGE/SUPERIOR COURT,Cheryl Lynn ALLEN,Swatara Township--7th Ward,249,7,0,0,256,21088,470,10,0,21568
JUDGE/SUPERIOR COURT,Cheryl Lynn ALLEN,Swatara Township--8th Ward,333,5,0,0,338,21088,470,10,0,21568
JUDGE/SUPERIOR COURT,Cheryl Lynn ALLEN,Swatara Township--9th Ward,117,4,0,0,121,21088,470,10,0,21568
JUDGE/SUPERIOR COURT,Cheryl Lynn ALLEN,Upper Paxton Twp--1st Precinct,213,2,0,0,215,21088,470,10,0,21568
JUDGE/SUPERIOR COURT,Cheryl Lynn ALLEN,Upper Paxton Twp--2nd Precinct,122,2,0,0,124,21088,470,10,0,21568
JUDGE/SUPERIOR COURT,Cheryl Lynn ALLEN,Washington Township,194,6,0,0,200,21088,470,10,0,21568
JUDGE/SUPERIOR COURT,Cheryl Lynn ALLEN,Wayne Township,159,0,1,0,160,21088,470,10,0,21568
JUDGE/SUPERIOR COURT,Cheryl Lynn ALLEN,West Hanover Twp--1st Precinct,213,5,0,0,218,21088,470,10,0,21568
JUDGE/SUPERIOR COURT,Cheryl Lynn ALLEN,West Hanover Twp--2nd Precinct,197,7,1,0,205,21088,470,10,0,21568
JUDGE/SUPERIOR COURT,Cheryl Lynn ALLEN,West Hanover Twp--3rd Precinct,444,10,0,0,454,21088,470,10,0,21568
JUDGE/SUPERIOR COURT,Cheryl Lynn ALLEN,West Hanover Twp--4th Precinct,271,1,0,0,272,21088,470,10,0,21568
JUDGE/SUPERIOR COURT,Cheryl Lynn ALLEN,Wiconisco Twp--1st Precinct,50,1,0,0,51,21088,470,10,0,21568
JUDGE/SUPERIOR COURT,Cheryl Lynn ALLEN,Wiconisco Twp--2nd Precinct,41,1,0,0,42,21088,470,10,0,21568
JUDGE/SUPERIOR COURT,Cheryl Lynn ALLEN,Williams Twp,108,1,0,0,109,21088,470,10,0,21568
JUDGE/SUPERIOR COURT,Christine  DONOHUE,"City--1st Ward, 1st Precinct",69,1,0,0,70,15426,306,11,0,15743
JUDGE/SUPERIOR COURT,Christine  DONOHUE,"City--1st Ward, 2nd Precinct",108,1,1,0,110,15426,306,11,0,15743
JUDGE/SUPERIOR COURT,Christine  DONOHUE,"City--1st Ward, 3rd Precinct",61,0,0,0,61,15426,306,11,0,15743
JUDGE/SUPERIOR COURT,Christine  DONOHUE,"City--2nd Ward, 1st Precinct",24,0,0,0,24,15426,306,11,0,15743
JUDGE/SUPERIOR COURT,Christine  DONOHUE,"City--2nd Ward, 2nd Precinct",60,0,0,0,60,15426,306,11,0,15743
JUDGE/SUPERIOR COURT,Christine  DONOHUE,City--3rd Ward,79,0,0,0,79,15426,306,11,0,15743
JUDGE/SUPERIOR COURT,Christine  DONOHUE,City--4th Ward,116,3,0,0,119,15426,306,11,0,15743
JUDGE/SUPERIOR COURT,Christine  DONOHUE,City--5th Ward,239,6,0,0,245,15426,306,11,0,15743
JUDGE/SUPERIOR COURT,Christine  DONOHUE,City--6th Ward,113,1,3,0,117,15426,306,11,0,15743
JUDGE/SUPERIOR COURT,Christine  DONOHUE,"City--7th Ward, 1st Precinct",41,1,0,0,42,15426,306,11,0,15743
JUDGE/SUPERIOR COURT,Christine  DONOHUE,"City--7th Ward, 2nd Precinct",113,0,0,0,113,15426,306,11,0,15743
JUDGE/SUPERIOR COURT,Christine  DONOHUE,City--8th Ward,107,1,0,0,108,15426,306,11,0,15743
JUDGE/SUPERIOR COURT,Christine  DONOHUE,"City--9th Ward, 1st Precinct",38,2,0,0,40,15426,306,11,0,15743
JUDGE/SUPERIOR COURT,Christine  DONOHUE,"City--9th Ward, 2nd Precinct",66,1,0,0,67,15426,306,11,0,15743
JUDGE/SUPERIOR COURT,Christine  DONOHUE,"City--9th Ward, 3rd Precinct",132,1,0,0,133,15426,306,11,0,15743
JUDGE/SUPERIOR COURT,Christine  DONOHUE,"City--9th Ward, 4th Precinct",120,1,0,0,121,15426,306,11,0,15743
JUDGE/SUPERIOR COURT,Christine  DONOHUE,"City--9th Ward, 5th Precinct",82,3,0,0,85,15426,306,11,0,15743
JUDGE/SUPERIOR COURT,Christine  DONOHUE,"City--10th Ward, 1st Precinct",176,2,0,0,178,15426,306,11,0,15743
JUDGE/SUPERIOR COURT,Christine  DONOHUE,"City--10th Ward, 2nd Precinct",66,0,0,0,66,15426,306,11,0,15743
JUDGE/SUPERIOR COURT,Christine  DONOHUE,"City--10th Ward, 3rd Precinct",58,0,0,0,58,15426,306,11,0,15743
JUDGE/SUPERIOR COURT,Christine  DONOHUE,"City--10th Ward, 4th Precinct",80,0,0,0,80,15426,306,11,0,15743
JUDGE/SUPERIOR COURT,Christine  DONOHUE,City--11th Ward,80,15,0,0,95,15426,306,11,0,15743
JUDGE/SUPERIOR COURT,Christine  DONOHUE,City--12th Ward,201,7,0,0,208,15426,306,11,0,15743
JUDGE/SUPERIOR COURT,Christine  DONOHUE,"City--13th Ward, 1st Precinct",79,0,0,0,79,15426,306,11,0,15743
JUDGE/SUPERIOR COURT,Christine  DONOHUE,"City--13th Ward, 2nd Precinct",98,1,0,0,99,15426,306,11,0,15743
JUDGE/SUPERIOR COURT,Christine  DONOHUE,"City--13th Ward, 3rd Precinct",129,1,0,0,130,15426,306,11,0,15743
JUDGE/SUPERIOR COURT,Christine  DONOHUE,City--14th Ward,240,6,0,0,246,15426,306,11,0,15743
JUDGE/SUPERIOR COURT,Christine  DONOHUE,City--15th Ward,69,1,0,0,70,15426,306,11,0,15743
JUDGE/SUPERIOR COURT,Christine  DONOHUE,Berrysburg Borough,24,0,0,0,24,15426,306,11,0,15743
JUDGE/SUPERIOR COURT,Christine  DONOHUE,Dauphin Borough,58,2,0,0,60,15426,306,11,0,15743
JUDGE/SUPERIOR COURT,Christine  DONOHUE,Elizabethville Borough,52,2,0,0,54,15426,306,11,0,15743
JUDGE/SUPERIOR COURT,Christine  DONOHUE,Gratz Borough,26,0,0,0,26,15426,306,11,0,15743
JUDGE/SUPERIOR COURT,Christine  DONOHUE,Halifax Borough,26,0,0,0,26,15426,306,11,0,15743
JUDGE/SUPERIOR COURT,Christine  DONOHUE,Highspire--1st Precinct,68,2,0,0,70,15426,306,11,0,15743
JUDGE/SUPERIOR COURT,Christine  DONOHUE,Highspire--2nd Precinct,70,0,0,0,70,15426,306,11,0,15743
JUDGE/SUPERIOR COURT,Christine  DONOHUE,Hummelstown--1st Precinct,75,2,0,0,77,15426,306,11,0,15743
JUDGE/SUPERIOR COURT,Christine  DONOHUE,Hummelstown--2nd Precinct,122,3,0,0,125,15426,306,11,0,15743
JUDGE/SUPERIOR COURT,Christine  DONOHUE,Lykens Borough--1st Ward,32,1,0,0,33,15426,306,11,0,15743
JUDGE/SUPERIOR COURT,Christine  DONOHUE,Lykens Borough--2nd Ward,48,1,0,0,49,15426,306,11,0,15743
JUDGE/SUPERIOR COURT,Christine  DONOHUE,"Middletown--1st Ward, 1st Precinct",39,0,0,0,39,15426,306,11,0,15743
JUDGE/SUPERIOR COURT,Christine  DONOHUE,"Middletown--1st Ward, 2nd Precinct",63,1,0,0,64,15426,306,11,0,15743
JUDGE/SUPERIOR COURT,Christine  DONOHUE,"Middletown--2nd Ward, 1st Precinct",65,1,0,0,66,15426,306,11,0,15743
JUDGE/SUPERIOR COURT,Christine  DONOHUE,"Middletown--2nd Ward, 2nd Precinct",48,1,0,0,49,15426,306,11,0,15743
JUDGE/SUPERIOR COURT,Christine  DONOHUE,"Middletown--3rd Ward, 1st Precinct",35,1,0,0,36,15426,306,11,0,15743
JUDGE/SUPERIOR COURT,Christine  DONOHUE,"Middletown--3rd Ward, 2nd Precinct",88,0,0,0,88,15426,306,11,0,15743
JUDGE/SUPERIOR COURT,Christine  DONOHUE,Millersburg--1st Ward,34,1,0,0,35,15426,306,11,0,15743
JUDGE/SUPERIOR COURT,Christine  DONOHUE,Millersburg--2nd Ward,50,0,0,0,50,15426,306,11,0,15743
JUDGE/SUPERIOR COURT,Christine  DONOHUE,Paxtang Borough,128,2,0,0,130,15426,306,11,0,15743
JUDGE/SUPERIOR COURT,Christine  DONOHUE,Penbrook Borough--1st Ward,31,0,0,0,31,15426,306,11,0,15743
JUDGE/SUPERIOR COURT,Christine  DONOHUE,Penbrook Borough--2nd Ward,35,0,0,0,35,15426,306,11,0,15743
JUDGE/SUPERIOR COURT,Christine  DONOHUE,Penbrook Borough--3rd Ward,31,0,0,0,31,15426,306,11,0,15743
JUDGE/SUPERIOR COURT,Christine  DONOHUE,Penbrook Borough--4th Ward,45,1,0,0,46,15426,306,11,0,15743
JUDGE/SUPERIOR COURT,Christine  DONOHUE,Royalton Borough--1st Ward,17,0,0,0,17,15426,306,11,0,15743
JUDGE/SUPERIOR COURT,Christine  DONOHUE,Royalton Borough--2nd Ward,19,0,0,0,19,15426,306,11,0,15743
JUDGE/SUPERIOR COURT,Christine  DONOHUE,Steelton--1st Ward,57,3,0,0,60,15426,306,11,0,15743
JUDGE/SUPERIOR COURT,Christine  DONOHUE,"Steelton--2nd Ward, 1st Precinct",74,0,0,0,74,15426,306,11,0,15743
JUDGE/SUPERIOR COURT,Christine  DONOHUE,"Steelton--2nd Ward, 2nd Precinct",42,0,0,0,42,15426,306,11,0,15743
JUDGE/SUPERIOR COURT,Christine  DONOHUE,"Steelton--3rd Ward, 1st Precinct",31,0,0,0,31,15426,306,11,0,15743
JUDGE/SUPERIOR COURT,Christine  DONOHUE,"Steelton--3rd Ward, 2nd Precinct",69,0,0,0,69,15426,306,11,0,15743
JUDGE/SUPERIOR COURT,Christine  DONOHUE,Steelton--4th Ward,58,2,1,0,61,15426,306,11,0,15743
JUDGE/SUPERIOR COURT,Christine  DONOHUE,Pillow Borough,18,0,0,0,18,15426,306,11,0,15743
JUDGE/SUPERIOR COURT,Christine  DONOHUE,Williamstown--1st Ward,38,1,0,0,39,15426,306,11,0,15743
JUDGE/SUPERIOR COURT,Christine  DONOHUE,Williamstown--2nd Ward,22,0,0,0,22,15426,306,11,0,15743
JUDGE/SUPERIOR COURT,Christine  DONOHUE,Conewago Twp--1st Precinct,70,1,0,0,71,15426,306,11,0,15743
JUDGE/SUPERIOR COURT,Christine  DONOHUE,Conewago Twp--2nd Precinct,61,0,0,0,61,15426,306,11,0,15743
JUDGE/SUPERIOR COURT,Christine  DONOHUE,Derry Township--1st Precinct,136,1,0,0,137,15426,306,11,0,15743
JUDGE/SUPERIOR COURT,Christine  DONOHUE,Derry Township--2nd Precinct,110,3,0,0,113,15426,306,11,0,15743
JUDGE/SUPERIOR COURT,Christine  DONOHUE,Derry Township--3rd Precinct,114,2,1,0,117,15426,306,11,0,15743
JUDGE/SUPERIOR COURT,Christine  DONOHUE,Derry Township--4th Precinct,81,1,0,0,82,15426,306,11,0,15743
JUDGE/SUPERIOR COURT,Christine  DONOHUE,Derry Township--5th Precinct,48,0,0,0,48,15426,306,11,0,15743
JUDGE/SUPERIOR COURT,Christine  DONOHUE,Derry Township--6th Precinct,74,1,0,0,75,15426,306,11,0,15743
JUDGE/SUPERIOR COURT,Christine  DONOHUE,Derry Township--7th Precinct,112,3,0,0,115,15426,306,11,0,15743
JUDGE/SUPERIOR COURT,Christine  DONOHUE,Derry Township--8th Precinct,76,0,0,0,76,15426,306,11,0,15743
JUDGE/SUPERIOR COURT,Christine  DONOHUE,Derry Township--9th Precinct,63,2,0,0,65,15426,306,11,0,15743
JUDGE/SUPERIOR COURT,Christine  DONOHUE,Derry Township--10th Precinct,87,4,0,0,91,15426,306,11,0,15743
JUDGE/SUPERIOR COURT,Christine  DONOHUE,Derry Township--11th Precinct,136,2,0,0,138,15426,306,11,0,15743
JUDGE/SUPERIOR COURT,Christine  DONOHUE,Derry Township--12th Precinct,71,3,0,0,74,15426,306,11,0,15743
JUDGE/SUPERIOR COURT,Christine  DONOHUE,Derry Township--13th Precinct,108,4,0,0,112,15426,306,11,0,15743
JUDGE/SUPERIOR COURT,Christine  DONOHUE,Derry Township--14th Precinct,77,2,0,0,79,15426,306,11,0,15743
JUDGE/SUPERIOR COURT,Christine  DONOHUE,Derry Township--15th Precinct,124,4,0,0,128,15426,306,11,0,15743
JUDGE/SUPERIOR COURT,Christine  DONOHUE,East Hanover Township--1st Precinct,101,2,0,0,103,15426,306,11,0,15743
JUDGE/SUPERIOR COURT,Christine  DONOHUE,East Hanover Township--2nd Precinct,121,2,0,0,123,15426,306,11,0,15743
JUDGE/SUPERIOR COURT,Christine  DONOHUE,Halifax Twp--1st Precinct,97,2,0,0,99,15426,306,11,0,15743
JUDGE/SUPERIOR COURT,Christine  DONOHUE,Halifax Twp--2nd Precinct,90,3,0,0,93,15426,306,11,0,15743
JUDGE/SUPERIOR COURT,Christine  DONOHUE,Jackson Township,76,0,0,0,76,15426,306,11,0,15743
JUDGE/SUPERIOR COURT,Christine  DONOHUE,Jefferson Township,21,0,0,0,21,15426,306,11,0,15743
JUDGE/SUPERIOR COURT,Christine  DONOHUE,Londonderry Twp--1st Precinct,84,0,0,0,84,15426,306,11,0,15743
JUDGE/SUPERIOR COURT,Christine  DONOHUE,Londonderry Twp--2nd Precinct,93,0,0,0,93,15426,306,11,0,15743
JUDGE/SUPERIOR COURT,Christine  DONOHUE,Londonderry Twp--3rd Precinct,45,0,0,0,45,15426,306,11,0,15743
JUDGE/SUPERIOR COURT,Christine  DONOHUE,Lower Paxton Twp--1st Precinct,81,0,0,0,81,15426,306,11,0,15743
JUDGE/SUPERIOR COURT,Christine  DONOHUE,Lower Paxton Twp--2nd Precinct,100,5,0,0,105,15426,306,11,0,15743
JUDGE/SUPERIOR COURT,Christine  DONOHUE,Lower Paxton Twp--3rd precinct,159,5,0,0,164,15426,306,11,0,15743
JUDGE/SUPERIOR COURT,Christine  DONOHUE,Lower Paxton Twp--4th Precinct,124,1,0,0,125,15426,306,11,0,15743
JUDGE/SUPERIOR COURT,Christine  DONOHUE,Lower Paxton Twp--5th Precinct,113,2,0,0,115,15426,306,11,0,15743
JUDGE/SUPERIOR COURT,Christine  DONOHUE,Lower Paxton Twp--6th Precinct,111,3,0,0,114,15426,306,11,0,15743
JUDGE/SUPERIOR COURT,Christine  DONOHUE,Lower Paxton Twp--7th Precinct,114,2,0,0,116,15426,306,11,0,15743
JUDGE/SUPERIOR COURT,Christine  DONOHUE,Lower Paxton Twp--8th Precinct,89,2,0,0,91,15426,306,11,0,15743
JUDGE/SUPERIOR COURT,Christine  DONOHUE,Lower Paxton Twp--9th Precinct,65,1,0,0,66,15426,306,11,0,15743
JUDGE/SUPERIOR COURT,Christine  DONOHUE,Lower Paxton Twp--10th Precinct,91,4,0,0,95,15426,306,11,0,15743
JUDGE/SUPERIOR COURT,Christine  DONOHUE,Lower Paxton Twp--11th Precinct,89,2,0,0,91,15426,306,11,0,15743
JUDGE/SUPERIOR COURT,Christine  DONOHUE,Lower Paxton Twp--12th Precinct,120,1,0,0,121,15426,306,11,0,15743
JUDGE/SUPERIOR COURT,Christine  DONOHUE,Lower Paxton Twp--13th Precinct,133,6,0,0,139,15426,306,11,0,15743
JUDGE/SUPERIOR COURT,Christine  DONOHUE,Lower Paxton Twp--14th Precinct,96,1,2,0,99,15426,306,11,0,15743
JUDGE/SUPERIOR COURT,Christine  DONOHUE,Lower Paxton Twp--15th Precinct,123,1,0,0,124,15426,306,11,0,15743
JUDGE/SUPERIOR COURT,Christine  DONOHUE,Lower Paxton Twp--16th Precinct,164,1,0,0,165,15426,306,11,0,15743
JUDGE/SUPERIOR COURT,Christine  DONOHUE,Lower Paxton Twp--17th Precinct,116,3,0,0,119,15426,306,11,0,15743
JUDGE/SUPERIOR COURT,Christine  DONOHUE,Lower Paxton Twp--18th Precinct,111,0,0,0,111,15426,306,11,0,15743
JUDGE/SUPERIOR COURT,Christine  DONOHUE,Lower Paxton Twp--19th Precinct,157,7,0,0,164,15426,306,11,0,15743
JUDGE/SUPERIOR COURT,Christine  DONOHUE,Lower Paxton Twp--20th Precinct,94,2,0,0,96,15426,306,11,0,15743
JUDGE/SUPERIOR COURT,Christine  DONOHUE,Lower Paxton Twp--21st Precinct,165,9,0,0,174,15426,306,11,0,15743
JUDGE/SUPERIOR COURT,Christine  DONOHUE,Lower Paxton Twp--22nd Precinct,110,1,0,0,111,15426,306,11,0,15743
JUDGE/SUPERIOR COURT,Christine  DONOHUE,Lower Paxton Twp--23rd Precinct,95,0,0,0,95,15426,306,11,0,15743
JUDGE/SUPERIOR COURT,Christine  DONOHUE,Lower Paxton Twp--24th Precinct,118,3,0,0,121,15426,306,11,0,15743
JUDGE/SUPERIOR COURT,Christine  DONOHUE,Lower Paxton Twp--25th Precinct,94,1,0,0,95,15426,306,11,0,15743
JUDGE/SUPERIOR COURT,Christine  DONOHUE,Lower Paxton Twp--26th Precinct,135,4,0,0,139,15426,306,11,0,15743
JUDGE/SUPERIOR COURT,Christine  DONOHUE,Lower Paxton Twp--27th Precinct,109,2,0,0,111,15426,306,11,0,15743
JUDGE/SUPERIOR COURT,Christine  DONOHUE,Lower Swatara Twp--1st Precinct,101,1,0,0,102,15426,306,11,0,15743
JUDGE/SUPERIOR COURT,Christine  DONOHUE,Lower Swatara Twp--2nd Precinct,108,5,0,0,113,15426,306,11,0,15743
JUDGE/SUPERIOR COURT,Christine  DONOHUE,Lower Swatara Twp--3rd Precinct,115,9,0,0,124,15426,306,11,0,15743
JUDGE/SUPERIOR COURT,Christine  DONOHUE,Lower Swatara Twp--4th Precinct,88,0,0,0,88,15426,306,11,0,15743
JUDGE/SUPERIOR COURT,Christine  DONOHUE,Lykens Township,25,0,0,0,25,15426,306,11,0,15743
JUDGE/SUPERIOR COURT,Christine  DONOHUE,Middle Paxton Twp--1st Precinct,117,0,0,0,117,15426,306,11,0,15743
JUDGE/SUPERIOR COURT,Christine  DONOHUE,Middle Paxton Twp--2nd Precinct,129,0,0,0,129,15426,306,11,0,15743
JUDGE/SUPERIOR COURT,Christine  DONOHUE,Middle Paxton Twp--3rd Precinct,127,1,0,0,128,15426,306,11,0,15743
JUDGE/SUPERIOR COURT,Christine  DONOHUE,Mifflin Township,23,0,0,0,23,15426,306,11,0,15743
JUDGE/SUPERIOR COURT,Christine  DONOHUE,Reed Township,12,0,0,0,12,15426,306,11,0,15743
JUDGE/SUPERIOR COURT,Christine  DONOHUE,Rush Township,14,0,0,0,14,15426,306,11,0,15743
JUDGE/SUPERIOR COURT,Christine  DONOHUE,South Hanover Twp--1st Precinct,79,2,0,0,81,15426,306,11,0,15743
JUDGE/SUPERIOR COURT,Christine  DONOHUE,South Hanover Twp--2nd Precinct,150,6,0,0,156,15426,306,11,0,15743
JUDGE/SUPERIOR COURT,Christine  DONOHUE,South Hanover Twp--3rd Precinct,80,0,0,0,80,15426,306,11,0,15743
JUDGE/SUPERIOR COURT,Christine  DONOHUE,Susquehanna Twp--1st Ward,295,8,0,0,303,15426,306,11,0,15743
JUDGE/SUPERIOR COURT,Christine  DONOHUE,Susquehanna Twp--2nd Ward,330,11,0,0,341,15426,306,11,0,15743
JUDGE/SUPERIOR COURT,Christine  DONOHUE,Susquehanna Twp--3rd Ward,189,4,0,0,193,15426,306,11,0,15743
JUDGE/SUPERIOR COURT,Christine  DONOHUE,Susquehanna Twp--4th Ward,189,1,0,0,190,15426,306,11,0,15743
JUDGE/SUPERIOR COURT,Christine  DONOHUE,Susquehanna Twp--5th Ward,158,1,0,0,159,15426,306,11,0,15743
JUDGE/SUPERIOR COURT,Christine  DONOHUE,Susquehanna Twp--6th Ward,175,3,0,0,178,15426,306,11,0,15743
JUDGE/SUPERIOR COURT,Christine  DONOHUE,Susquehanna Twp--7th Ward,119,0,0,0,119,15426,306,11,0,15743
JUDGE/SUPERIOR COURT,Christine  DONOHUE,Susquehanna Twp--8th Ward,281,13,0,0,294,15426,306,11,0,15743
JUDGE/SUPERIOR COURT,Christine  DONOHUE,Susquehanna Twp--9th Ward,238,1,0,0,239,15426,306,11,0,15743
JUDGE/SUPERIOR COURT,Christine  DONOHUE,Swatara Township--1st Ward,159,2,0,0,161,15426,306,11,0,15743
JUDGE/SUPERIOR COURT,Christine  DONOHUE,Swatara Township--2nd Ward,104,13,0,0,117,15426,306,11,0,15743
JUDGE/SUPERIOR COURT,Christine  DONOHUE,Swatara Township--3rd Ward,124,3,0,0,127,15426,306,11,0,15743
JUDGE/SUPERIOR COURT,Christine  DONOHUE,Swatara Township--4th Ward,140,3,0,0,143,15426,306,11,0,15743
JUDGE/SUPERIOR COURT,Christine  DONOHUE,Swatara Township--5th Ward,192,1,0,0,193,15426,306,11,0,15743
JUDGE/SUPERIOR COURT,Christine  DONOHUE,Swatara Township--6th Ward,191,1,0,0,192,15426,306,11,0,15743
JUDGE/SUPERIOR COURT,Christine  DONOHUE,Swatara Township--7th Ward,221,6,0,0,227,15426,306,11,0,15743
JUDGE/SUPERIOR COURT,Christine  DONOHUE,Swatara Township--8th Ward,181,2,1,0,184,15426,306,11,0,15743
JUDGE/SUPERIOR COURT,Christine  DONOHUE,Swatara Township--9th Ward,105,6,0,0,111,15426,306,11,0,15743
JUDGE/SUPERIOR COURT,Christine  DONOHUE,Upper Paxton Twp--1st Precinct,74,0,0,0,74,15426,306,11,0,15743
JUDGE/SUPERIOR COURT,Christine  DONOHUE,Upper Paxton Twp--2nd Precinct,53,0,0,0,53,15426,306,11,0,15743
JUDGE/SUPERIOR COURT,Christine  DONOHUE,Washington Township,86,1,0,0,87,15426,306,11,0,15743
JUDGE/SUPERIOR COURT,Christine  DONOHUE,Wayne Township,75,0,0,0,75,15426,306,11,0,15743
JUDGE/SUPERIOR COURT,Christine  DONOHUE,West Hanover Twp--1st Precinct,85,1,0,0,86,15426,306,11,0,15743
JUDGE/SUPERIOR COURT,Christine  DONOHUE,West Hanover Twp--2nd Precinct,105,0,0,0,105,15426,306,11,0,15743
JUDGE/SUPERIOR COURT,Christine  DONOHUE,West Hanover Twp--3rd Precinct,231,7,2,0,240,15426,306,11,0,15743
JUDGE/SUPERIOR COURT,Christine  DONOHUE,West Hanover Twp--4th Precinct,123,1,0,0,124,15426,306,11,0,15743
JUDGE/SUPERIOR COURT,Christine  DONOHUE,Wiconisco Twp--1st Precinct,39,0,0,0,39,15426,306,11,0,15743
JUDGE/SUPERIOR COURT,Christine  DONOHUE,Wiconisco Twp--2nd Precinct,25,0,0,0,25,15426,306,11,0,15743
JUDGE/SUPERIOR COURT,Christine  DONOHUE,Williams Twp,37,0,0,0,37,15426,306,11,0,15743
JUDGE/SUPERIOR COURT,Jackie  SHOGAN,"City--1st Ward, 1st Precinct",21,3,0,0,24,21403,437,8,0,21848
JUDGE/SUPERIOR COURT,Jackie  SHOGAN,"City--1st Ward, 2nd Precinct",55,1,0,0,56,21403,437,8,0,21848
JUDGE/SUPERIOR COURT,Jackie  SHOGAN,"City--1st Ward, 3rd Precinct",16,0,0,0,16,21403,437,8,0,21848
JUDGE/SUPERIOR COURT,Jackie  SHOGAN,"City--2nd Ward, 1st Precinct",19,0,0,0,19,21403,437,8,0,21848
JUDGE/SUPERIOR COURT,Jackie  SHOGAN,"City--2nd Ward, 2nd Precinct",18,0,0,0,18,21403,437,8,0,21848
JUDGE/SUPERIOR COURT,Jackie  SHOGAN,City--3rd Ward,37,0,0,0,37,21403,437,8,0,21848
JUDGE/SUPERIOR COURT,Jackie  SHOGAN,City--4th Ward,44,0,0,0,44,21403,437,8,0,21848
JUDGE/SUPERIOR COURT,Jackie  SHOGAN,City--5th Ward,90,5,0,0,95,21403,437,8,0,21848
JUDGE/SUPERIOR COURT,Jackie  SHOGAN,City--6th Ward,48,0,0,0,48,21403,437,8,0,21848
JUDGE/SUPERIOR COURT,Jackie  SHOGAN,"City--7th Ward, 1st Precinct",22,1,0,0,23,21403,437,8,0,21848
JUDGE/SUPERIOR COURT,Jackie  SHOGAN,"City--7th Ward, 2nd Precinct",14,1,0,0,15,21403,437,8,0,21848
JUDGE/SUPERIOR COURT,Jackie  SHOGAN,City--8th Ward,20,0,0,0,20,21403,437,8,0,21848
JUDGE/SUPERIOR COURT,Jackie  SHOGAN,"City--9th Ward, 1st Precinct",22,0,0,0,22,21403,437,8,0,21848
JUDGE/SUPERIOR COURT,Jackie  SHOGAN,"City--9th Ward, 2nd Precinct",8,0,0,0,8,21403,437,8,0,21848
JUDGE/SUPERIOR COURT,Jackie  SHOGAN,"City--9th Ward, 3rd Precinct",28,0,0,0,28,21403,437,8,0,21848
JUDGE/SUPERIOR COURT,Jackie  SHOGAN,"City--9th Ward, 4th Precinct",69,3,0,0,72,21403,437,8,0,21848
JUDGE/SUPERIOR COURT,Jackie  SHOGAN,"City--9th Ward, 5th Precinct",43,2,0,0,45,21403,437,8,0,21848
JUDGE/SUPERIOR COURT,Jackie  SHOGAN,"City--10th Ward, 1st Precinct",49,2,0,0,51,21403,437,8,0,21848
JUDGE/SUPERIOR COURT,Jackie  SHOGAN,"City--10th Ward, 2nd Precinct",15,0,0,0,15,21403,437,8,0,21848
JUDGE/SUPERIOR COURT,Jackie  SHOGAN,"City--10th Ward, 3rd Precinct",42,1,0,0,43,21403,437,8,0,21848
JUDGE/SUPERIOR COURT,Jackie  SHOGAN,"City--10th Ward, 4th Precinct",23,0,0,0,23,21403,437,8,0,21848
JUDGE/SUPERIOR COURT,Jackie  SHOGAN,City--11th Ward,28,25,0,0,53,21403,437,8,0,21848
JUDGE/SUPERIOR COURT,Jackie  SHOGAN,City--12th Ward,51,4,0,0,55,21403,437,8,0,21848
JUDGE/SUPERIOR COURT,Jackie  SHOGAN,"City--13th Ward, 1st Precinct",49,0,0,0,49,21403,437,8,0,21848
JUDGE/SUPERIOR COURT,Jackie  SHOGAN,"City--13th Ward, 2nd Precinct",80,4,0,0,84,21403,437,8,0,21848
JUDGE/SUPERIOR COURT,Jackie  SHOGAN,"City--13th Ward, 3rd Precinct",72,1,0,0,73,21403,437,8,0,21848
JUDGE/SUPERIOR COURT,Jackie  SHOGAN,City--14th Ward,100,0,0,0,100,21403,437,8,0,21848
JUDGE/SUPERIOR COURT,Jackie  SHOGAN,City--15th Ward,17,0,0,0,17,21403,437,8,0,21848
JUDGE/SUPERIOR COURT,Jackie  SHOGAN,Berrysburg Borough,44,0,0,0,44,21403,437,8,0,21848
JUDGE/SUPERIOR COURT,Jackie  SHOGAN,Dauphin Borough,102,1,0,0,103,21403,437,8,0,21848
JUDGE/SUPERIOR COURT,Jackie  SHOGAN,Elizabethville Borough,115,0,0,0,115,21403,437,8,0,21848
JUDGE/SUPERIOR COURT,Jackie  SHOGAN,Gratz Borough,61,2,0,0,63,21403,437,8,0,21848
JUDGE/SUPERIOR COURT,Jackie  SHOGAN,Halifax Borough,57,2,0,0,59,21403,437,8,0,21848
JUDGE/SUPERIOR COURT,Jackie  SHOGAN,Highspire--1st Precinct,81,0,0,0,81,21403,437,8,0,21848
JUDGE/SUPERIOR COURT,Jackie  SHOGAN,Highspire--2nd Precinct,90,0,0,0,90,21403,437,8,0,21848
JUDGE/SUPERIOR COURT,Jackie  SHOGAN,Hummelstown--1st Precinct,127,4,0,0,131,21403,437,8,0,21848
JUDGE/SUPERIOR COURT,Jackie  SHOGAN,Hummelstown--2nd Precinct,282,4,0,0,286,21403,437,8,0,21848
JUDGE/SUPERIOR COURT,Jackie  SHOGAN,Lykens Borough--1st Ward,49,0,0,0,49,21403,437,8,0,21848
JUDGE/SUPERIOR COURT,Jackie  SHOGAN,Lykens Borough--2nd Ward,81,2,0,0,83,21403,437,8,0,21848
JUDGE/SUPERIOR COURT,Jackie  SHOGAN,"Middletown--1st Ward, 1st Precinct",54,0,0,0,54,21403,437,8,0,21848
JUDGE/SUPERIOR COURT,Jackie  SHOGAN,"Middletown--1st Ward, 2nd Precinct",99,7,1,0,107,21403,437,8,0,21848
JUDGE/SUPERIOR COURT,Jackie  SHOGAN,"Middletown--2nd Ward, 1st Precinct",103,1,0,0,104,21403,437,8,0,21848
JUDGE/SUPERIOR COURT,Jackie  SHOGAN,"Middletown--2nd Ward, 2nd Precinct",108,2,0,0,110,21403,437,8,0,21848
JUDGE/SUPERIOR COURT,Jackie  SHOGAN,"Middletown--3rd Ward, 1st Precinct",85,1,0,0,86,21403,437,8,0,21848
JUDGE/SUPERIOR COURT,Jackie  SHOGAN,"Middletown--3rd Ward, 2nd Precinct",140,0,0,0,140,21403,437,8,0,21848
JUDGE/SUPERIOR COURT,Jackie  SHOGAN,Millersburg--1st Ward,98,2,0,0,100,21403,437,8,0,21848
JUDGE/SUPERIOR COURT,Jackie  SHOGAN,Millersburg--2nd Ward,112,3,0,0,115,21403,437,8,0,21848
JUDGE/SUPERIOR COURT,Jackie  SHOGAN,Paxtang Borough,145,0,0,0,145,21403,437,8,0,21848
JUDGE/SUPERIOR COURT,Jackie  SHOGAN,Penbrook Borough--1st Ward,33,1,0,0,34,21403,437,8,0,21848
JUDGE/SUPERIOR COURT,Jackie  SHOGAN,Penbrook Borough--2nd Ward,46,1,0,0,47,21403,437,8,0,21848
JUDGE/SUPERIOR COURT,Jackie  SHOGAN,Penbrook Borough--3rd Ward,50,0,0,0,50,21403,437,8,0,21848
JUDGE/SUPERIOR COURT,Jackie  SHOGAN,Penbrook Borough--4th Ward,59,0,0,0,59,21403,437,8,0,21848
JUDGE/SUPERIOR COURT,Jackie  SHOGAN,Royalton Borough--1st Ward,23,0,0,0,23,21403,437,8,0,21848
JUDGE/SUPERIOR COURT,Jackie  SHOGAN,Royalton Borough--2nd Ward,57,0,0,0,57,21403,437,8,0,21848
JUDGE/SUPERIOR COURT,Jackie  SHOGAN,Steelton--1st Ward,77,2,0,0,79,21403,437,8,0,21848
JUDGE/SUPERIOR COURT,Jackie  SHOGAN,"Steelton--2nd Ward, 1st Precinct",38,2,0,0,40,21403,437,8,0,21848
JUDGE/SUPERIOR COURT,Jackie  SHOGAN,"Steelton--2nd Ward, 2nd Precinct",46,0,0,0,46,21403,437,8,0,21848
JUDGE/SUPERIOR COURT,Jackie  SHOGAN,"Steelton--3rd Ward, 1st Precinct",26,0,0,0,26,21403,437,8,0,21848
JUDGE/SUPERIOR COURT,Jackie  SHOGAN,"Steelton--3rd Ward, 2nd Precinct",41,0,0,0,41,21403,437,8,0,21848
JUDGE/SUPERIOR COURT,Jackie  SHOGAN,Steelton--4th Ward,40,0,0,0,40,21403,437,8,0,21848
JUDGE/SUPERIOR COURT,Jackie  SHOGAN,Pillow Borough,33,0,0,0,33,21403,437,8,0,21848
JUDGE/SUPERIOR COURT,Jackie  SHOGAN,Williamstown--1st Ward,65,0,0,0,65,21403,437,8,0,21848
JUDGE/SUPERIOR COURT,Jackie  SHOGAN,Williamstown--2nd Ward,47,0,0,0,47,21403,437,8,0,21848
JUDGE/SUPERIOR COURT,Jackie  SHOGAN,Conewago Twp--1st Precinct,220,1,0,0,221,21403,437,8,0,21848
JUDGE/SUPERIOR COURT,Jackie  SHOGAN,Conewago Twp--2nd Precinct,166,7,0,0,173,21403,437,8,0,21848
JUDGE/SUPERIOR COURT,Jackie  SHOGAN,Derry Township--1st Precinct,240,4,0,0,244,21403,437,8,0,21848
JUDGE/SUPERIOR COURT,Jackie  SHOGAN,Derry Township--2nd Precinct,194,2,0,0,196,21403,437,8,0,21848
JUDGE/SUPERIOR COURT,Jackie  SHOGAN,Derry Township--3rd Precinct,133,2,0,0,135,21403,437,8,0,21848
JUDGE/SUPERIOR COURT,Jackie  SHOGAN,Derry Township--4th Precinct,124,5,0,0,129,21403,437,8,0,21848
JUDGE/SUPERIOR COURT,Jackie  SHOGAN,Derry Township--5th Precinct,98,3,0,0,101,21403,437,8,0,21848
JUDGE/SUPERIOR COURT,Jackie  SHOGAN,Derry Township--6th Precinct,125,1,0,0,126,21403,437,8,0,21848
JUDGE/SUPERIOR COURT,Jackie  SHOGAN,Derry Township--7th Precinct,277,13,0,0,290,21403,437,8,0,21848
JUDGE/SUPERIOR COURT,Jackie  SHOGAN,Derry Township--8th Precinct,130,0,0,0,130,21403,437,8,0,21848
JUDGE/SUPERIOR COURT,Jackie  SHOGAN,Derry Township--9th Precinct,81,3,0,0,84,21403,437,8,0,21848
JUDGE/SUPERIOR COURT,Jackie  SHOGAN,Derry Township--10th Precinct,179,2,0,0,181,21403,437,8,0,21848
JUDGE/SUPERIOR COURT,Jackie  SHOGAN,Derry Township--11th Precinct,211,8,0,0,219,21403,437,8,0,21848
JUDGE/SUPERIOR COURT,Jackie  SHOGAN,Derry Township--12th Precinct,128,0,0,0,128,21403,437,8,0,21848
JUDGE/SUPERIOR COURT,Jackie  SHOGAN,Derry Township--13th Precinct,176,7,0,0,183,21403,437,8,0,21848
JUDGE/SUPERIOR COURT,Jackie  SHOGAN,Derry Township--14th Precinct,119,4,0,0,123,21403,437,8,0,21848
JUDGE/SUPERIOR COURT,Jackie  SHOGAN,Derry Township--15th Precinct,235,2,0,0,237,21403,437,8,0,21848
JUDGE/SUPERIOR COURT,Jackie  SHOGAN,East Hanover Township--1st Precinct,254,7,0,0,261,21403,437,8,0,21848
JUDGE/SUPERIOR COURT,Jackie  SHOGAN,East Hanover Township--2nd Precinct,286,1,0,0,287,21403,437,8,0,21848
JUDGE/SUPERIOR COURT,Jackie  SHOGAN,Halifax Twp--1st Precinct,166,2,0,0,168,21403,437,8,0,21848
JUDGE/SUPERIOR COURT,Jackie  SHOGAN,Halifax Twp--2nd Precinct,195,7,0,0,202,21403,437,8,0,21848
JUDGE/SUPERIOR COURT,Jackie  SHOGAN,Jackson Township,161,1,0,0,162,21403,437,8,0,21848
JUDGE/SUPERIOR COURT,Jackie  SHOGAN,Jefferson Township,48,0,0,0,48,21403,437,8,0,21848
JUDGE/SUPERIOR COURT,Jackie  SHOGAN,Londonderry Twp--1st Precinct,228,0,0,0,228,21403,437,8,0,21848
JUDGE/SUPERIOR COURT,Jackie  SHOGAN,Londonderry Twp--2nd Precinct,215,3,0,0,218,21403,437,8,0,21848
JUDGE/SUPERIOR COURT,Jackie  SHOGAN,Londonderry Twp--3rd Precinct,80,1,0,0,81,21403,437,8,0,21848
JUDGE/SUPERIOR COURT,Jackie  SHOGAN,Lower Paxton Twp--1st Precinct,151,3,0,0,154,21403,437,8,0,21848
JUDGE/SUPERIOR COURT,Jackie  SHOGAN,Lower Paxton Twp--2nd Precinct,144,6,0,0,150,21403,437,8,0,21848
JUDGE/SUPERIOR COURT,Jackie  SHOGAN,Lower Paxton Twp--3rd precinct,295,7,0,0,302,21403,437,8,0,21848
JUDGE/SUPERIOR COURT,Jackie  SHOGAN,Lower Paxton Twp--4th Precinct,205,2,0,0,207,21403,437,8,0,21848
JUDGE/SUPERIOR COURT,Jackie  SHOGAN,Lower Paxton Twp--5th Precinct,184,2,0,0,186,21403,437,8,0,21848
JUDGE/SUPERIOR COURT,Jackie  SHOGAN,Lower Paxton Twp--6th Precinct,118,4,0,0,122,21403,437,8,0,21848
JUDGE/SUPERIOR COURT,Jackie  SHOGAN,Lower Paxton Twp--7th Precinct,265,4,0,0,269,21403,437,8,0,21848
JUDGE/SUPERIOR COURT,Jackie  SHOGAN,Lower Paxton Twp--8th Precinct,103,2,0,0,105,21403,437,8,0,21848
JUDGE/SUPERIOR COURT,Jackie  SHOGAN,Lower Paxton Twp--9th Precinct,156,4,0,0,160,21403,437,8,0,21848
JUDGE/SUPERIOR COURT,Jackie  SHOGAN,Lower Paxton Twp--10th Precinct,94,4,0,0,98,21403,437,8,0,21848
JUDGE/SUPERIOR COURT,Jackie  SHOGAN,Lower Paxton Twp--11th Precinct,139,1,1,0,141,21403,437,8,0,21848
JUDGE/SUPERIOR COURT,Jackie  SHOGAN,Lower Paxton Twp--12th Precinct,214,6,1,0,221,21403,437,8,0,21848
JUDGE/SUPERIOR COURT,Jackie  SHOGAN,Lower Paxton Twp--13th Precinct,193,2,0,0,195,21403,437,8,0,21848
JUDGE/SUPERIOR COURT,Jackie  SHOGAN,Lower Paxton Twp--14th Precinct,106,3,2,0,111,21403,437,8,0,21848
JUDGE/SUPERIOR COURT,Jackie  SHOGAN,Lower Paxton Twp--15th Precinct,173,4,0,0,177,21403,437,8,0,21848
JUDGE/SUPERIOR COURT,Jackie  SHOGAN,Lower Paxton Twp--16th Precinct,304,8,0,0,312,21403,437,8,0,21848
JUDGE/SUPERIOR COURT,Jackie  SHOGAN,Lower Paxton Twp--17th Precinct,126,1,0,0,127,21403,437,8,0,21848
JUDGE/SUPERIOR COURT,Jackie  SHOGAN,Lower Paxton Twp--18th Precinct,132,1,0,0,133,21403,437,8,0,21848
JUDGE/SUPERIOR COURT,Jackie  SHOGAN,Lower Paxton Twp--19th Precinct,227,5,0,0,232,21403,437,8,0,21848
JUDGE/SUPERIOR COURT,Jackie  SHOGAN,Lower Paxton Twp--20th Precinct,202,4,0,0,206,21403,437,8,0,21848
JUDGE/SUPERIOR COURT,Jackie  SHOGAN,Lower Paxton Twp--21st Precinct,242,3,0,0,245,21403,437,8,0,21848
JUDGE/SUPERIOR COURT,Jackie  SHOGAN,Lower Paxton Twp--22nd Precinct,202,3,0,0,205,21403,437,8,0,21848
JUDGE/SUPERIOR COURT,Jackie  SHOGAN,Lower Paxton Twp--23rd Precinct,205,2,0,0,207,21403,437,8,0,21848
JUDGE/SUPERIOR COURT,Jackie  SHOGAN,Lower Paxton Twp--24th Precinct,188,6,0,0,194,21403,437,8,0,21848
JUDGE/SUPERIOR COURT,Jackie  SHOGAN,Lower Paxton Twp--25th Precinct,122,3,0,0,125,21403,437,8,0,21848
JUDGE/SUPERIOR COURT,Jackie  SHOGAN,Lower Paxton Twp--26th Precinct,170,3,0,0,173,21403,437,8,0,21848
JUDGE/SUPERIOR COURT,Jackie  SHOGAN,Lower Paxton Twp--27th Precinct,142,1,0,0,143,21403,437,8,0,21848
JUDGE/SUPERIOR COURT,Jackie  SHOGAN,Lower Swatara Twp--1st Precinct,266,3,0,0,269,21403,437,8,0,21848
JUDGE/SUPERIOR COURT,Jackie  SHOGAN,Lower Swatara Twp--2nd Precinct,216,7,0,0,223,21403,437,8,0,21848
JUDGE/SUPERIOR COURT,Jackie  SHOGAN,Lower Swatara Twp--3rd Precinct,183,18,0,0,201,21403,437,8,0,21848
JUDGE/SUPERIOR COURT,Jackie  SHOGAN,Lower Swatara Twp--4th Precinct,166,0,0,0,166,21403,437,8,0,21848
JUDGE/SUPERIOR COURT,Jackie  SHOGAN,Lykens Township,72,0,0,0,72,21403,437,8,0,21848
JUDGE/SUPERIOR COURT,Jackie  SHOGAN,Middle Paxton Twp--1st Precinct,220,0,0,0,220,21403,437,8,0,21848
JUDGE/SUPERIOR COURT,Jackie  SHOGAN,Middle Paxton Twp--2nd Precinct,179,1,0,0,180,21403,437,8,0,21848
JUDGE/SUPERIOR COURT,Jackie  SHOGAN,Middle Paxton Twp--3rd Precinct,262,1,0,0,263,21403,437,8,0,21848
JUDGE/SUPERIOR COURT,Jackie  SHOGAN,Mifflin Township,65,0,0,0,65,21403,437,8,0,21848
JUDGE/SUPERIOR COURT,Jackie  SHOGAN,Reed Township,31,0,0,0,31,21403,437,8,0,21848
JUDGE/SUPERIOR COURT,Jackie  SHOGAN,Rush Township,30,0,0,0,30,21403,437,8,0,21848
JUDGE/SUPERIOR COURT,Jackie  SHOGAN,South Hanover Twp--1st Precinct,204,3,0,0,207,21403,437,8,0,21848
JUDGE/SUPERIOR COURT,Jackie  SHOGAN,South Hanover Twp--2nd Precinct,278,4,0,0,282,21403,437,8,0,21848
JUDGE/SUPERIOR COURT,Jackie  SHOGAN,South Hanover Twp--3rd Precinct,159,1,0,0,160,21403,437,8,0,21848
JUDGE/SUPERIOR COURT,Jackie  SHOGAN,Susquehanna Twp--1st Ward,238,9,0,0,247,21403,437,8,0,21848
JUDGE/SUPERIOR COURT,Jackie  SHOGAN,Susquehanna Twp--2nd Ward,380,12,0,0,392,21403,437,8,0,21848
JUDGE/SUPERIOR COURT,Jackie  SHOGAN,Susquehanna Twp--3rd Ward,132,0,0,0,132,21403,437,8,0,21848
JUDGE/SUPERIOR COURT,Jackie  SHOGAN,Susquehanna Twp--4th Ward,159,4,0,0,163,21403,437,8,0,21848
JUDGE/SUPERIOR COURT,Jackie  SHOGAN,Susquehanna Twp--5th Ward,205,5,0,0,210,21403,437,8,0,21848
JUDGE/SUPERIOR COURT,Jackie  SHOGAN,Susquehanna Twp--6th Ward,264,6,0,0,270,21403,437,8,0,21848
JUDGE/SUPERIOR COURT,Jackie  SHOGAN,Susquehanna Twp--7th Ward,122,0,0,0,122,21403,437,8,0,21848
JUDGE/SUPERIOR COURT,Jackie  SHOGAN,Susquehanna Twp--8th Ward,286,11,0,0,297,21403,437,8,0,21848
JUDGE/SUPERIOR COURT,Jackie  SHOGAN,Susquehanna Twp--9th Ward,188,3,0,0,191,21403,437,8,0,21848
JUDGE/SUPERIOR COURT,Jackie  SHOGAN,Swatara Township--1st Ward,194,3,0,0,197,21403,437,8,0,21848
JUDGE/SUPERIOR COURT,Jackie  SHOGAN,Swatara Township--2nd Ward,109,10,0,0,119,21403,437,8,0,21848
JUDGE/SUPERIOR COURT,Jackie  SHOGAN,Swatara Township--3rd Ward,128,4,0,0,132,21403,437,8,0,21848
JUDGE/SUPERIOR COURT,Jackie  SHOGAN,Swatara Township--4th Ward,226,8,0,0,234,21403,437,8,0,21848
JUDGE/SUPERIOR COURT,Jackie  SHOGAN,Swatara Township--5th Ward,315,1,0,0,316,21403,437,8,0,21848
JUDGE/SUPERIOR COURT,Jackie  SHOGAN,Swatara Township--6th Ward,273,2,1,0,276,21403,437,8,0,21848
JUDGE/SUPERIOR COURT,Jackie  SHOGAN,Swatara Township--7th Ward,270,6,0,0,276,21403,437,8,0,21848
JUDGE/SUPERIOR COURT,Jackie  SHOGAN,Swatara Township--8th Ward,331,5,0,0,336,21403,437,8,0,21848
JUDGE/SUPERIOR COURT,Jackie  SHOGAN,Swatara Township--9th Ward,109,5,0,0,114,21403,437,8,0,21848
JUDGE/SUPERIOR COURT,Jackie  SHOGAN,Upper Paxton Twp--1st Precinct,210,2,0,0,212,21403,437,8,0,21848
JUDGE/SUPERIOR COURT,Jackie  SHOGAN,Upper Paxton Twp--2nd Precinct,128,2,0,0,130,21403,437,8,0,21848
JUDGE/SUPERIOR COURT,Jackie  SHOGAN,Washington Township,198,6,0,0,204,21403,437,8,0,21848
JUDGE/SUPERIOR COURT,Jackie  SHOGAN,Wayne Township,180,0,0,0,180,21403,437,8,0,21848
JUDGE/SUPERIOR COURT,Jackie  SHOGAN,West Hanover Twp--1st Precinct,225,4,0,0,229,21403,437,8,0,21848
JUDGE/SUPERIOR COURT,Jackie  SHOGAN,West Hanover Twp--2nd Precinct,199,7,1,0,207,21403,437,8,0,21848
JUDGE/SUPERIOR COURT,Jackie  SHOGAN,West Hanover Twp--3rd Precinct,451,10,1,0,462,21403,437,8,0,21848
JUDGE/SUPERIOR COURT,Jackie  SHOGAN,West Hanover Twp--4th Precinct,277,1,0,0,278,21403,437,8,0,21848
JUDGE/SUPERIOR COURT,Jackie  SHOGAN,Wiconisco Twp--1st Precinct,55,1,0,0,56,21403,437,8,0,21848
JUDGE/SUPERIOR COURT,Jackie  SHOGAN,Wiconisco Twp--2nd Precinct,41,1,0,0,42,21403,437,8,0,21848
JUDGE/SUPERIOR COURT,Jackie  SHOGAN,Williams Twp,94,1,0,0,95,21403,437,8,0,21848
JUDGE/SUPERIOR COURT,John  YOUNGE,"City--1st Ward, 1st Precinct",58,1,0,0,59,12779,233,7,0,13019
JUDGE/SUPERIOR COURT,John  YOUNGE,"City--1st Ward, 2nd Precinct",102,1,1,0,104,12779,233,7,0,13019
JUDGE/SUPERIOR COURT,John  YOUNGE,"City--1st Ward, 3rd Precinct",59,1,0,0,60,12779,233,7,0,13019
JUDGE/SUPERIOR COURT,John  YOUNGE,"City--2nd Ward, 1st Precinct",18,0,0,0,18,12779,233,7,0,13019
JUDGE/SUPERIOR COURT,John  YOUNGE,"City--2nd Ward, 2nd Precinct",54,0,0,0,54,12779,233,7,0,13019
JUDGE/SUPERIOR COURT,John  YOUNGE,City--3rd Ward,71,1,0,0,72,12779,233,7,0,13019
JUDGE/SUPERIOR COURT,John  YOUNGE,City--4th Ward,110,4,0,0,114,12779,233,7,0,13019
JUDGE/SUPERIOR COURT,John  YOUNGE,City--5th Ward,206,6,0,0,212,12779,233,7,0,13019
JUDGE/SUPERIOR COURT,John  YOUNGE,City--6th Ward,116,1,3,0,120,12779,233,7,0,13019
JUDGE/SUPERIOR COURT,John  YOUNGE,"City--7th Ward, 1st Precinct",42,1,0,0,43,12779,233,7,0,13019
JUDGE/SUPERIOR COURT,John  YOUNGE,"City--7th Ward, 2nd Precinct",161,0,0,0,161,12779,233,7,0,13019
JUDGE/SUPERIOR COURT,John  YOUNGE,City--8th Ward,132,1,0,0,133,12779,233,7,0,13019
JUDGE/SUPERIOR COURT,John  YOUNGE,"City--9th Ward, 1st Precinct",34,1,0,0,35,12779,233,7,0,13019
JUDGE/SUPERIOR COURT,John  YOUNGE,"City--9th Ward, 2nd Precinct",77,0,0,0,77,12779,233,7,0,13019
JUDGE/SUPERIOR COURT,John  YOUNGE,"City--9th Ward, 3rd Precinct",150,1,0,0,151,12779,233,7,0,13019
JUDGE/SUPERIOR COURT,John  YOUNGE,"City--9th Ward, 4th Precinct",122,2,0,0,124,12779,233,7,0,13019
JUDGE/SUPERIOR COURT,John  YOUNGE,"City--9th Ward, 5th Precinct",70,3,0,0,73,12779,233,7,0,13019
JUDGE/SUPERIOR COURT,John  YOUNGE,"City--10th Ward, 1st Precinct",169,3,0,0,172,12779,233,7,0,13019
JUDGE/SUPERIOR COURT,John  YOUNGE,"City--10th Ward, 2nd Precinct",78,0,0,0,78,12779,233,7,0,13019
JUDGE/SUPERIOR COURT,John  YOUNGE,"City--10th Ward, 3rd Precinct",49,0,0,0,49,12779,233,7,0,13019
JUDGE/SUPERIOR COURT,John  YOUNGE,"City--10th Ward, 4th Precinct",96,1,0,0,97,12779,233,7,0,13019
JUDGE/SUPERIOR COURT,John  YOUNGE,City--11th Ward,81,14,0,0,95,12779,233,7,0,13019
JUDGE/SUPERIOR COURT,John  YOUNGE,City--12th Ward,184,2,0,0,186,12779,233,7,0,13019
JUDGE/SUPERIOR COURT,John  YOUNGE,"City--13th Ward, 1st Precinct",64,0,0,0,64,12779,233,7,0,13019
JUDGE/SUPERIOR COURT,John  YOUNGE,"City--13th Ward, 2nd Precinct",82,1,0,0,83,12779,233,7,0,13019
JUDGE/SUPERIOR COURT,John  YOUNGE,"City--13th Ward, 3rd Precinct",141,1,0,0,142,12779,233,7,0,13019
JUDGE/SUPERIOR COURT,John  YOUNGE,City--14th Ward,215,7,0,0,222,12779,233,7,0,13019
JUDGE/SUPERIOR COURT,John  YOUNGE,City--15th Ward,72,1,0,0,73,12779,233,7,0,13019
JUDGE/SUPERIOR COURT,John  YOUNGE,Berrysburg Borough,17,0,0,0,17,12779,233,7,0,13019
JUDGE/SUPERIOR COURT,John  YOUNGE,Dauphin Borough,47,1,0,0,48,12779,233,7,0,13019
JUDGE/SUPERIOR COURT,John  YOUNGE,Elizabethville Borough,37,2,0,0,39,12779,233,7,0,13019
JUDGE/SUPERIOR COURT,John  YOUNGE,Gratz Borough,13,0,0,0,13,12779,233,7,0,13019
JUDGE/SUPERIOR COURT,John  YOUNGE,Halifax Borough,16,0,0,0,16,12779,233,7,0,13019
JUDGE/SUPERIOR COURT,John  YOUNGE,Highspire--1st Precinct,50,1,0,0,51,12779,233,7,0,13019
JUDGE/SUPERIOR COURT,John  YOUNGE,Highspire--2nd Precinct,51,1,0,0,52,12779,233,7,0,13019
JUDGE/SUPERIOR COURT,John  YOUNGE,Hummelstown--1st Precinct,82,1,0,0,83,12779,233,7,0,13019
JUDGE/SUPERIOR COURT,John  YOUNGE,Hummelstown--2nd Precinct,169,1,0,0,170,12779,233,7,0,13019
JUDGE/SUPERIOR COURT,John  YOUNGE,Lykens Borough--1st Ward,33,0,0,0,33,12779,233,7,0,13019
JUDGE/SUPERIOR COURT,John  YOUNGE,Lykens Borough--2nd Ward,37,1,0,0,38,12779,233,7,0,13019
JUDGE/SUPERIOR COURT,John  YOUNGE,"Middletown--1st Ward, 1st Precinct",32,0,0,0,32,12779,233,7,0,13019
JUDGE/SUPERIOR COURT,John  YOUNGE,"Middletown--1st Ward, 2nd Precinct",44,1,0,0,45,12779,233,7,0,13019
JUDGE/SUPERIOR COURT,John  YOUNGE,"Middletown--2nd Ward, 1st Precinct",56,1,0,0,57,12779,233,7,0,13019
JUDGE/SUPERIOR COURT,John  YOUNGE,"Middletown--2nd Ward, 2nd Precinct",45,1,0,0,46,12779,233,7,0,13019
JUDGE/SUPERIOR COURT,John  YOUNGE,"Middletown--3rd Ward, 1st Precinct",31,1,0,0,32,12779,233,7,0,13019
JUDGE/SUPERIOR COURT,John  YOUNGE,"Middletown--3rd Ward, 2nd Precinct",61,0,0,0,61,12779,233,7,0,13019
JUDGE/SUPERIOR COURT,John  YOUNGE,Millersburg--1st Ward,23,0,0,0,23,12779,233,7,0,13019
JUDGE/SUPERIOR COURT,John  YOUNGE,Millersburg--2nd Ward,40,0,0,0,40,12779,233,7,0,13019
JUDGE/SUPERIOR COURT,John  YOUNGE,Paxtang Borough,101,3,0,0,104,12779,233,7,0,13019
JUDGE/SUPERIOR COURT,John  YOUNGE,Penbrook Borough--1st Ward,30,0,0,0,30,12779,233,7,0,13019
JUDGE/SUPERIOR COURT,John  YOUNGE,Penbrook Borough--2nd Ward,33,0,0,0,33,12779,233,7,0,13019
JUDGE/SUPERIOR COURT,John  YOUNGE,Penbrook Borough--3rd Ward,26,0,0,0,26,12779,233,7,0,13019
JUDGE/SUPERIOR COURT,John  YOUNGE,Penbrook Borough--4th Ward,37,1,0,0,38,12779,233,7,0,13019
JUDGE/SUPERIOR COURT,John  YOUNGE,Royalton Borough--1st Ward,15,0,0,0,15,12779,233,7,0,13019
JUDGE/SUPERIOR COURT,John  YOUNGE,Royalton Borough--2nd Ward,17,0,0,0,17,12779,233,7,0,13019
JUDGE/SUPERIOR COURT,John  YOUNGE,Steelton--1st Ward,43,4,0,0,47,12779,233,7,0,13019
JUDGE/SUPERIOR COURT,John  YOUNGE,"Steelton--2nd Ward, 1st Precinct",69,0,0,0,69,12779,233,7,0,13019
JUDGE/SUPERIOR COURT,John  YOUNGE,"Steelton--2nd Ward, 2nd Precinct",19,0,0,0,19,12779,233,7,0,13019
JUDGE/SUPERIOR COURT,John  YOUNGE,"Steelton--3rd Ward, 1st Precinct",25,0,0,0,25,12779,233,7,0,13019
JUDGE/SUPERIOR COURT,John  YOUNGE,"Steelton--3rd Ward, 2nd Precinct",58,0,0,0,58,12779,233,7,0,13019
JUDGE/SUPERIOR COURT,John  YOUNGE,Steelton--4th Ward,49,1,0,0,50,12779,233,7,0,13019
JUDGE/SUPERIOR COURT,John  YOUNGE,Pillow Borough,18,0,0,0,18,12779,233,7,0,13019
JUDGE/SUPERIOR COURT,John  YOUNGE,Williamstown--1st Ward,30,1,0,0,31,12779,233,7,0,13019
JUDGE/SUPERIOR COURT,John  YOUNGE,Williamstown--2nd Ward,9,0,0,0,9,12779,233,7,0,13019
JUDGE/SUPERIOR COURT,John  YOUNGE,Conewago Twp--1st Precinct,64,1,0,0,65,12779,233,7,0,13019
JUDGE/SUPERIOR COURT,John  YOUNGE,Conewago Twp--2nd Precinct,44,0,0,0,44,12779,233,7,0,13019
JUDGE/SUPERIOR COURT,John  YOUNGE,Derry Township--1st Precinct,93,1,0,0,94,12779,233,7,0,13019
JUDGE/SUPERIOR COURT,John  YOUNGE,Derry Township--2nd Precinct,74,3,0,0,77,12779,233,7,0,13019
JUDGE/SUPERIOR COURT,John  YOUNGE,Derry Township--3rd Precinct,85,2,1,0,88,12779,233,7,0,13019
JUDGE/SUPERIOR COURT,John  YOUNGE,Derry Township--4th Precinct,59,2,0,0,61,12779,233,7,0,13019
JUDGE/SUPERIOR COURT,John  YOUNGE,Derry Township--5th Precinct,44,0,0,0,44,12779,233,7,0,13019
JUDGE/SUPERIOR COURT,John  YOUNGE,Derry Township--6th Precinct,51,0,0,0,51,12779,233,7,0,13019
JUDGE/SUPERIOR COURT,John  YOUNGE,Derry Township--7th Precinct,92,2,0,0,94,12779,233,7,0,13019
JUDGE/SUPERIOR COURT,John  YOUNGE,Derry Township--8th Precinct,51,0,0,0,51,12779,233,7,0,13019
JUDGE/SUPERIOR COURT,John  YOUNGE,Derry Township--9th Precinct,47,2,0,0,49,12779,233,7,0,13019
JUDGE/SUPERIOR COURT,John  YOUNGE,Derry Township--10th Precinct,52,2,0,0,54,12779,233,7,0,13019
JUDGE/SUPERIOR COURT,John  YOUNGE,Derry Township--11th Precinct,97,1,0,0,98,12779,233,7,0,13019
JUDGE/SUPERIOR COURT,John  YOUNGE,Derry Township--12th Precinct,50,3,0,0,53,12779,233,7,0,13019
JUDGE/SUPERIOR COURT,John  YOUNGE,Derry Township--13th Precinct,87,3,0,0,90,12779,233,7,0,13019
JUDGE/SUPERIOR COURT,John  YOUNGE,Derry Township--14th Precinct,55,1,0,0,56,12779,233,7,0,13019
JUDGE/SUPERIOR COURT,John  YOUNGE,Derry Township--15th Precinct,90,2,0,0,92,12779,233,7,0,13019
JUDGE/SUPERIOR COURT,John  YOUNGE,East Hanover Township--1st Precinct,75,1,0,0,76,12779,233,7,0,13019
JUDGE/SUPERIOR COURT,John  YOUNGE,East Hanover Township--2nd Precinct,90,2,0,0,92,12779,233,7,0,13019
JUDGE/SUPERIOR COURT,John  YOUNGE,Halifax Twp--1st Precinct,73,4,0,0,77,12779,233,7,0,13019
JUDGE/SUPERIOR COURT,John  YOUNGE,Halifax Twp--2nd Precinct,69,2,0,0,71,12779,233,7,0,13019
JUDGE/SUPERIOR COURT,John  YOUNGE,Jackson Township,78,0,0,0,78,12779,233,7,0,13019
JUDGE/SUPERIOR COURT,John  YOUNGE,Jefferson Township,23,0,0,0,23,12779,233,7,0,13019
JUDGE/SUPERIOR COURT,John  YOUNGE,Londonderry Twp--1st Precinct,59,0,0,0,59,12779,233,7,0,13019
JUDGE/SUPERIOR COURT,John  YOUNGE,Londonderry Twp--2nd Precinct,71,0,0,0,71,12779,233,7,0,13019
JUDGE/SUPERIOR COURT,John  YOUNGE,Londonderry Twp--3rd Precinct,35,0,0,0,35,12779,233,7,0,13019
JUDGE/SUPERIOR COURT,John  YOUNGE,Lower Paxton Twp--1st Precinct,66,0,0,0,66,12779,233,7,0,13019
JUDGE/SUPERIOR COURT,John  YOUNGE,Lower Paxton Twp--2nd Precinct,88,4,0,0,92,12779,233,7,0,13019
JUDGE/SUPERIOR COURT,John  YOUNGE,Lower Paxton Twp--3rd precinct,112,2,0,0,114,12779,233,7,0,13019
JUDGE/SUPERIOR COURT,John  YOUNGE,Lower Paxton Twp--4th Precinct,94,1,0,0,95,12779,233,7,0,13019
JUDGE/SUPERIOR COURT,John  YOUNGE,Lower Paxton Twp--5th Precinct,88,0,1,0,89,12779,233,7,0,13019
JUDGE/SUPERIOR COURT,John  YOUNGE,Lower Paxton Twp--6th Precinct,88,0,0,0,88,12779,233,7,0,13019
JUDGE/SUPERIOR COURT,John  YOUNGE,Lower Paxton Twp--7th Precinct,103,1,0,0,104,12779,233,7,0,13019
JUDGE/SUPERIOR COURT,John  YOUNGE,Lower Paxton Twp--8th Precinct,69,1,0,0,70,12779,233,7,0,13019
JUDGE/SUPERIOR COURT,John  YOUNGE,Lower Paxton Twp--9th Precinct,58,3,0,0,61,12779,233,7,0,13019
JUDGE/SUPERIOR COURT,John  YOUNGE,Lower Paxton Twp--10th Precinct,83,4,0,0,87,12779,233,7,0,13019
JUDGE/SUPERIOR COURT,John  YOUNGE,Lower Paxton Twp--11th Precinct,75,2,0,0,77,12779,233,7,0,13019
JUDGE/SUPERIOR COURT,John  YOUNGE,Lower Paxton Twp--12th Precinct,96,1,0,0,97,12779,233,7,0,13019
JUDGE/SUPERIOR COURT,John  YOUNGE,Lower Paxton Twp--13th Precinct,109,3,0,0,112,12779,233,7,0,13019
JUDGE/SUPERIOR COURT,John  YOUNGE,Lower Paxton Twp--14th Precinct,73,1,0,0,74,12779,233,7,0,13019
JUDGE/SUPERIOR COURT,John  YOUNGE,Lower Paxton Twp--15th Precinct,86,0,0,0,86,12779,233,7,0,13019
JUDGE/SUPERIOR COURT,John  YOUNGE,Lower Paxton Twp--16th Precinct,135,1,0,0,136,12779,233,7,0,13019
JUDGE/SUPERIOR COURT,John  YOUNGE,Lower Paxton Twp--17th Precinct,83,1,0,0,84,12779,233,7,0,13019
JUDGE/SUPERIOR COURT,John  YOUNGE,Lower Paxton Twp--18th Precinct,80,0,0,0,80,12779,233,7,0,13019
JUDGE/SUPERIOR COURT,John  YOUNGE,Lower Paxton Twp--19th Precinct,128,3,0,0,131,12779,233,7,0,13019
JUDGE/SUPERIOR COURT,John  YOUNGE,Lower Paxton Twp--20th Precinct,81,0,0,0,81,12779,233,7,0,13019
JUDGE/SUPERIOR COURT,John  YOUNGE,Lower Paxton Twp--21st Precinct,138,5,0,0,143,12779,233,7,0,13019
JUDGE/SUPERIOR COURT,John  YOUNGE,Lower Paxton Twp--22nd Precinct,81,0,0,0,81,12779,233,7,0,13019
JUDGE/SUPERIOR COURT,John  YOUNGE,Lower Paxton Twp--23rd Precinct,69,0,0,0,69,12779,233,7,0,13019
JUDGE/SUPERIOR COURT,John  YOUNGE,Lower Paxton Twp--24th Precinct,86,2,0,0,88,12779,233,7,0,13019
JUDGE/SUPERIOR COURT,John  YOUNGE,Lower Paxton Twp--25th Precinct,73,1,0,0,74,12779,233,7,0,13019
JUDGE/SUPERIOR COURT,John  YOUNGE,Lower Paxton Twp--26th Precinct,115,4,0,0,119,12779,233,7,0,13019
JUDGE/SUPERIOR COURT,John  YOUNGE,Lower Paxton Twp--27th Precinct,87,1,0,0,88,12779,233,7,0,13019
JUDGE/SUPERIOR COURT,John  YOUNGE,Lower Swatara Twp--1st Precinct,69,1,0,0,70,12779,233,7,0,13019
JUDGE/SUPERIOR COURT,John  YOUNGE,Lower Swatara Twp--2nd Precinct,79,3,0,0,82,12779,233,7,0,13019
JUDGE/SUPERIOR COURT,John  YOUNGE,Lower Swatara Twp--3rd Precinct,85,9,0,0,94,12779,233,7,0,13019
JUDGE/SUPERIOR COURT,John  YOUNGE,Lower Swatara Twp--4th Precinct,73,0,0,0,73,12779,233,7,0,13019
JUDGE/SUPERIOR COURT,John  YOUNGE,Lykens Township,18,0,0,0,18,12779,233,7,0,13019
JUDGE/SUPERIOR COURT,John  YOUNGE,Middle Paxton Twp--1st Precinct,85,0,0,0,85,12779,233,7,0,13019
JUDGE/SUPERIOR COURT,John  YOUNGE,Middle Paxton Twp--2nd Precinct,86,0,0,0,86,12779,233,7,0,13019
JUDGE/SUPERIOR COURT,John  YOUNGE,Middle Paxton Twp--3rd Precinct,80,0,0,0,80,12779,233,7,0,13019
JUDGE/SUPERIOR COURT,John  YOUNGE,Mifflin Township,13,0,0,0,13,12779,233,7,0,13019
JUDGE/SUPERIOR COURT,John  YOUNGE,Reed Township,11,0,0,0,11,12779,233,7,0,13019
JUDGE/SUPERIOR COURT,John  YOUNGE,Rush Township,9,0,0,0,9,12779,233,7,0,13019
JUDGE/SUPERIOR COURT,John  YOUNGE,South Hanover Twp--1st Precinct,59,0,0,0,59,12779,233,7,0,13019
JUDGE/SUPERIOR COURT,John  YOUNGE,South Hanover Twp--2nd Precinct,109,4,0,0,113,12779,233,7,0,13019
JUDGE/SUPERIOR COURT,John  YOUNGE,South Hanover Twp--3rd Precinct,56,0,0,0,56,12779,233,7,0,13019
JUDGE/SUPERIOR COURT,John  YOUNGE,Susquehanna Twp--1st Ward,252,7,0,0,259,12779,233,7,0,13019
JUDGE/SUPERIOR COURT,John  YOUNGE,Susquehanna Twp--2nd Ward,278,10,0,0,288,12779,233,7,0,13019
JUDGE/SUPERIOR COURT,John  YOUNGE,Susquehanna Twp--3rd Ward,179,4,0,0,183,12779,233,7,0,13019
JUDGE/SUPERIOR COURT,John  YOUNGE,Susquehanna Twp--4th Ward,151,1,0,0,152,12779,233,7,0,13019
JUDGE/SUPERIOR COURT,John  YOUNGE,Susquehanna Twp--5th Ward,132,1,0,0,133,12779,233,7,0,13019
JUDGE/SUPERIOR COURT,John  YOUNGE,Susquehanna Twp--6th Ward,139,2,0,0,141,12779,233,7,0,13019
JUDGE/SUPERIOR COURT,John  YOUNGE,Susquehanna Twp--7th Ward,91,0,0,0,91,12779,233,7,0,13019
JUDGE/SUPERIOR COURT,John  YOUNGE,Susquehanna Twp--8th Ward,248,10,0,0,258,12779,233,7,0,13019
JUDGE/SUPERIOR COURT,John  YOUNGE,Susquehanna Twp--9th Ward,220,0,0,0,220,12779,233,7,0,13019
JUDGE/SUPERIOR COURT,John  YOUNGE,Swatara Township--1st Ward,124,1,0,0,125,12779,233,7,0,13019
JUDGE/SUPERIOR COURT,John  YOUNGE,Swatara Township--2nd Ward,93,12,0,0,105,12779,233,7,0,13019
JUDGE/SUPERIOR COURT,John  YOUNGE,Swatara Township--3rd Ward,95,0,0,0,95,12779,233,7,0,13019
JUDGE/SUPERIOR COURT,John  YOUNGE,Swatara Township--4th Ward,111,1,0,0,112,12779,233,7,0,13019
JUDGE/SUPERIOR COURT,John  YOUNGE,Swatara Township--5th Ward,142,1,0,0,143,12779,233,7,0,13019
JUDGE/SUPERIOR COURT,John  YOUNGE,Swatara Township--6th Ward,142,1,0,0,143,12779,233,7,0,13019
JUDGE/SUPERIOR COURT,John  YOUNGE,Swatara Township--7th Ward,178,3,0,0,181,12779,233,7,0,13019
JUDGE/SUPERIOR COURT,John  YOUNGE,Swatara Township--8th Ward,140,1,0,0,141,12779,233,7,0,13019
JUDGE/SUPERIOR COURT,John  YOUNGE,Swatara Township--9th Ward,91,4,0,0,95,12779,233,7,0,13019
JUDGE/SUPERIOR COURT,John  YOUNGE,Upper Paxton Twp--1st Precinct,59,0,0,0,59,12779,233,7,0,13019
JUDGE/SUPERIOR COURT,John  YOUNGE,Upper Paxton Twp--2nd Precinct,47,0,0,0,47,12779,233,7,0,13019
JUDGE/SUPERIOR COURT,John  YOUNGE,Washington Township,57,1,0,0,58,12779,233,7,0,13019
JUDGE/SUPERIOR COURT,John  YOUNGE,Wayne Township,55,0,0,0,55,12779,233,7,0,13019
JUDGE/SUPERIOR COURT,John  YOUNGE,West Hanover Twp--1st Precinct,59,0,0,0,59,12779,233,7,0,13019
JUDGE/SUPERIOR COURT,John  YOUNGE,West Hanover Twp--2nd Precinct,85,0,0,0,85,12779,233,7,0,13019
JUDGE/SUPERIOR COURT,John  YOUNGE,West Hanover Twp--3rd Precinct,189,4,1,0,194,12779,233,7,0,13019
JUDGE/SUPERIOR COURT,John  YOUNGE,West Hanover Twp--4th Precinct,94,1,0,0,95,12779,233,7,0,13019
JUDGE/SUPERIOR COURT,John  YOUNGE,Wiconisco Twp--1st Precinct,24,0,0,0,24,12779,233,7,0,13019
JUDGE/SUPERIOR COURT,John  YOUNGE,Wiconisco Twp--2nd Precinct,19,0,0,0,19,12779,233,7,0,13019
JUDGE/SUPERIOR COURT,John  YOUNGE,Williams Twp,25,0,0,0,25,12779,233,7,0,13019
JUDGE/SUPERIOR COURT,Ron  FOLINO,"City--1st Ward, 1st Precinct",47,1,0,0,48,12183,242,7,0,12432
JUDGE/SUPERIOR COURT,Ron  FOLINO,"City--1st Ward, 2nd Precinct",76,1,1,0,78,12183,242,7,0,12432
JUDGE/SUPERIOR COURT,Ron  FOLINO,"City--1st Ward, 3rd Precinct",49,1,0,0,50,12183,242,7,0,12432
JUDGE/SUPERIOR COURT,Ron  FOLINO,"City--2nd Ward, 1st Precinct",20,0,0,0,20,12183,242,7,0,12432
JUDGE/SUPERIOR COURT,Ron  FOLINO,"City--2nd Ward, 2nd Precinct",47,0,0,0,47,12183,242,7,0,12432
JUDGE/SUPERIOR COURT,Ron  FOLINO,City--3rd Ward,67,1,0,0,68,12183,242,7,0,12432
JUDGE/SUPERIOR COURT,Ron  FOLINO,City--4th Ward,106,3,0,0,109,12183,242,7,0,12432
JUDGE/SUPERIOR COURT,Ron  FOLINO,City--5th Ward,192,6,0,0,198,12183,242,7,0,12432
JUDGE/SUPERIOR COURT,Ron  FOLINO,City--6th Ward,97,1,3,0,101,12183,242,7,0,12432
JUDGE/SUPERIOR COURT,Ron  FOLINO,"City--7th Ward, 1st Precinct",35,1,0,0,36,12183,242,7,0,12432
JUDGE/SUPERIOR COURT,Ron  FOLINO,"City--7th Ward, 2nd Precinct",89,0,0,0,89,12183,242,7,0,12432
JUDGE/SUPERIOR COURT,Ron  FOLINO,City--8th Ward,85,1,0,0,86,12183,242,7,0,12432
JUDGE/SUPERIOR COURT,Ron  FOLINO,"City--9th Ward, 1st Precinct",32,2,0,0,34,12183,242,7,0,12432
JUDGE/SUPERIOR COURT,Ron  FOLINO,"City--9th Ward, 2nd Precinct",65,1,0,0,66,12183,242,7,0,12432
JUDGE/SUPERIOR COURT,Ron  FOLINO,"City--9th Ward, 3rd Precinct",109,1,0,0,110,12183,242,7,0,12432
JUDGE/SUPERIOR COURT,Ron  FOLINO,"City--9th Ward, 4th Precinct",99,0,0,0,99,12183,242,7,0,12432
JUDGE/SUPERIOR COURT,Ron  FOLINO,"City--9th Ward, 5th Precinct",68,4,0,0,72,12183,242,7,0,12432
JUDGE/SUPERIOR COURT,Ron  FOLINO,"City--10th Ward, 1st Precinct",143,0,0,0,143,12183,242,7,0,12432
JUDGE/SUPERIOR COURT,Ron  FOLINO,"City--10th Ward, 2nd Precinct",62,0,0,0,62,12183,242,7,0,12432
JUDGE/SUPERIOR COURT,Ron  FOLINO,"City--10th Ward, 3rd Precinct",49,0,0,0,49,12183,242,7,0,12432
JUDGE/SUPERIOR COURT,Ron  FOLINO,"City--10th Ward, 4th Precinct",71,0,0,0,71,12183,242,7,0,12432
JUDGE/SUPERIOR COURT,Ron  FOLINO,City--11th Ward,66,13,0,0,79,12183,242,7,0,12432
JUDGE/SUPERIOR COURT,Ron  FOLINO,City--12th Ward,166,5,0,0,171,12183,242,7,0,12432
JUDGE/SUPERIOR COURT,Ron  FOLINO,"City--13th Ward, 1st Precinct",63,0,0,0,63,12183,242,7,0,12432
JUDGE/SUPERIOR COURT,Ron  FOLINO,"City--13th Ward, 2nd Precinct",69,0,0,0,69,12183,242,7,0,12432
JUDGE/SUPERIOR COURT,Ron  FOLINO,"City--13th Ward, 3rd Precinct",91,1,0,0,92,12183,242,7,0,12432
JUDGE/SUPERIOR COURT,Ron  FOLINO,City--14th Ward,179,5,0,0,184,12183,242,7,0,12432
JUDGE/SUPERIOR COURT,Ron  FOLINO,City--15th Ward,50,1,0,0,51,12183,242,7,0,12432
JUDGE/SUPERIOR COURT,Ron  FOLINO,Berrysburg Borough,16,0,0,0,16,12183,242,7,0,12432
JUDGE/SUPERIOR COURT,Ron  FOLINO,Dauphin Borough,51,1,0,0,52,12183,242,7,0,12432
JUDGE/SUPERIOR COURT,Ron  FOLINO,Elizabethville Borough,46,2,0,0,48,12183,242,7,0,12432
JUDGE/SUPERIOR COURT,Ron  FOLINO,Gratz Borough,17,0,0,0,17,12183,242,7,0,12432
JUDGE/SUPERIOR COURT,Ron  FOLINO,Halifax Borough,17,1,0,0,18,12183,242,7,0,12432
JUDGE/SUPERIOR COURT,Ron  FOLINO,Highspire--1st Precinct,45,2,0,0,47,12183,242,7,0,12432
JUDGE/SUPERIOR COURT,Ron  FOLINO,Highspire--2nd Precinct,51,0,0,0,51,12183,242,7,0,12432
JUDGE/SUPERIOR COURT,Ron  FOLINO,Hummelstown--1st Precinct,67,1,0,0,68,12183,242,7,0,12432
JUDGE/SUPERIOR COURT,Ron  FOLINO,Hummelstown--2nd Precinct,105,3,0,0,108,12183,242,7,0,12432
JUDGE/SUPERIOR COURT,Ron  FOLINO,Lykens Borough--1st Ward,34,1,0,0,35,12183,242,7,0,12432
JUDGE/SUPERIOR COURT,Ron  FOLINO,Lykens Borough--2nd Ward,39,2,0,0,41,12183,242,7,0,12432
JUDGE/SUPERIOR COURT,Ron  FOLINO,"Middletown--1st Ward, 1st Precinct",24,0,0,0,24,12183,242,7,0,12432
JUDGE/SUPERIOR COURT,Ron  FOLINO,"Middletown--1st Ward, 2nd Precinct",51,1,0,0,52,12183,242,7,0,12432
JUDGE/SUPERIOR COURT,Ron  FOLINO,"Middletown--2nd Ward, 1st Precinct",64,0,0,0,64,12183,242,7,0,12432
JUDGE/SUPERIOR COURT,Ron  FOLINO,"Middletown--2nd Ward, 2nd Precinct",42,1,0,0,43,12183,242,7,0,12432
JUDGE/SUPERIOR COURT,Ron  FOLINO,"Middletown--3rd Ward, 1st Precinct",30,1,0,0,31,12183,242,7,0,12432
JUDGE/SUPERIOR COURT,Ron  FOLINO,"Middletown--3rd Ward, 2nd Precinct",53,0,0,0,53,12183,242,7,0,12432
JUDGE/SUPERIOR COURT,Ron  FOLINO,Millersburg--1st Ward,21,1,0,0,22,12183,242,7,0,12432
JUDGE/SUPERIOR COURT,Ron  FOLINO,Millersburg--2nd Ward,30,0,0,0,30,12183,242,7,0,12432
JUDGE/SUPERIOR COURT,Ron  FOLINO,Paxtang Borough,103,3,0,0,106,12183,242,7,0,12432
JUDGE/SUPERIOR COURT,Ron  FOLINO,Penbrook Borough--1st Ward,28,0,0,0,28,12183,242,7,0,12432
JUDGE/SUPERIOR COURT,Ron  FOLINO,Penbrook Borough--2nd Ward,30,0,0,0,30,12183,242,7,0,12432
JUDGE/SUPERIOR COURT,Ron  FOLINO,Penbrook Borough--3rd Ward,21,0,0,0,21,12183,242,7,0,12432
JUDGE/SUPERIOR COURT,Ron  FOLINO,Penbrook Borough--4th Ward,34,0,0,0,34,12183,242,7,0,12432
JUDGE/SUPERIOR COURT,Ron  FOLINO,Royalton Borough--1st Ward,20,0,0,0,20,12183,242,7,0,12432
JUDGE/SUPERIOR COURT,Ron  FOLINO,Royalton Borough--2nd Ward,21,0,0,0,21,12183,242,7,0,12432
JUDGE/SUPERIOR COURT,Ron  FOLINO,Steelton--1st Ward,54,3,0,0,57,12183,242,7,0,12432
JUDGE/SUPERIOR COURT,Ron  FOLINO,"Steelton--2nd Ward, 1st Precinct",67,0,0,0,67,12183,242,7,0,12432
JUDGE/SUPERIOR COURT,Ron  FOLINO,"Steelton--2nd Ward, 2nd Precinct",23,0,0,0,23,12183,242,7,0,12432
JUDGE/SUPERIOR COURT,Ron  FOLINO,"Steelton--3rd Ward, 1st Precinct",28,0,0,0,28,12183,242,7,0,12432
JUDGE/SUPERIOR COURT,Ron  FOLINO,"Steelton--3rd Ward, 2nd Precinct",53,0,0,0,53,12183,242,7,0,12432
JUDGE/SUPERIOR COURT,Ron  FOLINO,Steelton--4th Ward,47,0,1,0,48,12183,242,7,0,12432
JUDGE/SUPERIOR COURT,Ron  FOLINO,Pillow Borough,15,0,0,0,15,12183,242,7,0,12432
JUDGE/SUPERIOR COURT,Ron  FOLINO,Williamstown--1st Ward,31,0,0,0,31,12183,242,7,0,12432
JUDGE/SUPERIOR COURT,Ron  FOLINO,Williamstown--2nd Ward,15,0,0,0,15,12183,242,7,0,12432
JUDGE/SUPERIOR COURT,Ron  FOLINO,Conewago Twp--1st Precinct,63,1,0,0,64,12183,242,7,0,12432
JUDGE/SUPERIOR COURT,Ron  FOLINO,Conewago Twp--2nd Precinct,35,0,0,0,35,12183,242,7,0,12432
JUDGE/SUPERIOR COURT,Ron  FOLINO,Derry Township--1st Precinct,105,1,0,0,106,12183,242,7,0,12432
JUDGE/SUPERIOR COURT,Ron  FOLINO,Derry Township--2nd Precinct,75,3,0,0,78,12183,242,7,0,12432
JUDGE/SUPERIOR COURT,Ron  FOLINO,Derry Township--3rd Precinct,98,2,1,0,101,12183,242,7,0,12432
JUDGE/SUPERIOR COURT,Ron  FOLINO,Derry Township--4th Precinct,58,1,0,0,59,12183,242,7,0,12432
JUDGE/SUPERIOR COURT,Ron  FOLINO,Derry Township--5th Precinct,49,0,0,0,49,12183,242,7,0,12432
JUDGE/SUPERIOR COURT,Ron  FOLINO,Derry Township--6th Precinct,54,1,0,0,55,12183,242,7,0,12432
JUDGE/SUPERIOR COURT,Ron  FOLINO,Derry Township--7th Precinct,96,2,0,0,98,12183,242,7,0,12432
JUDGE/SUPERIOR COURT,Ron  FOLINO,Derry Township--8th Precinct,56,0,0,0,56,12183,242,7,0,12432
JUDGE/SUPERIOR COURT,Ron  FOLINO,Derry Township--9th Precinct,42,1,0,0,43,12183,242,7,0,12432
JUDGE/SUPERIOR COURT,Ron  FOLINO,Derry Township--10th Precinct,57,2,0,0,59,12183,242,7,0,12432
JUDGE/SUPERIOR COURT,Ron  FOLINO,Derry Township--11th Precinct,111,2,0,0,113,12183,242,7,0,12432
JUDGE/SUPERIOR COURT,Ron  FOLINO,Derry Township--12th Precinct,58,3,0,0,61,12183,242,7,0,12432
JUDGE/SUPERIOR COURT,Ron  FOLINO,Derry Township--13th Precinct,87,2,0,0,89,12183,242,7,0,12432
JUDGE/SUPERIOR COURT,Ron  FOLINO,Derry Township--14th Precinct,55,2,0,0,57,12183,242,7,0,12432
JUDGE/SUPERIOR COURT,Ron  FOLINO,Derry Township--15th Precinct,96,3,0,0,99,12183,242,7,0,12432
JUDGE/SUPERIOR COURT,Ron  FOLINO,East Hanover Township--1st Precinct,77,2,0,0,79,12183,242,7,0,12432
JUDGE/SUPERIOR COURT,Ron  FOLINO,East Hanover Township--2nd Precinct,90,3,0,0,93,12183,242,7,0,12432
JUDGE/SUPERIOR COURT,Ron  FOLINO,Halifax Twp--1st Precinct,65,3,0,0,68,12183,242,7,0,12432
JUDGE/SUPERIOR COURT,Ron  FOLINO,Halifax Twp--2nd Precinct,61,2,0,0,63,12183,242,7,0,12432
JUDGE/SUPERIOR COURT,Ron  FOLINO,Jackson Township,56,0,0,0,56,12183,242,7,0,12432
JUDGE/SUPERIOR COURT,Ron  FOLINO,Jefferson Township,17,0,0,0,17,12183,242,7,0,12432
JUDGE/SUPERIOR COURT,Ron  FOLINO,Londonderry Twp--1st Precinct,63,0,0,0,63,12183,242,7,0,12432
JUDGE/SUPERIOR COURT,Ron  FOLINO,Londonderry Twp--2nd Precinct,71,0,0,0,71,12183,242,7,0,12432
JUDGE/SUPERIOR COURT,Ron  FOLINO,Londonderry Twp--3rd Precinct,30,0,0,0,30,12183,242,7,0,12432
JUDGE/SUPERIOR COURT,Ron  FOLINO,Lower Paxton Twp--1st Precinct,66,0,0,0,66,12183,242,7,0,12432
JUDGE/SUPERIOR COURT,Ron  FOLINO,Lower Paxton Twp--2nd Precinct,78,5,0,0,83,12183,242,7,0,12432
JUDGE/SUPERIOR COURT,Ron  FOLINO,Lower Paxton Twp--3rd precinct,126,3,0,0,129,12183,242,7,0,12432
JUDGE/SUPERIOR COURT,Ron  FOLINO,Lower Paxton Twp--4th Precinct,87,1,0,0,88,12183,242,7,0,12432
JUDGE/SUPERIOR COURT,Ron  FOLINO,Lower Paxton Twp--5th Precinct,91,0,0,0,91,12183,242,7,0,12432
JUDGE/SUPERIOR COURT,Ron  FOLINO,Lower Paxton Twp--6th Precinct,88,1,0,0,89,12183,242,7,0,12432
JUDGE/SUPERIOR COURT,Ron  FOLINO,Lower Paxton Twp--7th Precinct,93,1,0,0,94,12183,242,7,0,12432
JUDGE/SUPERIOR COURT,Ron  FOLINO,Lower Paxton Twp--8th Precinct,72,1,0,0,73,12183,242,7,0,12432
JUDGE/SUPERIOR COURT,Ron  FOLINO,Lower Paxton Twp--9th Precinct,57,0,0,0,57,12183,242,7,0,12432
JUDGE/SUPERIOR COURT,Ron  FOLINO,Lower Paxton Twp--10th Precinct,72,3,0,0,75,12183,242,7,0,12432
JUDGE/SUPERIOR COURT,Ron  FOLINO,Lower Paxton Twp--11th Precinct,70,2,0,0,72,12183,242,7,0,12432
JUDGE/SUPERIOR COURT,Ron  FOLINO,Lower Paxton Twp--12th Precinct,102,1,0,0,103,12183,242,7,0,12432
JUDGE/SUPERIOR COURT,Ron  FOLINO,Lower Paxton Twp--13th Precinct,111,1,0,0,112,12183,242,7,0,12432
JUDGE/SUPERIOR COURT,Ron  FOLINO,Lower Paxton Twp--14th Precinct,70,2,0,0,72,12183,242,7,0,12432
JUDGE/SUPERIOR COURT,Ron  FOLINO,Lower Paxton Twp--15th Precinct,97,0,0,0,97,12183,242,7,0,12432
JUDGE/SUPERIOR COURT,Ron  FOLINO,Lower Paxton Twp--16th Precinct,136,0,0,0,136,12183,242,7,0,12432
JUDGE/SUPERIOR COURT,Ron  FOLINO,Lower Paxton Twp--17th Precinct,86,3,0,0,89,12183,242,7,0,12432
JUDGE/SUPERIOR COURT,Ron  FOLINO,Lower Paxton Twp--18th Precinct,83,1,0,0,84,12183,242,7,0,12432
JUDGE/SUPERIOR COURT,Ron  FOLINO,Lower Paxton Twp--19th Precinct,147,4,0,0,151,12183,242,7,0,12432
JUDGE/SUPERIOR COURT,Ron  FOLINO,Lower Paxton Twp--20th Precinct,86,0,0,0,86,12183,242,7,0,12432
JUDGE/SUPERIOR COURT,Ron  FOLINO,Lower Paxton Twp--21st Precinct,129,8,0,0,137,12183,242,7,0,12432
JUDGE/SUPERIOR COURT,Ron  FOLINO,Lower Paxton Twp--22nd Precinct,85,0,0,0,85,12183,242,7,0,12432
JUDGE/SUPERIOR COURT,Ron  FOLINO,Lower Paxton Twp--23rd Precinct,58,0,0,0,58,12183,242,7,0,12432
JUDGE/SUPERIOR COURT,Ron  FOLINO,Lower Paxton Twp--24th Precinct,89,2,0,0,91,12183,242,7,0,12432
JUDGE/SUPERIOR COURT,Ron  FOLINO,Lower Paxton Twp--25th Precinct,81,1,0,0,82,12183,242,7,0,12432
JUDGE/SUPERIOR COURT,Ron  FOLINO,Lower Paxton Twp--26th Precinct,102,3,0,0,105,12183,242,7,0,12432
JUDGE/SUPERIOR COURT,Ron  FOLINO,Lower Paxton Twp--27th Precinct,87,0,0,0,87,12183,242,7,0,12432
JUDGE/SUPERIOR COURT,Ron  FOLINO,Lower Swatara Twp--1st Precinct,74,1,0,0,75,12183,242,7,0,12432
JUDGE/SUPERIOR COURT,Ron  FOLINO,Lower Swatara Twp--2nd Precinct,79,2,0,0,81,12183,242,7,0,12432
JUDGE/SUPERIOR COURT,Ron  FOLINO,Lower Swatara Twp--3rd Precinct,92,9,0,0,101,12183,242,7,0,12432
JUDGE/SUPERIOR COURT,Ron  FOLINO,Lower Swatara Twp--4th Precinct,66,0,0,0,66,12183,242,7,0,12432
JUDGE/SUPERIOR COURT,Ron  FOLINO,Lykens Township,16,0,0,0,16,12183,242,7,0,12432
JUDGE/SUPERIOR COURT,Ron  FOLINO,Middle Paxton Twp--1st Precinct,87,0,0,0,87,12183,242,7,0,12432
JUDGE/SUPERIOR COURT,Ron  FOLINO,Middle Paxton Twp--2nd Precinct,85,0,0,0,85,12183,242,7,0,12432
JUDGE/SUPERIOR COURT,Ron  FOLINO,Middle Paxton Twp--3rd Precinct,82,0,0,0,82,12183,242,7,0,12432
JUDGE/SUPERIOR COURT,Ron  FOLINO,Mifflin Township,16,0,0,0,16,12183,242,7,0,12432
JUDGE/SUPERIOR COURT,Ron  FOLINO,Reed Township,13,0,0,0,13,12183,242,7,0,12432
JUDGE/SUPERIOR COURT,Ron  FOLINO,Rush Township,9,0,0,0,9,12183,242,7,0,12432
JUDGE/SUPERIOR COURT,Ron  FOLINO,South Hanover Twp--1st Precinct,60,2,0,0,62,12183,242,7,0,12432
JUDGE/SUPERIOR COURT,Ron  FOLINO,South Hanover Twp--2nd Precinct,114,2,0,0,116,12183,242,7,0,12432
JUDGE/SUPERIOR COURT,Ron  FOLINO,South Hanover Twp--3rd Precinct,49,0,0,0,49,12183,242,7,0,12432
JUDGE/SUPERIOR COURT,Ron  FOLINO,Susquehanna Twp--1st Ward,239,7,0,0,246,12183,242,7,0,12432
JUDGE/SUPERIOR COURT,Ron  FOLINO,Susquehanna Twp--2nd Ward,265,12,0,0,277,12183,242,7,0,12432
JUDGE/SUPERIOR COURT,Ron  FOLINO,Susquehanna Twp--3rd Ward,147,4,0,0,151,12183,242,7,0,12432
JUDGE/SUPERIOR COURT,Ron  FOLINO,Susquehanna Twp--4th Ward,152,1,0,0,153,12183,242,7,0,12432
JUDGE/SUPERIOR COURT,Ron  FOLINO,Susquehanna Twp--5th Ward,134,2,0,0,136,12183,242,7,0,12432
JUDGE/SUPERIOR COURT,Ron  FOLINO,Susquehanna Twp--6th Ward,144,4,0,0,148,12183,242,7,0,12432
JUDGE/SUPERIOR COURT,Ron  FOLINO,Susquehanna Twp--7th Ward,96,0,0,0,96,12183,242,7,0,12432
JUDGE/SUPERIOR COURT,Ron  FOLINO,Susquehanna Twp--8th Ward,218,11,0,0,229,12183,242,7,0,12432
JUDGE/SUPERIOR COURT,Ron  FOLINO,Susquehanna Twp--9th Ward,205,1,0,0,206,12183,242,7,0,12432
JUDGE/SUPERIOR COURT,Ron  FOLINO,Swatara Township--1st Ward,134,2,0,0,136,12183,242,7,0,12432
JUDGE/SUPERIOR COURT,Ron  FOLINO,Swatara Township--2nd Ward,86,11,0,0,97,12183,242,7,0,12432
JUDGE/SUPERIOR COURT,Ron  FOLINO,Swatara Township--3rd Ward,100,1,0,0,101,12183,242,7,0,12432
JUDGE/SUPERIOR COURT,Ron  FOLINO,Swatara Township--4th Ward,125,2,0,0,127,12183,242,7,0,12432
JUDGE/SUPERIOR COURT,Ron  FOLINO,Swatara Township--5th Ward,142,1,0,0,143,12183,242,7,0,12432
JUDGE/SUPERIOR COURT,Ron  FOLINO,Swatara Township--6th Ward,157,1,0,0,158,12183,242,7,0,12432
JUDGE/SUPERIOR COURT,Ron  FOLINO,Swatara Township--7th Ward,181,3,0,0,184,12183,242,7,0,12432
JUDGE/SUPERIOR COURT,Ron  FOLINO,Swatara Township--8th Ward,153,2,0,0,155,12183,242,7,0,12432
JUDGE/SUPERIOR COURT,Ron  FOLINO,Swatara Township--9th Ward,91,3,0,0,94,12183,242,7,0,12432
JUDGE/SUPERIOR COURT,Ron  FOLINO,Upper Paxton Twp--1st Precinct,60,0,0,0,60,12183,242,7,0,12432
JUDGE/SUPERIOR COURT,Ron  FOLINO,Upper Paxton Twp--2nd Precinct,37,0,0,0,37,12183,242,7,0,12432
JUDGE/SUPERIOR COURT,Ron  FOLINO,Washington Township,57,1,0,0,58,12183,242,7,0,12432
JUDGE/SUPERIOR COURT,Ron  FOLINO,Wayne Township,55,0,0,0,55,12183,242,7,0,12432
JUDGE/SUPERIOR COURT,Ron  FOLINO,West Hanover Twp--1st Precinct,68,1,0,0,69,12183,242,7,0,12432
JUDGE/SUPERIOR COURT,Ron  FOLINO,West Hanover Twp--2nd Precinct,81,0,0,0,81,12183,242,7,0,12432
JUDGE/SUPERIOR COURT,Ron  FOLINO,West Hanover Twp--3rd Precinct,192,4,1,0,197,12183,242,7,0,12432
JUDGE/SUPERIOR COURT,Ron  FOLINO,West Hanover Twp--4th Precinct,92,1,0,0,93,12183,242,7,0,12432
JUDGE/SUPERIOR COURT,Ron  FOLINO,Wiconisco Twp--1st Precinct,28,0,0,0,28,12183,242,7,0,12432
JUDGE/SUPERIOR COURT,Ron  FOLINO,Wiconisco Twp--2nd Precinct,18,0,0,0,18,12183,242,7,0,12432
JUDGE/SUPERIOR COURT,Ron  FOLINO,Williams Twp,25,0,0,0,25,12183,242,7,0,12432
JUDGE/SUPERIOR COURT,Write In  ,"City--1st Ward, 1st Precinct",0,0,0,0,0,33,0,0,0,33
JUDGE/SUPERIOR COURT,Write In  ,"City--1st Ward, 2nd Precinct",0,0,0,0,0,33,0,0,0,33
JUDGE/SUPERIOR COURT,Write In  ,"City--1st Ward, 3rd Precinct",0,0,0,0,0,33,0,0,0,33
JUDGE/SUPERIOR COURT,Write In  ,"City--2nd Ward, 1st Precinct",0,0,0,0,0,33,0,0,0,33
JUDGE/SUPERIOR COURT,Write In  ,"City--2nd Ward, 2nd Precinct",0,0,0,0,0,33,0,0,0,33
JUDGE/SUPERIOR COURT,Write In  ,City--3rd Ward,0,0,0,0,0,33,0,0,0,33
JUDGE/SUPERIOR COURT,Write In  ,City--4th Ward,0,0,0,0,0,33,0,0,0,33
JUDGE/SUPERIOR COURT,Write In  ,City--5th Ward,3,0,0,0,3,33,0,0,0,33
JUDGE/SUPERIOR COURT,Write In  ,City--6th Ward,0,0,0,0,0,33,0,0,0,33
JUDGE/SUPERIOR COURT,Write In  ,"City--7th Ward, 1st Precinct",0,0,0,0,0,33,0,0,0,33
JUDGE/SUPERIOR COURT,Write In  ,"City--7th Ward, 2nd Precinct",0,0,0,0,0,33,0,0,0,33
JUDGE/SUPERIOR COURT,Write In  ,City--8th Ward,0,0,0,0,0,33,0,0,0,33
JUDGE/SUPERIOR COURT,Write In  ,"City--9th Ward, 1st Precinct",0,0,0,0,0,33,0,0,0,33
JUDGE/SUPERIOR COURT,Write In  ,"City--9th Ward, 2nd Precinct",0,0,0,0,0,33,0,0,0,33
JUDGE/SUPERIOR COURT,Write In  ,"City--9th Ward, 3rd Precinct",0,0,0,0,0,33,0,0,0,33
JUDGE/SUPERIOR COURT,Write In  ,"City--9th Ward, 4th Precinct",0,0,0,0,0,33,0,0,0,33
JUDGE/SUPERIOR COURT,Write In  ,"City--9th Ward, 5th Precinct",0,0,0,0,0,33,0,0,0,33
JUDGE/SUPERIOR COURT,Write In  ,"City--10th Ward, 1st Precinct",0,0,0,0,0,33,0,0,0,33
JUDGE/SUPERIOR COURT,Write In  ,"City--10th Ward, 2nd Precinct",0,0,0,0,0,33,0,0,0,33
JUDGE/SUPERIOR COURT,Write In  ,"City--10th Ward, 3rd Precinct",0,0,0,0,0,33,0,0,0,33
JUDGE/SUPERIOR COURT,Write In  ,"City--10th Ward, 4th Precinct",0,0,0,0,0,33,0,0,0,33
JUDGE/SUPERIOR COURT,Write In  ,City--11th Ward,0,0,0,0,0,33,0,0,0,33
JUDGE/SUPERIOR COURT,Write In  ,City--12th Ward,0,0,0,0,0,33,0,0,0,33
JUDGE/SUPERIOR COURT,Write In  ,"City--13th Ward, 1st Precinct",3,0,0,0,3,33,0,0,0,33
JUDGE/SUPERIOR COURT,Write In  ,"City--13th Ward, 2nd Precinct",0,0,0,0,0,33,0,0,0,33
JUDGE/SUPERIOR COURT,Write In  ,"City--13th Ward, 3rd Precinct",1,0,0,0,1,33,0,0,0,33
JUDGE/SUPERIOR COURT,Write In  ,City--14th Ward,0,0,0,0,0,33,0,0,0,33
JUDGE/SUPERIOR COURT,Write In  ,City--15th Ward,0,0,0,0,0,33,0,0,0,33
JUDGE/SUPERIOR COURT,Write In  ,Berrysburg Borough,0,0,0,0,0,33,0,0,0,33
JUDGE/SUPERIOR COURT,Write In  ,Dauphin Borough,0,0,0,0,0,33,0,0,0,33
JUDGE/SUPERIOR COURT,Write In  ,Elizabethville Borough,0,0,0,0,0,33,0,0,0,33
JUDGE/SUPERIOR COURT,Write In  ,Gratz Borough,0,0,0,0,0,33,0,0,0,33
JUDGE/SUPERIOR COURT,Write In  ,Halifax Borough,0,0,0,0,0,33,0,0,0,33
JUDGE/SUPERIOR COURT,Write In  ,Highspire--1st Precinct,0,0,0,0,0,33,0,0,0,33
JUDGE/SUPERIOR COURT,Write In  ,Highspire--2nd Precinct,0,0,0,0,0,33,0,0,0,33
JUDGE/SUPERIOR COURT,Write In  ,Hummelstown--1st Precinct,0,0,0,0,0,33,0,0,0,33
JUDGE/SUPERIOR COURT,Write In  ,Hummelstown--2nd Precinct,1,0,0,0,1,33,0,0,0,33
JUDGE/SUPERIOR COURT,Write In  ,Lykens Borough--1st Ward,0,0,0,0,0,33,0,0,0,33
JUDGE/SUPERIOR COURT,Write In  ,Lykens Borough--2nd Ward,0,0,0,0,0,33,0,0,0,33
JUDGE/SUPERIOR COURT,Write In  ,"Middletown--1st Ward, 1st Precinct",0,0,0,0,0,33,0,0,0,33
JUDGE/SUPERIOR COURT,Write In  ,"Middletown--1st Ward, 2nd Precinct",0,0,0,0,0,33,0,0,0,33
JUDGE/SUPERIOR COURT,Write In  ,"Middletown--2nd Ward, 1st Precinct",1,0,0,0,1,33,0,0,0,33
JUDGE/SUPERIOR COURT,Write In  ,"Middletown--2nd Ward, 2nd Precinct",0,0,0,0,0,33,0,0,0,33
JUDGE/SUPERIOR COURT,Write In  ,"Middletown--3rd Ward, 1st Precinct",0,0,0,0,0,33,0,0,0,33
JUDGE/SUPERIOR COURT,Write In  ,"Middletown--3rd Ward, 2nd Precinct",0,0,0,0,0,33,0,0,0,33
JUDGE/SUPERIOR COURT,Write In  ,Millersburg--1st Ward,0,0,0,0,0,33,0,0,0,33
JUDGE/SUPERIOR COURT,Write In  ,Millersburg--2nd Ward,1,0,0,0,1,33,0,0,0,33
JUDGE/SUPERIOR COURT,Write In  ,Paxtang Borough,0,0,0,0,0,33,0,0,0,33
JUDGE/SUPERIOR COURT,Write In  ,Penbrook Borough--1st Ward,0,0,0,0,0,33,0,0,0,33
JUDGE/SUPERIOR COURT,Write In  ,Penbrook Borough--2nd Ward,0,0,0,0,0,33,0,0,0,33
JUDGE/SUPERIOR COURT,Write In  ,Penbrook Borough--3rd Ward,0,0,0,0,0,33,0,0,0,33
JUDGE/SUPERIOR COURT,Write In  ,Penbrook Borough--4th Ward,1,0,0,0,1,33,0,0,0,33
JUDGE/SUPERIOR COURT,Write In  ,Royalton Borough--1st Ward,0,0,0,0,0,33,0,0,0,33
JUDGE/SUPERIOR COURT,Write In  ,Royalton Borough--2nd Ward,0,0,0,0,0,33,0,0,0,33
JUDGE/SUPERIOR COURT,Write In  ,Steelton--1st Ward,0,0,0,0,0,33,0,0,0,33
JUDGE/SUPERIOR COURT,Write In  ,"Steelton--2nd Ward, 1st Precinct",0,0,0,0,0,33,0,0,0,33
JUDGE/SUPERIOR COURT,Write In  ,"Steelton--2nd Ward, 2nd Precinct",0,0,0,0,0,33,0,0,0,33
JUDGE/SUPERIOR COURT,Write In  ,"Steelton--3rd Ward, 1st Precinct",0,0,0,0,0,33,0,0,0,33
JUDGE/SUPERIOR COURT,Write In  ,"Steelton--3rd Ward, 2nd Precinct",0,0,0,0,0,33,0,0,0,33
JUDGE/SUPERIOR COURT,Write In  ,Steelton--4th Ward,1,0,0,0,1,33,0,0,0,33
JUDGE/SUPERIOR COURT,Write In  ,Pillow Borough,0,0,0,0,0,33,0,0,0,33
JUDGE/SUPERIOR COURT,Write In  ,Williamstown--1st Ward,0,0,0,0,0,33,0,0,0,33
JUDGE/SUPERIOR COURT,Write In  ,Williamstown--2nd Ward,0,0,0,0,0,33,0,0,0,33
JUDGE/SUPERIOR COURT,Write In  ,Conewago Twp--1st Precinct,0,0,0,0,0,33,0,0,0,33
JUDGE/SUPERIOR COURT,Write In  ,Conewago Twp--2nd Precinct,0,0,0,0,0,33,0,0,0,33
JUDGE/SUPERIOR COURT,Write In  ,Derry Township--1st Precinct,0,0,0,0,0,33,0,0,0,33
JUDGE/SUPERIOR COURT,Write In  ,Derry Township--2nd Precinct,0,0,0,0,0,33,0,0,0,33
JUDGE/SUPERIOR COURT,Write In  ,Derry Township--3rd Precinct,0,0,0,0,0,33,0,0,0,33
JUDGE/SUPERIOR COURT,Write In  ,Derry Township--4th Precinct,0,0,0,0,0,33,0,0,0,33
JUDGE/SUPERIOR COURT,Write In  ,Derry Township--5th Precinct,0,0,0,0,0,33,0,0,0,33
JUDGE/SUPERIOR COURT,Write In  ,Derry Township--6th Precinct,0,0,0,0,0,33,0,0,0,33
JUDGE/SUPERIOR COURT,Write In  ,Derry Township--7th Precinct,1,0,0,0,1,33,0,0,0,33
JUDGE/SUPERIOR COURT,Write In  ,Derry Township--8th Precinct,0,0,0,0,0,33,0,0,0,33
JUDGE/SUPERIOR COURT,Write In  ,Derry Township--9th Precinct,0,0,0,0,0,33,0,0,0,33
JUDGE/SUPERIOR COURT,Write In  ,Derry Township--10th Precinct,0,0,0,0,0,33,0,0,0,33
JUDGE/SUPERIOR COURT,Write In  ,Derry Township--11th Precinct,0,0,0,0,0,33,0,0,0,33
JUDGE/SUPERIOR COURT,Write In  ,Derry Township--12th Precinct,0,0,0,0,0,33,0,0,0,33
JUDGE/SUPERIOR COURT,Write In  ,Derry Township--13th Precinct,1,0,0,0,1,33,0,0,0,33
JUDGE/SUPERIOR COURT,Write In  ,Derry Township--14th Precinct,0,0,0,0,0,33,0,0,0,33
JUDGE/SUPERIOR COURT,Write In  ,Derry Township--15th Precinct,0,0,0,0,0,33,0,0,0,33
JUDGE/SUPERIOR COURT,Write In  ,East Hanover Township--1st Precinct,0,0,0,0,0,33,0,0,0,33
JUDGE/SUPERIOR COURT,Write In  ,East Hanover Township--2nd Precinct,0,0,0,0,0,33,0,0,0,33
JUDGE/SUPERIOR COURT,Write In  ,Halifax Twp--1st Precinct,1,0,0,0,1,33,0,0,0,33
JUDGE/SUPERIOR COURT,Write In  ,Halifax Twp--2nd Precinct,0,0,0,0,0,33,0,0,0,33
JUDGE/SUPERIOR COURT,Write In  ,Jackson Township,0,0,0,0,0,33,0,0,0,33
JUDGE/SUPERIOR COURT,Write In  ,Jefferson Township,0,0,0,0,0,33,0,0,0,33
JUDGE/SUPERIOR COURT,Write In  ,Londonderry Twp--1st Precinct,0,0,0,0,0,33,0,0,0,33
JUDGE/SUPERIOR COURT,Write In  ,Londonderry Twp--2nd Precinct,3,0,0,0,3,33,0,0,0,33
JUDGE/SUPERIOR COURT,Write In  ,Londonderry Twp--3rd Precinct,0,0,0,0,0,33,0,0,0,33
JUDGE/SUPERIOR COURT,Write In  ,Lower Paxton Twp--1st Precinct,0,0,0,0,0,33,0,0,0,33
JUDGE/SUPERIOR COURT,Write In  ,Lower Paxton Twp--2nd Precinct,1,0,0,0,1,33,0,0,0,33
JUDGE/SUPERIOR COURT,Write In  ,Lower Paxton Twp--3rd precinct,0,0,0,0,0,33,0,0,0,33
JUDGE/SUPERIOR COURT,Write In  ,Lower Paxton Twp--4th Precinct,0,0,0,0,0,33,0,0,0,33
JUDGE/SUPERIOR COURT,Write In  ,Lower Paxton Twp--5th Precinct,1,0,0,0,1,33,0,0,0,33
JUDGE/SUPERIOR COURT,Write In  ,Lower Paxton Twp--6th Precinct,0,0,0,0,0,33,0,0,0,33
JUDGE/SUPERIOR COURT,Write In  ,Lower Paxton Twp--7th Precinct,0,0,0,0,0,33,0,0,0,33
JUDGE/SUPERIOR COURT,Write In  ,Lower Paxton Twp--8th Precinct,0,0,0,0,0,33,0,0,0,33
JUDGE/SUPERIOR COURT,Write In  ,Lower Paxton Twp--9th Precinct,0,0,0,0,0,33,0,0,0,33
JUDGE/SUPERIOR COURT,Write In  ,Lower Paxton Twp--10th Precinct,0,0,0,0,0,33,0,0,0,33
JUDGE/SUPERIOR COURT,Write In  ,Lower Paxton Twp--11th Precinct,0,0,0,0,0,33,0,0,0,33
JUDGE/SUPERIOR COURT,Write In  ,Lower Paxton Twp--12th Precinct,0,0,0,0,0,33,0,0,0,33
JUDGE/SUPERIOR COURT,Write In  ,Lower Paxton Twp--13th Precinct,3,0,0,0,3,33,0,0,0,33
JUDGE/SUPERIOR COURT,Write In  ,Lower Paxton Twp--14th Precinct,0,0,0,0,0,33,0,0,0,33
JUDGE/SUPERIOR COURT,Write In  ,Lower Paxton Twp--15th Precinct,0,0,0,0,0,33,0,0,0,33
JUDGE/SUPERIOR COURT,Write In  ,Lower Paxton Twp--16th Precinct,0,0,0,0,0,33,0,0,0,33
JUDGE/SUPERIOR COURT,Write In  ,Lower Paxton Twp--17th Precinct,2,0,0,0,2,33,0,0,0,33
JUDGE/SUPERIOR COURT,Write In  ,Lower Paxton Twp--18th Precinct,0,0,0,0,0,33,0,0,0,33
JUDGE/SUPERIOR COURT,Write In  ,Lower Paxton Twp--19th Precinct,0,0,0,0,0,33,0,0,0,33
JUDGE/SUPERIOR COURT,Write In  ,Lower Paxton Twp--20th Precinct,0,0,0,0,0,33,0,0,0,33
JUDGE/SUPERIOR COURT,Write In  ,Lower Paxton Twp--21st Precinct,0,0,0,0,0,33,0,0,0,33
JUDGE/SUPERIOR COURT,Write In  ,Lower Paxton Twp--22nd Precinct,0,0,0,0,0,33,0,0,0,33
JUDGE/SUPERIOR COURT,Write In  ,Lower Paxton Twp--23rd Precinct,0,0,0,0,0,33,0,0,0,33
JUDGE/SUPERIOR COURT,Write In  ,Lower Paxton Twp--24th Precinct,0,0,0,0,0,33,0,0,0,33
JUDGE/SUPERIOR COURT,Write In  ,Lower Paxton Twp--25th Precinct,0,0,0,0,0,33,0,0,0,33
JUDGE/SUPERIOR COURT,Write In  ,Lower Paxton Twp--26th Precinct,1,0,0,0,1,33,0,0,0,33
JUDGE/SUPERIOR COURT,Write In  ,Lower Paxton Twp--27th Precinct,0,0,0,0,0,33,0,0,0,33
JUDGE/SUPERIOR COURT,Write In  ,Lower Swatara Twp--1st Precinct,0,0,0,0,0,33,0,0,0,33
JUDGE/SUPERIOR COURT,Write In  ,Lower Swatara Twp--2nd Precinct,0,0,0,0,0,33,0,0,0,33
JUDGE/SUPERIOR COURT,Write In  ,Lower Swatara Twp--3rd Precinct,0,0,0,0,0,33,0,0,0,33
JUDGE/SUPERIOR COURT,Write In  ,Lower Swatara Twp--4th Precinct,0,0,0,0,0,33,0,0,0,33
JUDGE/SUPERIOR COURT,Write In  ,Lykens Township,0,0,0,0,0,33,0,0,0,33
JUDGE/SUPERIOR COURT,Write In  ,Middle Paxton Twp--1st Precinct,1,0,0,0,1,33,0,0,0,33
JUDGE/SUPERIOR COURT,Write In  ,Middle Paxton Twp--2nd Precinct,0,0,0,0,0,33,0,0,0,33
JUDGE/SUPERIOR COURT,Write In  ,Middle Paxton Twp--3rd Precinct,1,0,0,0,1,33,0,0,0,33
JUDGE/SUPERIOR COURT,Write In  ,Mifflin Township,0,0,0,0,0,33,0,0,0,33
JUDGE/SUPERIOR COURT,Write In  ,Reed Township,0,0,0,0,0,33,0,0,0,33
JUDGE/SUPERIOR COURT,Write In  ,Rush Township,0,0,0,0,0,33,0,0,0,33
JUDGE/SUPERIOR COURT,Write In  ,South Hanover Twp--1st Precinct,0,0,0,0,0,33,0,0,0,33
JUDGE/SUPERIOR COURT,Write In  ,South Hanover Twp--2nd Precinct,0,0,0,0,0,33,0,0,0,33
JUDGE/SUPERIOR COURT,Write In  ,South Hanover Twp--3rd Precinct,0,0,0,0,0,33,0,0,0,33
JUDGE/SUPERIOR COURT,Write In  ,Susquehanna Twp--1st Ward,0,0,0,0,0,33,0,0,0,33
JUDGE/SUPERIOR COURT,Write In  ,Susquehanna Twp--2nd Ward,0,0,0,0,0,33,0,0,0,33
JUDGE/SUPERIOR COURT,Write In  ,Susquehanna Twp--3rd Ward,0,0,0,0,0,33,0,0,0,33
JUDGE/SUPERIOR COURT,Write In  ,Susquehanna Twp--4th Ward,0,0,0,0,0,33,0,0,0,33
JUDGE/SUPERIOR COURT,Write In  ,Susquehanna Twp--5th Ward,0,0,0,0,0,33,0,0,0,33
JUDGE/SUPERIOR COURT,Write In  ,Susquehanna Twp--6th Ward,0,0,0,0,0,33,0,0,0,33
JUDGE/SUPERIOR COURT,Write In  ,Susquehanna Twp--7th Ward,1,0,0,0,1,33,0,0,0,33
JUDGE/SUPERIOR COURT,Write In  ,Susquehanna Twp--8th Ward,0,0,0,0,0,33,0,0,0,33
JUDGE/SUPERIOR COURT,Write In  ,Susquehanna Twp--9th Ward,0,0,0,0,0,33,0,0,0,33
JUDGE/SUPERIOR COURT,Write In  ,Swatara Township--1st Ward,3,0,0,0,3,33,0,0,0,33
JUDGE/SUPERIOR COURT,Write In  ,Swatara Township--2nd Ward,0,0,0,0,0,33,0,0,0,33
JUDGE/SUPERIOR COURT,Write In  ,Swatara Township--3rd Ward,0,0,0,0,0,33,0,0,0,33
JUDGE/SUPERIOR COURT,Write In  ,Swatara Township--4th Ward,0,0,0,0,0,33,0,0,0,33
JUDGE/SUPERIOR COURT,Write In  ,Swatara Township--5th Ward,0,0,0,0,0,33,0,0,0,33
JUDGE/SUPERIOR COURT,Write In  ,Swatara Township--6th Ward,0,0,0,0,0,33,0,0,0,33
JUDGE/SUPERIOR COURT,Write In  ,Swatara Township--7th Ward,0,0,0,0,0,33,0,0,0,33
JUDGE/SUPERIOR COURT,Write In  ,Swatara Township--8th Ward,0,0,0,0,0,33,0,0,0,33
JUDGE/SUPERIOR COURT,Write In  ,Swatara Township--9th Ward,0,0,0,0,0,33,0,0,0,33
JUDGE/SUPERIOR COURT,Write In  ,Upper Paxton Twp--1st Precinct,1,0,0,0,1,33,0,0,0,33
JUDGE/SUPERIOR COURT,Write In  ,Upper Paxton Twp--2nd Precinct,0,0,0,0,0,33,0,0,0,33
JUDGE/SUPERIOR COURT,Write In  ,Washington Township,0,0,0,0,0,33,0,0,0,33
JUDGE/SUPERIOR COURT,Write In  ,Wayne Township,0,0,0,0,0,33,0,0,0,33
JUDGE/SUPERIOR COURT,Write In  ,West Hanover Twp--1st Precinct,0,0,0,0,0,33,0,0,0,33
JUDGE/SUPERIOR COURT,Write In  ,West Hanover Twp--2nd Precinct,0,0,0,0,0,33,0,0,0,33
JUDGE/SUPERIOR COURT,Write In  ,West Hanover Twp--3rd Precinct,0,0,0,0,0,33,0,0,0,33
JUDGE/SUPERIOR COURT,Write In  ,West Hanover Twp--4th Precinct,0,0,0,0,0,33,0,0,0,33
JUDGE/SUPERIOR COURT,Write In  ,Wiconisco Twp--1st Precinct,0,0,0,0,0,33,0,0,0,33
JUDGE/SUPERIOR COURT,Write In  ,Wiconisco Twp--2nd Precinct,0,0,0,0,0,33,0,0,0,33
JUDGE/SUPERIOR COURT,Write In  ,Williams Twp,0,0,0,0,0,33,0,0,0,33
JUSTICE/SUPREME COURT,Debra  TODD,"City--1st Ward, 1st Precinct",77,1,0,0,78,16757,317,9,0,17083
JUSTICE/SUPREME COURT,Debra  TODD,"City--1st Ward, 2nd Precinct",119,1,1,0,121,16757,317,9,0,17083
JUSTICE/SUPREME COURT,Debra  TODD,"City--1st Ward, 3rd Precinct",71,1,0,0,72,16757,317,9,0,17083
JUSTICE/SUPREME COURT,Debra  TODD,"City--2nd Ward, 1st Precinct",26,0,0,0,26,16757,317,9,0,17083
JUSTICE/SUPREME COURT,Debra  TODD,"City--2nd Ward, 2nd Precinct",59,0,0,0,59,16757,317,9,0,17083
JUSTICE/SUPREME COURT,Debra  TODD,City--3rd Ward,81,0,0,0,81,16757,317,9,0,17083
JUSTICE/SUPREME COURT,Debra  TODD,City--4th Ward,133,4,0,0,137,16757,317,9,0,17083
JUSTICE/SUPREME COURT,Debra  TODD,City--5th Ward,242,6,0,0,248,16757,317,9,0,17083
JUSTICE/SUPREME COURT,Debra  TODD,City--6th Ward,140,1,3,0,144,16757,317,9,0,17083
JUSTICE/SUPREME COURT,Debra  TODD,"City--7th Ward, 1st Precinct",49,1,0,0,50,16757,317,9,0,17083
JUSTICE/SUPREME COURT,Debra  TODD,"City--7th Ward, 2nd Precinct",137,0,0,0,137,16757,317,9,0,17083
JUSTICE/SUPREME COURT,Debra  TODD,City--8th Ward,136,1,0,0,137,16757,317,9,0,17083
JUSTICE/SUPREME COURT,Debra  TODD,"City--9th Ward, 1st Precinct",40,2,0,0,42,16757,317,9,0,17083
JUSTICE/SUPREME COURT,Debra  TODD,"City--9th Ward, 2nd Precinct",85,1,0,0,86,16757,317,9,0,17083
JUSTICE/SUPREME COURT,Debra  TODD,"City--9th Ward, 3rd Precinct",170,1,0,0,171,16757,317,9,0,17083
JUSTICE/SUPREME COURT,Debra  TODD,"City--9th Ward, 4th Precinct",158,1,0,0,159,16757,317,9,0,17083
JUSTICE/SUPREME COURT,Debra  TODD,"City--9th Ward, 5th Precinct",89,3,0,0,92,16757,317,9,0,17083
JUSTICE/SUPREME COURT,Debra  TODD,"City--10th Ward, 1st Precinct",215,3,0,0,218,16757,317,9,0,17083
JUSTICE/SUPREME COURT,Debra  TODD,"City--10th Ward, 2nd Precinct",84,0,0,0,84,16757,317,9,0,17083
JUSTICE/SUPREME COURT,Debra  TODD,"City--10th Ward, 3rd Precinct",70,0,0,0,70,16757,317,9,0,17083
JUSTICE/SUPREME COURT,Debra  TODD,"City--10th Ward, 4th Precinct",106,0,0,0,106,16757,317,9,0,17083
JUSTICE/SUPREME COURT,Debra  TODD,City--11th Ward,96,14,0,0,110,16757,317,9,0,17083
JUSTICE/SUPREME COURT,Debra  TODD,City--12th Ward,210,6,0,0,216,16757,317,9,0,17083
JUSTICE/SUPREME COURT,Debra  TODD,"City--13th Ward, 1st Precinct",87,0,0,0,87,16757,317,9,0,17083
JUSTICE/SUPREME COURT,Debra  TODD,"City--13th Ward, 2nd Precinct",113,2,0,0,115,16757,317,9,0,17083
JUSTICE/SUPREME COURT,Debra  TODD,"City--13th Ward, 3rd Precinct",146,1,0,0,147,16757,317,9,0,17083
JUSTICE/SUPREME COURT,Debra  TODD,City--14th Ward,272,6,0,0,278,16757,317,9,0,17083
JUSTICE/SUPREME COURT,Debra  TODD,City--15th Ward,76,1,0,0,77,16757,317,9,0,17083
JUSTICE/SUPREME COURT,Debra  TODD,Berrysburg Borough,26,0,0,0,26,16757,317,9,0,17083
JUSTICE/SUPREME COURT,Debra  TODD,Dauphin Borough,75,2,0,0,77,16757,317,9,0,17083
JUSTICE/SUPREME COURT,Debra  TODD,Elizabethville Borough,53,2,0,0,55,16757,317,9,0,17083
JUSTICE/SUPREME COURT,Debra  TODD,Gratz Borough,28,0,0,0,28,16757,317,9,0,17083
JUSTICE/SUPREME COURT,Debra  TODD,Halifax Borough,30,1,0,0,31,16757,317,9,0,17083
JUSTICE/SUPREME COURT,Debra  TODD,Highspire--1st Precinct,69,1,0,0,70,16757,317,9,0,17083
JUSTICE/SUPREME COURT,Debra  TODD,Highspire--2nd Precinct,73,0,0,0,73,16757,317,9,0,17083
JUSTICE/SUPREME COURT,Debra  TODD,Hummelstown--1st Precinct,78,2,0,0,80,16757,317,9,0,17083
JUSTICE/SUPREME COURT,Debra  TODD,Hummelstown--2nd Precinct,135,3,0,0,138,16757,317,9,0,17083
JUSTICE/SUPREME COURT,Debra  TODD,Lykens Borough--1st Ward,35,1,0,0,36,16757,317,9,0,17083
JUSTICE/SUPREME COURT,Debra  TODD,Lykens Borough--2nd Ward,54,2,0,0,56,16757,317,9,0,17083
JUSTICE/SUPREME COURT,Debra  TODD,"Middletown--1st Ward, 1st Precinct",42,0,0,0,42,16757,317,9,0,17083
JUSTICE/SUPREME COURT,Debra  TODD,"Middletown--1st Ward, 2nd Precinct",75,1,0,0,76,16757,317,9,0,17083
JUSTICE/SUPREME COURT,Debra  TODD,"Middletown--2nd Ward, 1st Precinct",75,0,0,0,75,16757,317,9,0,17083
JUSTICE/SUPREME COURT,Debra  TODD,"Middletown--2nd Ward, 2nd Precinct",57,1,0,0,58,16757,317,9,0,17083
JUSTICE/SUPREME COURT,Debra  TODD,"Middletown--3rd Ward, 1st Precinct",33,1,0,0,34,16757,317,9,0,17083
JUSTICE/SUPREME COURT,Debra  TODD,"Middletown--3rd Ward, 2nd Precinct",88,0,0,0,88,16757,317,9,0,17083
JUSTICE/SUPREME COURT,Debra  TODD,Millersburg--1st Ward,36,2,0,0,38,16757,317,9,0,17083
JUSTICE/SUPREME COURT,Debra  TODD,Millersburg--2nd Ward,60,0,0,0,60,16757,317,9,0,17083
JUSTICE/SUPREME COURT,Debra  TODD,Paxtang Borough,133,3,0,0,136,16757,317,9,0,17083
JUSTICE/SUPREME COURT,Debra  TODD,Penbrook Borough--1st Ward,37,0,0,0,37,16757,317,9,0,17083
JUSTICE/SUPREME COURT,Debra  TODD,Penbrook Borough--2nd Ward,34,0,0,0,34,16757,317,9,0,17083
JUSTICE/SUPREME COURT,Debra  TODD,Penbrook Borough--3rd Ward,33,0,0,0,33,16757,317,9,0,17083
JUSTICE/SUPREME COURT,Debra  TODD,Penbrook Borough--4th Ward,47,1,0,0,48,16757,317,9,0,17083
JUSTICE/SUPREME COURT,Debra  TODD,Royalton Borough--1st Ward,26,0,0,0,26,16757,317,9,0,17083
JUSTICE/SUPREME COURT,Debra  TODD,Royalton Borough--2nd Ward,25,0,0,0,25,16757,317,9,0,17083
JUSTICE/SUPREME COURT,Debra  TODD,Steelton--1st Ward,73,3,0,0,76,16757,317,9,0,17083
JUSTICE/SUPREME COURT,Debra  TODD,"Steelton--2nd Ward, 1st Precinct",75,0,0,0,75,16757,317,9,0,17083
JUSTICE/SUPREME COURT,Debra  TODD,"Steelton--2nd Ward, 2nd Precinct",41,0,0,0,41,16757,317,9,0,17083
JUSTICE/SUPREME COURT,Debra  TODD,"Steelton--3rd Ward, 1st Precinct",31,0,0,0,31,16757,317,9,0,17083
JUSTICE/SUPREME COURT,Debra  TODD,"Steelton--3rd Ward, 2nd Precinct",71,0,0,0,71,16757,317,9,0,17083
JUSTICE/SUPREME COURT,Debra  TODD,Steelton--4th Ward,63,1,2,0,66,16757,317,9,0,17083
JUSTICE/SUPREME COURT,Debra  TODD,Pillow Borough,19,0,0,0,19,16757,317,9,0,17083
JUSTICE/SUPREME COURT,Debra  TODD,Williamstown--1st Ward,38,1,0,0,39,16757,317,9,0,17083
JUSTICE/SUPREME COURT,Debra  TODD,Williamstown--2nd Ward,28,0,0,0,28,16757,317,9,0,17083
JUSTICE/SUPREME COURT,Debra  TODD,Conewago Twp--1st Precinct,73,1,0,0,74,16757,317,9,0,17083
JUSTICE/SUPREME COURT,Debra  TODD,Conewago Twp--2nd Precinct,63,0,0,0,63,16757,317,9,0,17083
JUSTICE/SUPREME COURT,Debra  TODD,Derry Township--1st Precinct,154,1,0,0,155,16757,317,9,0,17083
JUSTICE/SUPREME COURT,Debra  TODD,Derry Township--2nd Precinct,105,4,0,0,109,16757,317,9,0,17083
JUSTICE/SUPREME COURT,Debra  TODD,Derry Township--3rd Precinct,121,3,1,0,125,16757,317,9,0,17083
JUSTICE/SUPREME COURT,Debra  TODD,Derry Township--4th Precinct,73,2,0,0,75,16757,317,9,0,17083
JUSTICE/SUPREME COURT,Debra  TODD,Derry Township--5th Precinct,65,1,0,0,66,16757,317,9,0,17083
JUSTICE/SUPREME COURT,Debra  TODD,Derry Township--6th Precinct,64,1,0,0,65,16757,317,9,0,17083
JUSTICE/SUPREME COURT,Debra  TODD,Derry Township--7th Precinct,118,6,0,0,124,16757,317,9,0,17083
JUSTICE/SUPREME COURT,Debra  TODD,Derry Township--8th Precinct,73,0,0,0,73,16757,317,9,0,17083
JUSTICE/SUPREME COURT,Debra  TODD,Derry Township--9th Precinct,55,2,0,0,57,16757,317,9,0,17083
JUSTICE/SUPREME COURT,Debra  TODD,Derry Township--10th Precinct,91,4,0,0,95,16757,317,9,0,17083
JUSTICE/SUPREME COURT,Debra  TODD,Derry Township--11th Precinct,138,2,0,0,140,16757,317,9,0,17083
JUSTICE/SUPREME COURT,Debra  TODD,Derry Township--12th Precinct,78,5,0,0,83,16757,317,9,0,17083
JUSTICE/SUPREME COURT,Debra  TODD,Derry Township--13th Precinct,113,6,0,0,119,16757,317,9,0,17083
JUSTICE/SUPREME COURT,Debra  TODD,Derry Township--14th Precinct,76,2,0,0,78,16757,317,9,0,17083
JUSTICE/SUPREME COURT,Debra  TODD,Derry Township--15th Precinct,134,3,0,0,137,16757,317,9,0,17083
JUSTICE/SUPREME COURT,Debra  TODD,East Hanover Township--1st Precinct,109,1,0,0,110,16757,317,9,0,17083
JUSTICE/SUPREME COURT,Debra  TODD,East Hanover Township--2nd Precinct,119,3,0,0,122,16757,317,9,0,17083
JUSTICE/SUPREME COURT,Debra  TODD,Halifax Twp--1st Precinct,115,3,0,0,118,16757,317,9,0,17083
JUSTICE/SUPREME COURT,Debra  TODD,Halifax Twp--2nd Precinct,96,2,0,0,98,16757,317,9,0,17083
JUSTICE/SUPREME COURT,Debra  TODD,Jackson Township,91,0,0,0,91,16757,317,9,0,17083
JUSTICE/SUPREME COURT,Debra  TODD,Jefferson Township,24,0,0,0,24,16757,317,9,0,17083
JUSTICE/SUPREME COURT,Debra  TODD,Londonderry Twp--1st Precinct,79,0,0,0,79,16757,317,9,0,17083
JUSTICE/SUPREME COURT,Debra  TODD,Londonderry Twp--2nd Precinct,93,0,0,0,93,16757,317,9,0,17083
JUSTICE/SUPREME COURT,Debra  TODD,Londonderry Twp--3rd Precinct,36,0,0,0,36,16757,317,9,0,17083
JUSTICE/SUPREME COURT,Debra  TODD,Lower Paxton Twp--1st Precinct,90,0,0,0,90,16757,317,9,0,17083
JUSTICE/SUPREME COURT,Debra  TODD,Lower Paxton Twp--2nd Precinct,112,7,0,0,119,16757,317,9,0,17083
JUSTICE/SUPREME COURT,Debra  TODD,Lower Paxton Twp--3rd precinct,187,3,0,0,190,16757,317,9,0,17083
JUSTICE/SUPREME COURT,Debra  TODD,Lower Paxton Twp--4th Precinct,124,1,0,0,125,16757,317,9,0,17083
JUSTICE/SUPREME COURT,Debra  TODD,Lower Paxton Twp--5th Precinct,125,2,0,0,127,16757,317,9,0,17083
JUSTICE/SUPREME COURT,Debra  TODD,Lower Paxton Twp--6th Precinct,109,2,0,0,111,16757,317,9,0,17083
JUSTICE/SUPREME COURT,Debra  TODD,Lower Paxton Twp--7th Precinct,142,2,0,0,144,16757,317,9,0,17083
JUSTICE/SUPREME COURT,Debra  TODD,Lower Paxton Twp--8th Precinct,98,2,0,0,100,16757,317,9,0,17083
JUSTICE/SUPREME COURT,Debra  TODD,Lower Paxton Twp--9th Precinct,68,1,0,0,69,16757,317,9,0,17083
JUSTICE/SUPREME COURT,Debra  TODD,Lower Paxton Twp--10th Precinct,100,5,0,0,105,16757,317,9,0,17083
JUSTICE/SUPREME COURT,Debra  TODD,Lower Paxton Twp--11th Precinct,97,2,0,0,99,16757,317,9,0,17083
JUSTICE/SUPREME COURT,Debra  TODD,Lower Paxton Twp--12th Precinct,133,1,0,0,134,16757,317,9,0,17083
JUSTICE/SUPREME COURT,Debra  TODD,Lower Paxton Twp--13th Precinct,144,4,0,0,148,16757,317,9,0,17083
JUSTICE/SUPREME COURT,Debra  TODD,Lower Paxton Twp--14th Precinct,98,2,0,0,100,16757,317,9,0,17083
JUSTICE/SUPREME COURT,Debra  TODD,Lower Paxton Twp--15th Precinct,130,2,0,0,132,16757,317,9,0,17083
JUSTICE/SUPREME COURT,Debra  TODD,Lower Paxton Twp--16th Precinct,194,2,0,0,196,16757,317,9,0,17083
JUSTICE/SUPREME COURT,Debra  TODD,Lower Paxton Twp--17th Precinct,106,2,0,0,108,16757,317,9,0,17083
JUSTICE/SUPREME COURT,Debra  TODD,Lower Paxton Twp--18th Precinct,112,0,0,0,112,16757,317,9,0,17083
JUSTICE/SUPREME COURT,Debra  TODD,Lower Paxton Twp--19th Precinct,185,4,0,0,189,16757,317,9,0,17083
JUSTICE/SUPREME COURT,Debra  TODD,Lower Paxton Twp--20th Precinct,115,1,0,0,116,16757,317,9,0,17083
JUSTICE/SUPREME COURT,Debra  TODD,Lower Paxton Twp--21st Precinct,168,6,0,0,174,16757,317,9,0,17083
JUSTICE/SUPREME COURT,Debra  TODD,Lower Paxton Twp--22nd Precinct,124,1,0,0,125,16757,317,9,0,17083
JUSTICE/SUPREME COURT,Debra  TODD,Lower Paxton Twp--23rd Precinct,104,0,0,0,104,16757,317,9,0,17083
JUSTICE/SUPREME COURT,Debra  TODD,Lower Paxton Twp--24th Precinct,114,3,0,0,117,16757,317,9,0,17083
JUSTICE/SUPREME COURT,Debra  TODD,Lower Paxton Twp--25th Precinct,117,1,0,0,118,16757,317,9,0,17083
JUSTICE/SUPREME COURT,Debra  TODD,Lower Paxton Twp--26th Precinct,135,4,0,0,139,16757,317,9,0,17083
JUSTICE/SUPREME COURT,Debra  TODD,Lower Paxton Twp--27th Precinct,113,1,0,0,114,16757,317,9,0,17083
JUSTICE/SUPREME COURT,Debra  TODD,Lower Swatara Twp--1st Precinct,114,1,0,0,115,16757,317,9,0,17083
JUSTICE/SUPREME COURT,Debra  TODD,Lower Swatara Twp--2nd Precinct,106,5,0,0,111,16757,317,9,0,17083
JUSTICE/SUPREME COURT,Debra  TODD,Lower Swatara Twp--3rd Precinct,107,9,0,0,116,16757,317,9,0,17083
JUSTICE/SUPREME COURT,Debra  TODD,Lower Swatara Twp--4th Precinct,92,0,0,0,92,16757,317,9,0,17083
JUSTICE/SUPREME COURT,Debra  TODD,Lykens Township,32,0,0,0,32,16757,317,9,0,17083
JUSTICE/SUPREME COURT,Debra  TODD,Middle Paxton Twp--1st Precinct,136,0,0,0,136,16757,317,9,0,17083
JUSTICE/SUPREME COURT,Debra  TODD,Middle Paxton Twp--2nd Precinct,123,0,0,0,123,16757,317,9,0,17083
JUSTICE/SUPREME COURT,Debra  TODD,Middle Paxton Twp--3rd Precinct,120,1,0,0,121,16757,317,9,0,17083
JUSTICE/SUPREME COURT,Debra  TODD,Mifflin Township,24,0,0,0,24,16757,317,9,0,17083
JUSTICE/SUPREME COURT,Debra  TODD,Reed Township,13,0,0,0,13,16757,317,9,0,17083
JUSTICE/SUPREME COURT,Debra  TODD,Rush Township,15,0,0,0,15,16757,317,9,0,17083
JUSTICE/SUPREME COURT,Debra  TODD,South Hanover Twp--1st Precinct,84,1,0,0,85,16757,317,9,0,17083
JUSTICE/SUPREME COURT,Debra  TODD,South Hanover Twp--2nd Precinct,155,7,0,0,162,16757,317,9,0,17083
JUSTICE/SUPREME COURT,Debra  TODD,South Hanover Twp--3rd Precinct,81,0,0,0,81,16757,317,9,0,17083
JUSTICE/SUPREME COURT,Debra  TODD,Susquehanna Twp--1st Ward,313,10,0,0,323,16757,317,9,0,17083
JUSTICE/SUPREME COURT,Debra  TODD,Susquehanna Twp--2nd Ward,375,13,0,0,388,16757,317,9,0,17083
JUSTICE/SUPREME COURT,Debra  TODD,Susquehanna Twp--3rd Ward,205,4,0,0,209,16757,317,9,0,17083
JUSTICE/SUPREME COURT,Debra  TODD,Susquehanna Twp--4th Ward,206,1,0,0,207,16757,317,9,0,17083
JUSTICE/SUPREME COURT,Debra  TODD,Susquehanna Twp--5th Ward,171,5,0,0,176,16757,317,9,0,17083
JUSTICE/SUPREME COURT,Debra  TODD,Susquehanna Twp--6th Ward,187,2,0,0,189,16757,317,9,0,17083
JUSTICE/SUPREME COURT,Debra  TODD,Susquehanna Twp--7th Ward,127,0,0,0,127,16757,317,9,0,17083
JUSTICE/SUPREME COURT,Debra  TODD,Susquehanna Twp--8th Ward,334,14,0,0,348,16757,317,9,0,17083
JUSTICE/SUPREME COURT,Debra  TODD,Susquehanna Twp--9th Ward,275,2,0,0,277,16757,317,9,0,17083
JUSTICE/SUPREME COURT,Debra  TODD,Swatara Township--1st Ward,160,2,0,0,162,16757,317,9,0,17083
JUSTICE/SUPREME COURT,Debra  TODD,Swatara Township--2nd Ward,112,13,0,0,125,16757,317,9,0,17083
JUSTICE/SUPREME COURT,Debra  TODD,Swatara Township--3rd Ward,120,2,0,0,122,16757,317,9,0,17083
JUSTICE/SUPREME COURT,Debra  TODD,Swatara Township--4th Ward,144,2,0,0,146,16757,317,9,0,17083
JUSTICE/SUPREME COURT,Debra  TODD,Swatara Township--5th Ward,191,1,0,0,192,16757,317,9,0,17083
JUSTICE/SUPREME COURT,Debra  TODD,Swatara Township--6th Ward,187,1,0,0,188,16757,317,9,0,17083
JUSTICE/SUPREME COURT,Debra  TODD,Swatara Township--7th Ward,232,4,0,0,236,16757,317,9,0,17083
JUSTICE/SUPREME COURT,Debra  TODD,Swatara Township--8th Ward,192,4,1,0,197,16757,317,9,0,17083
JUSTICE/SUPREME COURT,Debra  TODD,Swatara Township--9th Ward,120,4,0,0,124,16757,317,9,0,17083
JUSTICE/SUPREME COURT,Debra  TODD,Upper Paxton Twp--1st Precinct,83,0,0,0,83,16757,317,9,0,17083
JUSTICE/SUPREME COURT,Debra  TODD,Upper Paxton Twp--2nd Precinct,60,0,0,0,60,16757,317,9,0,17083
JUSTICE/SUPREME COURT,Debra  TODD,Washington Township,83,2,0,0,85,16757,317,9,0,17083
JUSTICE/SUPREME COURT,Debra  TODD,Wayne Township,86,0,0,0,86,16757,317,9,0,17083
JUSTICE/SUPREME COURT,Debra  TODD,West Hanover Twp--1st Precinct,105,1,0,0,106,16757,317,9,0,17083
JUSTICE/SUPREME COURT,Debra  TODD,West Hanover Twp--2nd Precinct,119,2,0,0,121,16757,317,9,0,17083
JUSTICE/SUPREME COURT,Debra  TODD,West Hanover Twp--3rd Precinct,244,5,1,0,250,16757,317,9,0,17083
JUSTICE/SUPREME COURT,Debra  TODD,West Hanover Twp--4th Precinct,147,1,0,0,148,16757,317,9,0,17083
JUSTICE/SUPREME COURT,Debra  TODD,Wiconisco Twp--1st Precinct,31,0,0,0,31,16757,317,9,0,17083
JUSTICE/SUPREME COURT,Debra  TODD,Wiconisco Twp--2nd Precinct,28,0,0,0,28,16757,317,9,0,17083
JUSTICE/SUPREME COURT,Debra  TODD,Williams Twp,35,0,0,0,35,16757,317,9,0,17083
JUSTICE/SUPREME COURT,Maureen E. LALLY-GREEN,"City--1st Ward, 1st Precinct",39,2,0,0,41,22368,448,13,0,22829
JUSTICE/SUPREME COURT,Maureen E. LALLY-GREEN,"City--1st Ward, 2nd Precinct",71,1,0,0,72,22368,448,13,0,22829
JUSTICE/SUPREME COURT,Maureen E. LALLY-GREEN,"City--1st Ward, 3rd Precinct",20,0,0,0,20,22368,448,13,0,22829
JUSTICE/SUPREME COURT,Maureen E. LALLY-GREEN,"City--2nd Ward, 1st Precinct",21,0,0,0,21,22368,448,13,0,22829
JUSTICE/SUPREME COURT,Maureen E. LALLY-GREEN,"City--2nd Ward, 2nd Precinct",23,1,0,0,24,22368,448,13,0,22829
JUSTICE/SUPREME COURT,Maureen E. LALLY-GREEN,City--3rd Ward,45,1,0,0,46,22368,448,13,0,22829
JUSTICE/SUPREME COURT,Maureen E. LALLY-GREEN,City--4th Ward,65,0,0,0,65,22368,448,13,0,22829
JUSTICE/SUPREME COURT,Maureen E. LALLY-GREEN,City--5th Ward,102,6,0,0,108,22368,448,13,0,22829
JUSTICE/SUPREME COURT,Maureen E. LALLY-GREEN,City--6th Ward,60,1,1,0,62,22368,448,13,0,22829
JUSTICE/SUPREME COURT,Maureen E. LALLY-GREEN,"City--7th Ward, 1st Precinct",25,0,0,0,25,22368,448,13,0,22829
JUSTICE/SUPREME COURT,Maureen E. LALLY-GREEN,"City--7th Ward, 2nd Precinct",30,1,0,0,31,22368,448,13,0,22829
JUSTICE/SUPREME COURT,Maureen E. LALLY-GREEN,City--8th Ward,24,1,0,0,25,22368,448,13,0,22829
JUSTICE/SUPREME COURT,Maureen E. LALLY-GREEN,"City--9th Ward, 1st Precinct",24,0,0,0,24,22368,448,13,0,22829
JUSTICE/SUPREME COURT,Maureen E. LALLY-GREEN,"City--9th Ward, 2nd Precinct",16,1,0,0,17,22368,448,13,0,22829
JUSTICE/SUPREME COURT,Maureen E. LALLY-GREEN,"City--9th Ward, 3rd Precinct",41,1,0,0,42,22368,448,13,0,22829
JUSTICE/SUPREME COURT,Maureen E. LALLY-GREEN,"City--9th Ward, 4th Precinct",89,3,0,0,92,22368,448,13,0,22829
JUSTICE/SUPREME COURT,Maureen E. LALLY-GREEN,"City--9th Ward, 5th Precinct",52,2,0,0,54,22368,448,13,0,22829
JUSTICE/SUPREME COURT,Maureen E. LALLY-GREEN,"City--10th Ward, 1st Precinct",70,2,0,0,72,22368,448,13,0,22829
JUSTICE/SUPREME COURT,Maureen E. LALLY-GREEN,"City--10th Ward, 2nd Precinct",16,0,0,0,16,22368,448,13,0,22829
JUSTICE/SUPREME COURT,Maureen E. LALLY-GREEN,"City--10th Ward, 3rd Precinct",52,1,0,0,53,22368,448,13,0,22829
JUSTICE/SUPREME COURT,Maureen E. LALLY-GREEN,"City--10th Ward, 4th Precinct",28,0,0,0,28,22368,448,13,0,22829
JUSTICE/SUPREME COURT,Maureen E. LALLY-GREEN,City--11th Ward,29,11,0,0,40,22368,448,13,0,22829
JUSTICE/SUPREME COURT,Maureen E. LALLY-GREEN,City--12th Ward,70,4,0,0,74,22368,448,13,0,22829
JUSTICE/SUPREME COURT,Maureen E. LALLY-GREEN,"City--13th Ward, 1st Precinct",67,0,0,0,67,22368,448,13,0,22829
JUSTICE/SUPREME COURT,Maureen E. LALLY-GREEN,"City--13th Ward, 2nd Precinct",76,3,0,0,79,22368,448,13,0,22829
JUSTICE/SUPREME COURT,Maureen E. LALLY-GREEN,"City--13th Ward, 3rd Precinct",87,1,0,0,88,22368,448,13,0,22829
JUSTICE/SUPREME COURT,Maureen E. LALLY-GREEN,City--14th Ward,128,1,0,0,129,22368,448,13,0,22829
JUSTICE/SUPREME COURT,Maureen E. LALLY-GREEN,City--15th Ward,22,0,0,0,22,22368,448,13,0,22829
JUSTICE/SUPREME COURT,Maureen E. LALLY-GREEN,Berrysburg Borough,41,0,0,0,41,22368,448,13,0,22829
JUSTICE/SUPREME COURT,Maureen E. LALLY-GREEN,Dauphin Borough,97,1,0,0,98,22368,448,13,0,22829
JUSTICE/SUPREME COURT,Maureen E. LALLY-GREEN,Elizabethville Borough,126,1,0,0,127,22368,448,13,0,22829
JUSTICE/SUPREME COURT,Maureen E. LALLY-GREEN,Gratz Borough,65,2,0,0,67,22368,448,13,0,22829
JUSTICE/SUPREME COURT,Maureen E. LALLY-GREEN,Halifax Borough,60,3,0,0,63,22368,448,13,0,22829
JUSTICE/SUPREME COURT,Maureen E. LALLY-GREEN,Highspire--1st Precinct,81,0,0,0,81,22368,448,13,0,22829
JUSTICE/SUPREME COURT,Maureen E. LALLY-GREEN,Highspire--2nd Precinct,93,0,0,0,93,22368,448,13,0,22829
JUSTICE/SUPREME COURT,Maureen E. LALLY-GREEN,Hummelstown--1st Precinct,127,4,0,0,131,22368,448,13,0,22829
JUSTICE/SUPREME COURT,Maureen E. LALLY-GREEN,Hummelstown--2nd Precinct,270,4,0,0,274,22368,448,13,0,22829
JUSTICE/SUPREME COURT,Maureen E. LALLY-GREEN,Lykens Borough--1st Ward,65,0,0,0,65,22368,448,13,0,22829
JUSTICE/SUPREME COURT,Maureen E. LALLY-GREEN,Lykens Borough--2nd Ward,79,1,0,0,80,22368,448,13,0,22829
JUSTICE/SUPREME COURT,Maureen E. LALLY-GREEN,"Middletown--1st Ward, 1st Precinct",65,0,0,0,65,22368,448,13,0,22829
JUSTICE/SUPREME COURT,Maureen E. LALLY-GREEN,"Middletown--1st Ward, 2nd Precinct",104,7,0,0,111,22368,448,13,0,22829
JUSTICE/SUPREME COURT,Maureen E. LALLY-GREEN,"Middletown--2nd Ward, 1st Precinct",103,1,0,0,104,22368,448,13,0,22829
JUSTICE/SUPREME COURT,Maureen E. LALLY-GREEN,"Middletown--2nd Ward, 2nd Precinct",109,3,0,0,112,22368,448,13,0,22829
JUSTICE/SUPREME COURT,Maureen E. LALLY-GREEN,"Middletown--3rd Ward, 1st Precinct",96,1,0,0,97,22368,448,13,0,22829
JUSTICE/SUPREME COURT,Maureen E. LALLY-GREEN,"Middletown--3rd Ward, 2nd Precinct",142,0,0,0,142,22368,448,13,0,22829
JUSTICE/SUPREME COURT,Maureen E. LALLY-GREEN,Millersburg--1st Ward,99,2,0,0,101,22368,448,13,0,22829
JUSTICE/SUPREME COURT,Maureen E. LALLY-GREEN,Millersburg--2nd Ward,121,4,0,0,125,22368,448,13,0,22829
JUSTICE/SUPREME COURT,Maureen E. LALLY-GREEN,Paxtang Borough,158,0,0,0,158,22368,448,13,0,22829
JUSTICE/SUPREME COURT,Maureen E. LALLY-GREEN,Penbrook Borough--1st Ward,27,1,0,0,28,22368,448,13,0,22829
JUSTICE/SUPREME COURT,Maureen E. LALLY-GREEN,Penbrook Borough--2nd Ward,46,1,0,0,47,22368,448,13,0,22829
JUSTICE/SUPREME COURT,Maureen E. LALLY-GREEN,Penbrook Borough--3rd Ward,55,0,0,0,55,22368,448,13,0,22829
JUSTICE/SUPREME COURT,Maureen E. LALLY-GREEN,Penbrook Borough--4th Ward,63,1,0,0,64,22368,448,13,0,22829
JUSTICE/SUPREME COURT,Maureen E. LALLY-GREEN,Royalton Borough--1st Ward,25,0,0,0,25,22368,448,13,0,22829
JUSTICE/SUPREME COURT,Maureen E. LALLY-GREEN,Royalton Borough--2nd Ward,59,0,0,0,59,22368,448,13,0,22829
JUSTICE/SUPREME COURT,Maureen E. LALLY-GREEN,Steelton--1st Ward,78,3,0,0,81,22368,448,13,0,22829
JUSTICE/SUPREME COURT,Maureen E. LALLY-GREEN,"Steelton--2nd Ward, 1st Precinct",45,2,0,0,47,22368,448,13,0,22829
JUSTICE/SUPREME COURT,Maureen E. LALLY-GREEN,"Steelton--2nd Ward, 2nd Precinct",47,0,0,0,47,22368,448,13,0,22829
JUSTICE/SUPREME COURT,Maureen E. LALLY-GREEN,"Steelton--3rd Ward, 1st Precinct",25,0,0,0,25,22368,448,13,0,22829
JUSTICE/SUPREME COURT,Maureen E. LALLY-GREEN,"Steelton--3rd Ward, 2nd Precinct",49,0,0,0,49,22368,448,13,0,22829
JUSTICE/SUPREME COURT,Maureen E. LALLY-GREEN,Steelton--4th Ward,60,0,1,0,61,22368,448,13,0,22829
JUSTICE/SUPREME COURT,Maureen E. LALLY-GREEN,Pillow Borough,32,0,0,0,32,22368,448,13,0,22829
JUSTICE/SUPREME COURT,Maureen E. LALLY-GREEN,Williamstown--1st Ward,62,0,0,0,62,22368,448,13,0,22829
JUSTICE/SUPREME COURT,Maureen E. LALLY-GREEN,Williamstown--2nd Ward,45,0,0,0,45,22368,448,13,0,22829
JUSTICE/SUPREME COURT,Maureen E. LALLY-GREEN,Conewago Twp--1st Precinct,217,1,0,0,218,22368,448,13,0,22829
JUSTICE/SUPREME COURT,Maureen E. LALLY-GREEN,Conewago Twp--2nd Precinct,173,7,0,0,180,22368,448,13,0,22829
JUSTICE/SUPREME COURT,Maureen E. LALLY-GREEN,Derry Township--1st Precinct,260,3,0,0,263,22368,448,13,0,22829
JUSTICE/SUPREME COURT,Maureen E. LALLY-GREEN,Derry Township--2nd Precinct,211,3,0,0,214,22368,448,13,0,22829
JUSTICE/SUPREME COURT,Maureen E. LALLY-GREEN,Derry Township--3rd Precinct,131,2,0,0,133,22368,448,13,0,22829
JUSTICE/SUPREME COURT,Maureen E. LALLY-GREEN,Derry Township--4th Precinct,128,3,0,0,131,22368,448,13,0,22829
JUSTICE/SUPREME COURT,Maureen E. LALLY-GREEN,Derry Township--5th Precinct,112,3,0,0,115,22368,448,13,0,22829
JUSTICE/SUPREME COURT,Maureen E. LALLY-GREEN,Derry Township--6th Precinct,126,1,1,0,128,22368,448,13,0,22829
JUSTICE/SUPREME COURT,Maureen E. LALLY-GREEN,Derry Township--7th Precinct,297,8,0,0,305,22368,448,13,0,22829
JUSTICE/SUPREME COURT,Maureen E. LALLY-GREEN,Derry Township--8th Precinct,131,0,0,0,131,22368,448,13,0,22829
JUSTICE/SUPREME COURT,Maureen E. LALLY-GREEN,Derry Township--9th Precinct,87,3,0,0,90,22368,448,13,0,22829
JUSTICE/SUPREME COURT,Maureen E. LALLY-GREEN,Derry Township--10th Precinct,189,2,0,0,191,22368,448,13,0,22829
JUSTICE/SUPREME COURT,Maureen E. LALLY-GREEN,Derry Township--11th Precinct,231,6,0,0,237,22368,448,13,0,22829
JUSTICE/SUPREME COURT,Maureen E. LALLY-GREEN,Derry Township--12th Precinct,138,0,0,0,138,22368,448,13,0,22829
JUSTICE/SUPREME COURT,Maureen E. LALLY-GREEN,Derry Township--13th Precinct,183,5,0,0,188,22368,448,13,0,22829
JUSTICE/SUPREME COURT,Maureen E. LALLY-GREEN,Derry Township--14th Precinct,114,4,0,0,118,22368,448,13,0,22829
JUSTICE/SUPREME COURT,Maureen E. LALLY-GREEN,Derry Township--15th Precinct,243,3,1,0,247,22368,448,13,0,22829
JUSTICE/SUPREME COURT,Maureen E. LALLY-GREEN,East Hanover Township--1st Precinct,242,7,0,0,249,22368,448,13,0,22829
JUSTICE/SUPREME COURT,Maureen E. LALLY-GREEN,East Hanover Township--2nd Precinct,290,2,0,0,292,22368,448,13,0,22829
JUSTICE/SUPREME COURT,Maureen E. LALLY-GREEN,Halifax Twp--1st Precinct,187,2,0,0,189,22368,448,13,0,22829
JUSTICE/SUPREME COURT,Maureen E. LALLY-GREEN,Halifax Twp--2nd Precinct,227,7,0,0,234,22368,448,13,0,22829
JUSTICE/SUPREME COURT,Maureen E. LALLY-GREEN,Jackson Township,153,0,0,0,153,22368,448,13,0,22829
JUSTICE/SUPREME COURT,Maureen E. LALLY-GREEN,Jefferson Township,43,0,0,0,43,22368,448,13,0,22829
JUSTICE/SUPREME COURT,Maureen E. LALLY-GREEN,Londonderry Twp--1st Precinct,225,0,0,0,225,22368,448,13,0,22829
JUSTICE/SUPREME COURT,Maureen E. LALLY-GREEN,Londonderry Twp--2nd Precinct,193,3,0,0,196,22368,448,13,0,22829
JUSTICE/SUPREME COURT,Maureen E. LALLY-GREEN,Londonderry Twp--3rd Precinct,84,1,0,0,85,22368,448,13,0,22829
JUSTICE/SUPREME COURT,Maureen E. LALLY-GREEN,Lower Paxton Twp--1st Precinct,161,3,0,0,164,22368,448,13,0,22829
JUSTICE/SUPREME COURT,Maureen E. LALLY-GREEN,Lower Paxton Twp--2nd Precinct,136,4,0,0,140,22368,448,13,0,22829
JUSTICE/SUPREME COURT,Maureen E. LALLY-GREEN,Lower Paxton Twp--3rd precinct,291,6,0,0,297,22368,448,13,0,22829
JUSTICE/SUPREME COURT,Maureen E. LALLY-GREEN,Lower Paxton Twp--4th Precinct,220,2,0,0,222,22368,448,13,0,22829
JUSTICE/SUPREME COURT,Maureen E. LALLY-GREEN,Lower Paxton Twp--5th Precinct,182,4,0,0,186,22368,448,13,0,22829
JUSTICE/SUPREME COURT,Maureen E. LALLY-GREEN,Lower Paxton Twp--6th Precinct,128,3,0,0,131,22368,448,13,0,22829
JUSTICE/SUPREME COURT,Maureen E. LALLY-GREEN,Lower Paxton Twp--7th Precinct,286,5,0,0,291,22368,448,13,0,22829
JUSTICE/SUPREME COURT,Maureen E. LALLY-GREEN,Lower Paxton Twp--8th Precinct,103,2,0,0,105,22368,448,13,0,22829
JUSTICE/SUPREME COURT,Maureen E. LALLY-GREEN,Lower Paxton Twp--9th Precinct,157,4,0,0,161,22368,448,13,0,22829
JUSTICE/SUPREME COURT,Maureen E. LALLY-GREEN,Lower Paxton Twp--10th Precinct,90,3,0,0,93,22368,448,13,0,22829
JUSTICE/SUPREME COURT,Maureen E. LALLY-GREEN,Lower Paxton Twp--11th Precinct,139,1,1,0,141,22368,448,13,0,22829
JUSTICE/SUPREME COURT,Maureen E. LALLY-GREEN,Lower Paxton Twp--12th Precinct,225,7,1,0,233,22368,448,13,0,22829
JUSTICE/SUPREME COURT,Maureen E. LALLY-GREEN,Lower Paxton Twp--13th Precinct,196,1,0,0,197,22368,448,13,0,22829
JUSTICE/SUPREME COURT,Maureen E. LALLY-GREEN,Lower Paxton Twp--14th Precinct,98,3,3,0,104,22368,448,13,0,22829
JUSTICE/SUPREME COURT,Maureen E. LALLY-GREEN,Lower Paxton Twp--15th Precinct,183,4,0,0,187,22368,448,13,0,22829
JUSTICE/SUPREME COURT,Maureen E. LALLY-GREEN,Lower Paxton Twp--16th Precinct,309,9,0,0,318,22368,448,13,0,22829
JUSTICE/SUPREME COURT,Maureen E. LALLY-GREEN,Lower Paxton Twp--17th Precinct,137,4,0,0,141,22368,448,13,0,22829
JUSTICE/SUPREME COURT,Maureen E. LALLY-GREEN,Lower Paxton Twp--18th Precinct,135,2,0,0,137,22368,448,13,0,22829
JUSTICE/SUPREME COURT,Maureen E. LALLY-GREEN,Lower Paxton Twp--19th Precinct,253,13,0,0,266,22368,448,13,0,22829
JUSTICE/SUPREME COURT,Maureen E. LALLY-GREEN,Lower Paxton Twp--20th Precinct,209,4,0,0,213,22368,448,13,0,22829
JUSTICE/SUPREME COURT,Maureen E. LALLY-GREEN,Lower Paxton Twp--21st Precinct,246,6,0,0,252,22368,448,13,0,22829
JUSTICE/SUPREME COURT,Maureen E. LALLY-GREEN,Lower Paxton Twp--22nd Precinct,214,4,0,0,218,22368,448,13,0,22829
JUSTICE/SUPREME COURT,Maureen E. LALLY-GREEN,Lower Paxton Twp--23rd Precinct,200,5,0,0,205,22368,448,13,0,22829
JUSTICE/SUPREME COURT,Maureen E. LALLY-GREEN,Lower Paxton Twp--24th Precinct,198,6,0,0,204,22368,448,13,0,22829
JUSTICE/SUPREME COURT,Maureen E. LALLY-GREEN,Lower Paxton Twp--25th Precinct,119,3,0,0,122,22368,448,13,0,22829
JUSTICE/SUPREME COURT,Maureen E. LALLY-GREEN,Lower Paxton Twp--26th Precinct,192,5,0,0,197,22368,448,13,0,22829
JUSTICE/SUPREME COURT,Maureen E. LALLY-GREEN,Lower Paxton Twp--27th Precinct,152,1,0,0,153,22368,448,13,0,22829
JUSTICE/SUPREME COURT,Maureen E. LALLY-GREEN,Lower Swatara Twp--1st Precinct,277,4,0,0,281,22368,448,13,0,22829
JUSTICE/SUPREME COURT,Maureen E. LALLY-GREEN,Lower Swatara Twp--2nd Precinct,217,4,0,0,221,22368,448,13,0,22829
JUSTICE/SUPREME COURT,Maureen E. LALLY-GREEN,Lower Swatara Twp--3rd Precinct,187,16,0,0,203,22368,448,13,0,22829
JUSTICE/SUPREME COURT,Maureen E. LALLY-GREEN,Lower Swatara Twp--4th Precinct,167,0,0,0,167,22368,448,13,0,22829
JUSTICE/SUPREME COURT,Maureen E. LALLY-GREEN,Lykens Township,70,0,0,0,70,22368,448,13,0,22829
JUSTICE/SUPREME COURT,Maureen E. LALLY-GREEN,Middle Paxton Twp--1st Precinct,219,0,0,0,219,22368,448,13,0,22829
JUSTICE/SUPREME COURT,Maureen E. LALLY-GREEN,Middle Paxton Twp--2nd Precinct,182,1,0,0,183,22368,448,13,0,22829
JUSTICE/SUPREME COURT,Maureen E. LALLY-GREEN,Middle Paxton Twp--3rd Precinct,266,2,0,0,268,22368,448,13,0,22829
JUSTICE/SUPREME COURT,Maureen E. LALLY-GREEN,Mifflin Township,56,0,0,0,56,22368,448,13,0,22829
JUSTICE/SUPREME COURT,Maureen E. LALLY-GREEN,Reed Township,34,0,0,0,34,22368,448,13,0,22829
JUSTICE/SUPREME COURT,Maureen E. LALLY-GREEN,Rush Township,29,0,0,0,29,22368,448,13,0,22829
JUSTICE/SUPREME COURT,Maureen E. LALLY-GREEN,South Hanover Twp--1st Precinct,210,2,0,0,212,22368,448,13,0,22829
JUSTICE/SUPREME COURT,Maureen E. LALLY-GREEN,South Hanover Twp--2nd Precinct,285,6,0,0,291,22368,448,13,0,22829
JUSTICE/SUPREME COURT,Maureen E. LALLY-GREEN,South Hanover Twp--3rd Precinct,162,1,0,0,163,22368,448,13,0,22829
JUSTICE/SUPREME COURT,Maureen E. LALLY-GREEN,Susquehanna Twp--1st Ward,250,10,0,0,260,22368,448,13,0,22829
JUSTICE/SUPREME COURT,Maureen E. LALLY-GREEN,Susquehanna Twp--2nd Ward,423,17,0,0,440,22368,448,13,0,22829
JUSTICE/SUPREME COURT,Maureen E. LALLY-GREEN,Susquehanna Twp--3rd Ward,142,0,0,0,142,22368,448,13,0,22829
JUSTICE/SUPREME COURT,Maureen E. LALLY-GREEN,Susquehanna Twp--4th Ward,166,5,0,0,171,22368,448,13,0,22829
JUSTICE/SUPREME COURT,Maureen E. LALLY-GREEN,Susquehanna Twp--5th Ward,217,4,0,0,221,22368,448,13,0,22829
JUSTICE/SUPREME COURT,Maureen E. LALLY-GREEN,Susquehanna Twp--6th Ward,256,9,0,0,265,22368,448,13,0,22829
JUSTICE/SUPREME COURT,Maureen E. LALLY-GREEN,Susquehanna Twp--7th Ward,125,0,0,0,125,22368,448,13,0,22829
JUSTICE/SUPREME COURT,Maureen E. LALLY-GREEN,Susquehanna Twp--8th Ward,330,11,0,0,341,22368,448,13,0,22829
JUSTICE/SUPREME COURT,Maureen E. LALLY-GREEN,Susquehanna Twp--9th Ward,199,3,0,0,202,22368,448,13,0,22829
JUSTICE/SUPREME COURT,Maureen E. LALLY-GREEN,Swatara Township--1st Ward,210,3,0,0,213,22368,448,13,0,22829
JUSTICE/SUPREME COURT,Maureen E. LALLY-GREEN,Swatara Township--2nd Ward,122,11,0,0,133,22368,448,13,0,22829
JUSTICE/SUPREME COURT,Maureen E. LALLY-GREEN,Swatara Township--3rd Ward,142,2,0,0,144,22368,448,13,0,22829
JUSTICE/SUPREME COURT,Maureen E. LALLY-GREEN,Swatara Township--4th Ward,230,8,0,0,238,22368,448,13,0,22829
JUSTICE/SUPREME COURT,Maureen E. LALLY-GREEN,Swatara Township--5th Ward,332,3,0,0,335,22368,448,13,0,22829
JUSTICE/SUPREME COURT,Maureen E. LALLY-GREEN,Swatara Township--6th Ward,266,1,1,0,268,22368,448,13,0,22829
JUSTICE/SUPREME COURT,Maureen E. LALLY-GREEN,Swatara Township--7th Ward,248,7,0,0,255,22368,448,13,0,22829
JUSTICE/SUPREME COURT,Maureen E. LALLY-GREEN,Swatara Township--8th Ward,346,3,0,0,349,22368,448,13,0,22829
JUSTICE/SUPREME COURT,Maureen E. LALLY-GREEN,Swatara Township--9th Ward,120,5,0,0,125,22368,448,13,0,22829
JUSTICE/SUPREME COURT,Maureen E. LALLY-GREEN,Upper Paxton Twp--1st Precinct,221,1,0,0,222,22368,448,13,0,22829
JUSTICE/SUPREME COURT,Maureen E. LALLY-GREEN,Upper Paxton Twp--2nd Precinct,129,2,0,0,131,22368,448,13,0,22829
JUSTICE/SUPREME COURT,Maureen E. LALLY-GREEN,Washington Township,194,5,0,0,199,22368,448,13,0,22829
JUSTICE/SUPREME COURT,Maureen E. LALLY-GREEN,Wayne Township,162,0,1,0,163,22368,448,13,0,22829
JUSTICE/SUPREME COURT,Maureen E. LALLY-GREEN,West Hanover Twp--1st Precinct,217,5,0,0,222,22368,448,13,0,22829
JUSTICE/SUPREME COURT,Maureen E. LALLY-GREEN,West Hanover Twp--2nd Precinct,200,6,1,0,207,22368,448,13,0,22829
JUSTICE/SUPREME COURT,Maureen E. LALLY-GREEN,West Hanover Twp--3rd Precinct,496,12,1,0,509,22368,448,13,0,22829
JUSTICE/SUPREME COURT,Maureen E. LALLY-GREEN,West Hanover Twp--4th Precinct,272,1,0,0,273,22368,448,13,0,22829
JUSTICE/SUPREME COURT,Maureen E. LALLY-GREEN,Wiconisco Twp--1st Precinct,55,1,0,0,56,22368,448,13,0,22829
JUSTICE/SUPREME COURT,Maureen E. LALLY-GREEN,Wiconisco Twp--2nd Precinct,45,1,0,0,46,22368,448,13,0,22829
JUSTICE/SUPREME COURT,Maureen E. LALLY-GREEN,Williams Twp,107,0,0,0,107,22368,448,13,0,22829
JUSTICE/SUPREME COURT,Mike  KRANCER,"City--1st Ward, 1st Precinct",27,3,0,0,30,20047,439,6,0,20492
JUSTICE/SUPREME COURT,Mike  KRANCER,"City--1st Ward, 2nd Precinct",66,1,0,0,67,20047,439,6,0,20492
JUSTICE/SUPREME COURT,Mike  KRANCER,"City--1st Ward, 3rd Precinct",14,0,0,0,14,20047,439,6,0,20492
JUSTICE/SUPREME COURT,Mike  KRANCER,"City--2nd Ward, 1st Precinct",23,0,0,0,23,20047,439,6,0,20492
JUSTICE/SUPREME COURT,Mike  KRANCER,"City--2nd Ward, 2nd Precinct",18,1,0,0,19,20047,439,6,0,20492
JUSTICE/SUPREME COURT,Mike  KRANCER,City--3rd Ward,33,0,0,0,33,20047,439,6,0,20492
JUSTICE/SUPREME COURT,Mike  KRANCER,City--4th Ward,46,1,0,0,47,20047,439,6,0,20492
JUSTICE/SUPREME COURT,Mike  KRANCER,City--5th Ward,84,3,0,0,87,20047,439,6,0,20492
JUSTICE/SUPREME COURT,Mike  KRANCER,City--6th Ward,44,0,0,0,44,20047,439,6,0,20492
JUSTICE/SUPREME COURT,Mike  KRANCER,"City--7th Ward, 1st Precinct",22,1,0,0,23,20047,439,6,0,20492
JUSTICE/SUPREME COURT,Mike  KRANCER,"City--7th Ward, 2nd Precinct",14,2,0,0,16,20047,439,6,0,20492
JUSTICE/SUPREME COURT,Mike  KRANCER,City--8th Ward,12,0,0,0,12,20047,439,6,0,20492
JUSTICE/SUPREME COURT,Mike  KRANCER,"City--9th Ward, 1st Precinct",22,0,0,0,22,20047,439,6,0,20492
JUSTICE/SUPREME COURT,Mike  KRANCER,"City--9th Ward, 2nd Precinct",11,0,0,0,11,20047,439,6,0,20492
JUSTICE/SUPREME COURT,Mike  KRANCER,"City--9th Ward, 3rd Precinct",22,0,0,0,22,20047,439,6,0,20492
JUSTICE/SUPREME COURT,Mike  KRANCER,"City--9th Ward, 4th Precinct",63,3,0,0,66,20047,439,6,0,20492
JUSTICE/SUPREME COURT,Mike  KRANCER,"City--9th Ward, 5th Precinct",47,0,0,0,47,20047,439,6,0,20492
JUSTICE/SUPREME COURT,Mike  KRANCER,"City--10th Ward, 1st Precinct",41,2,0,0,43,20047,439,6,0,20492
JUSTICE/SUPREME COURT,Mike  KRANCER,"City--10th Ward, 2nd Precinct",10,0,0,0,10,20047,439,6,0,20492
JUSTICE/SUPREME COURT,Mike  KRANCER,"City--10th Ward, 3rd Precinct",38,1,0,0,39,20047,439,6,0,20492
JUSTICE/SUPREME COURT,Mike  KRANCER,"City--10th Ward, 4th Precinct",20,0,0,0,20,20047,439,6,0,20492
JUSTICE/SUPREME COURT,Mike  KRANCER,City--11th Ward,24,10,0,0,34,20047,439,6,0,20492
JUSTICE/SUPREME COURT,Mike  KRANCER,City--12th Ward,50,3,0,0,53,20047,439,6,0,20492
JUSTICE/SUPREME COURT,Mike  KRANCER,"City--13th Ward, 1st Precinct",46,0,0,0,46,20047,439,6,0,20492
JUSTICE/SUPREME COURT,Mike  KRANCER,"City--13th Ward, 2nd Precinct",64,4,0,0,68,20047,439,6,0,20492
JUSTICE/SUPREME COURT,Mike  KRANCER,"City--13th Ward, 3rd Precinct",70,1,0,0,71,20047,439,6,0,20492
JUSTICE/SUPREME COURT,Mike  KRANCER,City--14th Ward,102,0,0,0,102,20047,439,6,0,20492
JUSTICE/SUPREME COURT,Mike  KRANCER,City--15th Ward,16,0,0,0,16,20047,439,6,0,20492
JUSTICE/SUPREME COURT,Mike  KRANCER,Berrysburg Borough,39,0,0,0,39,20047,439,6,0,20492
JUSTICE/SUPREME COURT,Mike  KRANCER,Dauphin Borough,100,0,0,0,100,20047,439,6,0,20492
JUSTICE/SUPREME COURT,Mike  KRANCER,Elizabethville Borough,111,0,0,0,111,20047,439,6,0,20492
JUSTICE/SUPREME COURT,Mike  KRANCER,Gratz Borough,55,2,0,0,57,20047,439,6,0,20492
JUSTICE/SUPREME COURT,Mike  KRANCER,Halifax Borough,53,2,0,0,55,20047,439,6,0,20492
JUSTICE/SUPREME COURT,Mike  KRANCER,Highspire--1st Precinct,71,2,0,0,73,20047,439,6,0,20492
JUSTICE/SUPREME COURT,Mike  KRANCER,Highspire--2nd Precinct,87,1,0,0,88,20047,439,6,0,20492
JUSTICE/SUPREME COURT,Mike  KRANCER,Hummelstown--1st Precinct,114,3,0,0,117,20047,439,6,0,20492
JUSTICE/SUPREME COURT,Mike  KRANCER,Hummelstown--2nd Precinct,258,4,0,0,262,20047,439,6,0,20492
JUSTICE/SUPREME COURT,Mike  KRANCER,Lykens Borough--1st Ward,55,0,0,0,55,20047,439,6,0,20492
JUSTICE/SUPREME COURT,Mike  KRANCER,Lykens Borough--2nd Ward,73,2,0,0,75,20047,439,6,0,20492
JUSTICE/SUPREME COURT,Mike  KRANCER,"Middletown--1st Ward, 1st Precinct",51,0,0,0,51,20047,439,6,0,20492
JUSTICE/SUPREME COURT,Mike  KRANCER,"Middletown--1st Ward, 2nd Precinct",93,6,0,0,99,20047,439,6,0,20492
JUSTICE/SUPREME COURT,Mike  KRANCER,"Middletown--2nd Ward, 1st Precinct",102,1,0,0,103,20047,439,6,0,20492
JUSTICE/SUPREME COURT,Mike  KRANCER,"Middletown--2nd Ward, 2nd Precinct",96,3,0,0,99,20047,439,6,0,20492
JUSTICE/SUPREME COURT,Mike  KRANCER,"Middletown--3rd Ward, 1st Precinct",84,1,0,0,85,20047,439,6,0,20492
JUSTICE/SUPREME COURT,Mike  KRANCER,"Middletown--3rd Ward, 2nd Precinct",127,0,0,0,127,20047,439,6,0,20492
JUSTICE/SUPREME COURT,Mike  KRANCER,Millersburg--1st Ward,94,4,0,0,98,20047,439,6,0,20492
JUSTICE/SUPREME COURT,Mike  KRANCER,Millersburg--2nd Ward,120,3,0,0,123,20047,439,6,0,20492
JUSTICE/SUPREME COURT,Mike  KRANCER,Paxtang Borough,135,0,0,0,135,20047,439,6,0,20492
JUSTICE/SUPREME COURT,Mike  KRANCER,Penbrook Borough--1st Ward,33,1,0,0,34,20047,439,6,0,20492
JUSTICE/SUPREME COURT,Mike  KRANCER,Penbrook Borough--2nd Ward,43,1,0,0,44,20047,439,6,0,20492
JUSTICE/SUPREME COURT,Mike  KRANCER,Penbrook Borough--3rd Ward,43,0,0,0,43,20047,439,6,0,20492
JUSTICE/SUPREME COURT,Mike  KRANCER,Penbrook Borough--4th Ward,47,0,0,0,47,20047,439,6,0,20492
JUSTICE/SUPREME COURT,Mike  KRANCER,Royalton Borough--1st Ward,19,0,0,0,19,20047,439,6,0,20492
JUSTICE/SUPREME COURT,Mike  KRANCER,Royalton Borough--2nd Ward,52,0,0,0,52,20047,439,6,0,20492
JUSTICE/SUPREME COURT,Mike  KRANCER,Steelton--1st Ward,71,2,0,0,73,20047,439,6,0,20492
JUSTICE/SUPREME COURT,Mike  KRANCER,"Steelton--2nd Ward, 1st Precinct",43,2,0,0,45,20047,439,6,0,20492
JUSTICE/SUPREME COURT,Mike  KRANCER,"Steelton--2nd Ward, 2nd Precinct",40,0,0,0,40,20047,439,6,0,20492
JUSTICE/SUPREME COURT,Mike  KRANCER,"Steelton--3rd Ward, 1st Precinct",21,0,0,0,21,20047,439,6,0,20492
JUSTICE/SUPREME COURT,Mike  KRANCER,"Steelton--3rd Ward, 2nd Precinct",38,0,0,0,38,20047,439,6,0,20492
JUSTICE/SUPREME COURT,Mike  KRANCER,Steelton--4th Ward,35,0,0,0,35,20047,439,6,0,20492
JUSTICE/SUPREME COURT,Mike  KRANCER,Pillow Borough,31,0,0,0,31,20047,439,6,0,20492
JUSTICE/SUPREME COURT,Mike  KRANCER,Williamstown--1st Ward,57,0,0,0,57,20047,439,6,0,20492
JUSTICE/SUPREME COURT,Mike  KRANCER,Williamstown--2nd Ward,39,0,0,0,39,20047,439,6,0,20492
JUSTICE/SUPREME COURT,Mike  KRANCER,Conewago Twp--1st Precinct,212,1,0,0,213,20047,439,6,0,20492
JUSTICE/SUPREME COURT,Mike  KRANCER,Conewago Twp--2nd Precinct,151,7,0,0,158,20047,439,6,0,20492
JUSTICE/SUPREME COURT,Mike  KRANCER,Derry Township--1st Precinct,223,4,0,0,227,20047,439,6,0,20492
JUSTICE/SUPREME COURT,Mike  KRANCER,Derry Township--2nd Precinct,178,3,0,0,181,20047,439,6,0,20492
JUSTICE/SUPREME COURT,Mike  KRANCER,Derry Township--3rd Precinct,117,3,0,0,120,20047,439,6,0,20492
JUSTICE/SUPREME COURT,Mike  KRANCER,Derry Township--4th Precinct,104,4,0,0,108,20047,439,6,0,20492
JUSTICE/SUPREME COURT,Mike  KRANCER,Derry Township--5th Precinct,80,2,0,0,82,20047,439,6,0,20492
JUSTICE/SUPREME COURT,Mike  KRANCER,Derry Township--6th Precinct,114,0,1,0,115,20047,439,6,0,20492
JUSTICE/SUPREME COURT,Mike  KRANCER,Derry Township--7th Precinct,271,8,0,0,279,20047,439,6,0,20492
JUSTICE/SUPREME COURT,Mike  KRANCER,Derry Township--8th Precinct,112,0,0,0,112,20047,439,6,0,20492
JUSTICE/SUPREME COURT,Mike  KRANCER,Derry Township--9th Precinct,78,3,0,0,81,20047,439,6,0,20492
JUSTICE/SUPREME COURT,Mike  KRANCER,Derry Township--10th Precinct,171,1,0,0,172,20047,439,6,0,20492
JUSTICE/SUPREME COURT,Mike  KRANCER,Derry Township--11th Precinct,214,7,0,0,221,20047,439,6,0,20492
JUSTICE/SUPREME COURT,Mike  KRANCER,Derry Township--12th Precinct,124,0,0,0,124,20047,439,6,0,20492
JUSTICE/SUPREME COURT,Mike  KRANCER,Derry Township--13th Precinct,162,4,0,0,166,20047,439,6,0,20492
JUSTICE/SUPREME COURT,Mike  KRANCER,Derry Township--14th Precinct,97,4,0,0,101,20047,439,6,0,20492
JUSTICE/SUPREME COURT,Mike  KRANCER,Derry Township--15th Precinct,220,3,1,0,224,20047,439,6,0,20492
JUSTICE/SUPREME COURT,Mike  KRANCER,East Hanover Township--1st Precinct,233,8,0,0,241,20047,439,6,0,20492
JUSTICE/SUPREME COURT,Mike  KRANCER,East Hanover Township--2nd Precinct,278,4,0,0,282,20047,439,6,0,20492
JUSTICE/SUPREME COURT,Mike  KRANCER,Halifax Twp--1st Precinct,154,3,0,0,157,20047,439,6,0,20492
JUSTICE/SUPREME COURT,Mike  KRANCER,Halifax Twp--2nd Precinct,210,7,0,0,217,20047,439,6,0,20492
JUSTICE/SUPREME COURT,Mike  KRANCER,Jackson Township,140,1,0,0,141,20047,439,6,0,20492
JUSTICE/SUPREME COURT,Mike  KRANCER,Jefferson Township,51,0,0,0,51,20047,439,6,0,20492
JUSTICE/SUPREME COURT,Mike  KRANCER,Londonderry Twp--1st Precinct,230,0,0,0,230,20047,439,6,0,20492
JUSTICE/SUPREME COURT,Mike  KRANCER,Londonderry Twp--2nd Precinct,203,4,0,0,207,20047,439,6,0,20492
JUSTICE/SUPREME COURT,Mike  KRANCER,Londonderry Twp--3rd Precinct,81,1,0,0,82,20047,439,6,0,20492
JUSTICE/SUPREME COURT,Mike  KRANCER,Lower Paxton Twp--1st Precinct,143,3,0,0,146,20047,439,6,0,20492
JUSTICE/SUPREME COURT,Mike  KRANCER,Lower Paxton Twp--2nd Precinct,134,4,0,0,138,20047,439,6,0,20492
JUSTICE/SUPREME COURT,Mike  KRANCER,Lower Paxton Twp--3rd precinct,259,8,0,0,267,20047,439,6,0,20492
JUSTICE/SUPREME COURT,Mike  KRANCER,Lower Paxton Twp--4th Precinct,191,3,0,0,194,20047,439,6,0,20492
JUSTICE/SUPREME COURT,Mike  KRANCER,Lower Paxton Twp--5th Precinct,156,2,0,0,158,20047,439,6,0,20492
JUSTICE/SUPREME COURT,Mike  KRANCER,Lower Paxton Twp--6th Precinct,109,3,0,0,112,20047,439,6,0,20492
JUSTICE/SUPREME COURT,Mike  KRANCER,Lower Paxton Twp--7th Precinct,242,3,0,0,245,20047,439,6,0,20492
JUSTICE/SUPREME COURT,Mike  KRANCER,Lower Paxton Twp--8th Precinct,104,2,0,0,106,20047,439,6,0,20492
JUSTICE/SUPREME COURT,Mike  KRANCER,Lower Paxton Twp--9th Precinct,147,3,0,0,150,20047,439,6,0,20492
JUSTICE/SUPREME COURT,Mike  KRANCER,Lower Paxton Twp--10th Precinct,77,2,0,0,79,20047,439,6,0,20492
JUSTICE/SUPREME COURT,Mike  KRANCER,Lower Paxton Twp--11th Precinct,144,1,1,0,146,20047,439,6,0,20492
JUSTICE/SUPREME COURT,Mike  KRANCER,Lower Paxton Twp--12th Precinct,196,8,0,0,204,20047,439,6,0,20492
JUSTICE/SUPREME COURT,Mike  KRANCER,Lower Paxton Twp--13th Precinct,182,3,0,0,185,20047,439,6,0,20492
JUSTICE/SUPREME COURT,Mike  KRANCER,Lower Paxton Twp--14th Precinct,84,3,1,0,88,20047,439,6,0,20492
JUSTICE/SUPREME COURT,Mike  KRANCER,Lower Paxton Twp--15th Precinct,158,5,0,0,163,20047,439,6,0,20492
JUSTICE/SUPREME COURT,Mike  KRANCER,Lower Paxton Twp--16th Precinct,282,11,0,0,293,20047,439,6,0,20492
JUSTICE/SUPREME COURT,Mike  KRANCER,Lower Paxton Twp--17th Precinct,120,3,0,0,123,20047,439,6,0,20492
JUSTICE/SUPREME COURT,Mike  KRANCER,Lower Paxton Twp--18th Precinct,114,0,0,0,114,20047,439,6,0,20492
JUSTICE/SUPREME COURT,Mike  KRANCER,Lower Paxton Twp--19th Precinct,203,13,0,0,216,20047,439,6,0,20492
JUSTICE/SUPREME COURT,Mike  KRANCER,Lower Paxton Twp--20th Precinct,191,5,0,0,196,20047,439,6,0,20492
JUSTICE/SUPREME COURT,Mike  KRANCER,Lower Paxton Twp--21st Precinct,222,5,0,0,227,20047,439,6,0,20492
JUSTICE/SUPREME COURT,Mike  KRANCER,Lower Paxton Twp--22nd Precinct,194,3,0,0,197,20047,439,6,0,20492
JUSTICE/SUPREME COURT,Mike  KRANCER,Lower Paxton Twp--23rd Precinct,181,5,0,0,186,20047,439,6,0,20492
JUSTICE/SUPREME COURT,Mike  KRANCER,Lower Paxton Twp--24th Precinct,177,6,0,0,183,20047,439,6,0,20492
JUSTICE/SUPREME COURT,Mike  KRANCER,Lower Paxton Twp--25th Precinct,95,3,0,0,98,20047,439,6,0,20492
JUSTICE/SUPREME COURT,Mike  KRANCER,Lower Paxton Twp--26th Precinct,166,4,0,0,170,20047,439,6,0,20492
JUSTICE/SUPREME COURT,Mike  KRANCER,Lower Paxton Twp--27th Precinct,142,0,0,0,142,20047,439,6,0,20492
JUSTICE/SUPREME COURT,Mike  KRANCER,Lower Swatara Twp--1st Precinct,258,4,0,0,262,20047,439,6,0,20492
JUSTICE/SUPREME COURT,Mike  KRANCER,Lower Swatara Twp--2nd Precinct,214,3,0,0,217,20047,439,6,0,20492
JUSTICE/SUPREME COURT,Mike  KRANCER,Lower Swatara Twp--3rd Precinct,182,20,0,0,202,20047,439,6,0,20492
JUSTICE/SUPREME COURT,Mike  KRANCER,Lower Swatara Twp--4th Precinct,170,0,0,0,170,20047,439,6,0,20492
JUSTICE/SUPREME COURT,Mike  KRANCER,Lykens Township,73,0,0,0,73,20047,439,6,0,20492
JUSTICE/SUPREME COURT,Mike  KRANCER,Middle Paxton Twp--1st Precinct,210,0,0,0,210,20047,439,6,0,20492
JUSTICE/SUPREME COURT,Mike  KRANCER,Middle Paxton Twp--2nd Precinct,169,1,0,0,170,20047,439,6,0,20492
JUSTICE/SUPREME COURT,Mike  KRANCER,Middle Paxton Twp--3rd Precinct,242,1,0,0,243,20047,439,6,0,20492
JUSTICE/SUPREME COURT,Mike  KRANCER,Mifflin Township,66,0,0,0,66,20047,439,6,0,20492
JUSTICE/SUPREME COURT,Mike  KRANCER,Reed Township,32,0,0,0,32,20047,439,6,0,20492
JUSTICE/SUPREME COURT,Mike  KRANCER,Rush Township,29,0,0,0,29,20047,439,6,0,20492
JUSTICE/SUPREME COURT,Mike  KRANCER,South Hanover Twp--1st Precinct,210,3,0,0,213,20047,439,6,0,20492
JUSTICE/SUPREME COURT,Mike  KRANCER,South Hanover Twp--2nd Precinct,247,5,0,0,252,20047,439,6,0,20492
JUSTICE/SUPREME COURT,Mike  KRANCER,South Hanover Twp--3rd Precinct,157,1,0,0,158,20047,439,6,0,20492
JUSTICE/SUPREME COURT,Mike  KRANCER,Susquehanna Twp--1st Ward,195,8,0,0,203,20047,439,6,0,20492
JUSTICE/SUPREME COURT,Mike  KRANCER,Susquehanna Twp--2nd Ward,376,16,0,0,392,20047,439,6,0,20492
JUSTICE/SUPREME COURT,Mike  KRANCER,Susquehanna Twp--3rd Ward,115,0,0,0,115,20047,439,6,0,20492
JUSTICE/SUPREME COURT,Mike  KRANCER,Susquehanna Twp--4th Ward,144,3,0,0,147,20047,439,6,0,20492
JUSTICE/SUPREME COURT,Mike  KRANCER,Susquehanna Twp--5th Ward,186,4,0,0,190,20047,439,6,0,20492
JUSTICE/SUPREME COURT,Mike  KRANCER,Susquehanna Twp--6th Ward,241,5,0,0,246,20047,439,6,0,20492
JUSTICE/SUPREME COURT,Mike  KRANCER,Susquehanna Twp--7th Ward,106,0,0,0,106,20047,439,6,0,20492
JUSTICE/SUPREME COURT,Mike  KRANCER,Susquehanna Twp--8th Ward,258,9,0,0,267,20047,439,6,0,20492
JUSTICE/SUPREME COURT,Mike  KRANCER,Susquehanna Twp--9th Ward,159,3,0,0,162,20047,439,6,0,20492
JUSTICE/SUPREME COURT,Mike  KRANCER,Swatara Township--1st Ward,165,3,0,0,168,20047,439,6,0,20492
JUSTICE/SUPREME COURT,Mike  KRANCER,Swatara Township--2nd Ward,89,9,0,0,98,20047,439,6,0,20492
JUSTICE/SUPREME COURT,Mike  KRANCER,Swatara Township--3rd Ward,121,6,0,0,127,20047,439,6,0,20492
JUSTICE/SUPREME COURT,Mike  KRANCER,Swatara Township--4th Ward,213,9,0,0,222,20047,439,6,0,20492
JUSTICE/SUPREME COURT,Mike  KRANCER,Swatara Township--5th Ward,304,2,0,0,306,20047,439,6,0,20492
JUSTICE/SUPREME COURT,Mike  KRANCER,Swatara Township--6th Ward,256,2,0,0,258,20047,439,6,0,20492
JUSTICE/SUPREME COURT,Mike  KRANCER,Swatara Township--7th Ward,243,8,0,0,251,20047,439,6,0,20492
JUSTICE/SUPREME COURT,Mike  KRANCER,Swatara Township--8th Ward,325,6,0,0,331,20047,439,6,0,20492
JUSTICE/SUPREME COURT,Mike  KRANCER,Swatara Township--9th Ward,112,3,0,0,115,20047,439,6,0,20492
JUSTICE/SUPREME COURT,Mike  KRANCER,Upper Paxton Twp--1st Precinct,212,2,0,0,214,20047,439,6,0,20492
JUSTICE/SUPREME COURT,Mike  KRANCER,Upper Paxton Twp--2nd Precinct,130,2,0,0,132,20047,439,6,0,20492
JUSTICE/SUPREME COURT,Mike  KRANCER,Washington Township,187,6,0,0,193,20047,439,6,0,20492
JUSTICE/SUPREME COURT,Mike  KRANCER,Wayne Township,165,0,0,0,165,20047,439,6,0,20492
JUSTICE/SUPREME COURT,Mike  KRANCER,West Hanover Twp--1st Precinct,217,3,1,0,221,20047,439,6,0,20492
JUSTICE/SUPREME COURT,Mike  KRANCER,West Hanover Twp--2nd Precinct,198,6,1,0,205,20047,439,6,0,20492
JUSTICE/SUPREME COURT,Mike  KRANCER,West Hanover Twp--3rd Precinct,419,12,0,0,431,20047,439,6,0,20492
JUSTICE/SUPREME COURT,Mike  KRANCER,West Hanover Twp--4th Precinct,259,2,0,0,261,20047,439,6,0,20492
JUSTICE/SUPREME COURT,Mike  KRANCER,Wiconisco Twp--1st Precinct,53,1,0,0,54,20047,439,6,0,20492
JUSTICE/SUPREME COURT,Mike  KRANCER,Wiconisco Twp--2nd Precinct,42,1,0,0,43,20047,439,6,0,20492
JUSTICE/SUPREME COURT,Mike  KRANCER,Williams Twp,98,1,0,0,99,20047,439,6,0,20492
JUSTICE/SUPREME COURT,Seamus  McCAFFERY,"City--1st Ward, 1st Precinct",62,2,0,0,64,18675,312,11,0,18998
JUSTICE/SUPREME COURT,Seamus  McCAFFERY,"City--1st Ward, 2nd Precinct",110,1,1,0,112,18675,312,11,0,18998
JUSTICE/SUPREME COURT,Seamus  McCAFFERY,"City--1st Ward, 3rd Precinct",59,0,0,0,59,18675,312,11,0,18998
JUSTICE/SUPREME COURT,Seamus  McCAFFERY,"City--2nd Ward, 1st Precinct",24,0,0,0,24,18675,312,11,0,18998
JUSTICE/SUPREME COURT,Seamus  McCAFFERY,"City--2nd Ward, 2nd Precinct",68,0,0,0,68,18675,312,11,0,18998
JUSTICE/SUPREME COURT,Seamus  McCAFFERY,City--3rd Ward,81,1,0,0,82,18675,312,11,0,18998
JUSTICE/SUPREME COURT,Seamus  McCAFFERY,City--4th Ward,127,4,0,0,131,18675,312,11,0,18998
JUSTICE/SUPREME COURT,Seamus  McCAFFERY,City--5th Ward,253,6,0,0,259,18675,312,11,0,18998
JUSTICE/SUPREME COURT,Seamus  McCAFFERY,City--6th Ward,118,2,2,0,122,18675,312,11,0,18998
JUSTICE/SUPREME COURT,Seamus  McCAFFERY,"City--7th Ward, 1st Precinct",46,2,0,0,48,18675,312,11,0,18998
JUSTICE/SUPREME COURT,Seamus  McCAFFERY,"City--7th Ward, 2nd Precinct",115,0,0,0,115,18675,312,11,0,18998
JUSTICE/SUPREME COURT,Seamus  McCAFFERY,City--8th Ward,114,0,0,0,114,18675,312,11,0,18998
JUSTICE/SUPREME COURT,Seamus  McCAFFERY,"City--9th Ward, 1st Precinct",37,2,0,0,39,18675,312,11,0,18998
JUSTICE/SUPREME COURT,Seamus  McCAFFERY,"City--9th Ward, 2nd Precinct",71,0,0,0,71,18675,312,11,0,18998
JUSTICE/SUPREME COURT,Seamus  McCAFFERY,"City--9th Ward, 3rd Precinct",139,1,0,0,140,18675,312,11,0,18998
JUSTICE/SUPREME COURT,Seamus  McCAFFERY,"City--9th Ward, 4th Precinct",136,2,0,0,138,18675,312,11,0,18998
JUSTICE/SUPREME COURT,Seamus  McCAFFERY,"City--9th Ward, 5th Precinct",85,5,0,0,90,18675,312,11,0,18998
JUSTICE/SUPREME COURT,Seamus  McCAFFERY,"City--10th Ward, 1st Precinct",186,3,0,0,189,18675,312,11,0,18998
JUSTICE/SUPREME COURT,Seamus  McCAFFERY,"City--10th Ward, 2nd Precinct",76,0,0,0,76,18675,312,11,0,18998
JUSTICE/SUPREME COURT,Seamus  McCAFFERY,"City--10th Ward, 3rd Precinct",76,0,0,0,76,18675,312,11,0,18998
JUSTICE/SUPREME COURT,Seamus  McCAFFERY,"City--10th Ward, 4th Precinct",100,0,0,0,100,18675,312,11,0,18998
JUSTICE/SUPREME COURT,Seamus  McCAFFERY,City--11th Ward,78,15,0,0,93,18675,312,11,0,18998
JUSTICE/SUPREME COURT,Seamus  McCAFFERY,City--12th Ward,206,5,0,0,211,18675,312,11,0,18998
JUSTICE/SUPREME COURT,Seamus  McCAFFERY,"City--13th Ward, 1st Precinct",90,0,0,0,90,18675,312,11,0,18998
JUSTICE/SUPREME COURT,Seamus  McCAFFERY,"City--13th Ward, 2nd Precinct",121,1,0,0,122,18675,312,11,0,18998
JUSTICE/SUPREME COURT,Seamus  McCAFFERY,"City--13th Ward, 3rd Precinct",166,1,0,0,167,18675,312,11,0,18998
JUSTICE/SUPREME COURT,Seamus  McCAFFERY,City--14th Ward,264,6,0,0,270,18675,312,11,0,18998
JUSTICE/SUPREME COURT,Seamus  McCAFFERY,City--15th Ward,69,1,0,0,70,18675,312,11,0,18998
JUSTICE/SUPREME COURT,Seamus  McCAFFERY,Berrysburg Borough,27,0,0,0,27,18675,312,11,0,18998
JUSTICE/SUPREME COURT,Seamus  McCAFFERY,Dauphin Borough,70,1,0,0,71,18675,312,11,0,18998
JUSTICE/SUPREME COURT,Seamus  McCAFFERY,Elizabethville Borough,63,3,0,0,66,18675,312,11,0,18998
JUSTICE/SUPREME COURT,Seamus  McCAFFERY,Gratz Borough,33,0,0,0,33,18675,312,11,0,18998
JUSTICE/SUPREME COURT,Seamus  McCAFFERY,Halifax Borough,25,0,0,0,25,18675,312,11,0,18998
JUSTICE/SUPREME COURT,Seamus  McCAFFERY,Highspire--1st Precinct,86,2,0,0,88,18675,312,11,0,18998
JUSTICE/SUPREME COURT,Seamus  McCAFFERY,Highspire--2nd Precinct,80,1,0,0,81,18675,312,11,0,18998
JUSTICE/SUPREME COURT,Seamus  McCAFFERY,Hummelstown--1st Precinct,99,1,0,0,100,18675,312,11,0,18998
JUSTICE/SUPREME COURT,Seamus  McCAFFERY,Hummelstown--2nd Precinct,175,3,0,0,178,18675,312,11,0,18998
JUSTICE/SUPREME COURT,Seamus  McCAFFERY,Lykens Borough--1st Ward,44,1,0,0,45,18675,312,11,0,18998
JUSTICE/SUPREME COURT,Seamus  McCAFFERY,Lykens Borough--2nd Ward,55,1,0,0,56,18675,312,11,0,18998
JUSTICE/SUPREME COURT,Seamus  McCAFFERY,"Middletown--1st Ward, 1st Precinct",37,0,0,0,37,18675,312,11,0,18998
JUSTICE/SUPREME COURT,Seamus  McCAFFERY,"Middletown--1st Ward, 2nd Precinct",74,1,0,0,75,18675,312,11,0,18998
JUSTICE/SUPREME COURT,Seamus  McCAFFERY,"Middletown--2nd Ward, 1st Precinct",69,1,0,0,70,18675,312,11,0,18998
JUSTICE/SUPREME COURT,Seamus  McCAFFERY,"Middletown--2nd Ward, 2nd Precinct",86,3,0,0,89,18675,312,11,0,18998
JUSTICE/SUPREME COURT,Seamus  McCAFFERY,"Middletown--3rd Ward, 1st Precinct",63,1,0,0,64,18675,312,11,0,18998
JUSTICE/SUPREME COURT,Seamus  McCAFFERY,"Middletown--3rd Ward, 2nd Precinct",102,0,0,0,102,18675,312,11,0,18998
JUSTICE/SUPREME COURT,Seamus  McCAFFERY,Millersburg--1st Ward,42,0,0,0,42,18675,312,11,0,18998
JUSTICE/SUPREME COURT,Seamus  McCAFFERY,Millersburg--2nd Ward,58,0,0,0,58,18675,312,11,0,18998
JUSTICE/SUPREME COURT,Seamus  McCAFFERY,Paxtang Borough,141,3,0,0,144,18675,312,11,0,18998
JUSTICE/SUPREME COURT,Seamus  McCAFFERY,Penbrook Borough--1st Ward,35,0,0,0,35,18675,312,11,0,18998
JUSTICE/SUPREME COURT,Seamus  McCAFFERY,Penbrook Borough--2nd Ward,45,0,0,0,45,18675,312,11,0,18998
JUSTICE/SUPREME COURT,Seamus  McCAFFERY,Penbrook Borough--3rd Ward,40,0,0,0,40,18675,312,11,0,18998
JUSTICE/SUPREME COURT,Seamus  McCAFFERY,Penbrook Borough--4th Ward,54,1,0,0,55,18675,312,11,0,18998
JUSTICE/SUPREME COURT,Seamus  McCAFFERY,Royalton Borough--1st Ward,18,0,0,0,18,18675,312,11,0,18998
JUSTICE/SUPREME COURT,Seamus  McCAFFERY,Royalton Borough--2nd Ward,28,0,0,0,28,18675,312,11,0,18998
JUSTICE/SUPREME COURT,Seamus  McCAFFERY,Steelton--1st Ward,85,4,0,0,89,18675,312,11,0,18998
JUSTICE/SUPREME COURT,Seamus  McCAFFERY,"Steelton--2nd Ward, 1st Precinct",81,0,0,0,81,18675,312,11,0,18998
JUSTICE/SUPREME COURT,Seamus  McCAFFERY,"Steelton--2nd Ward, 2nd Precinct",43,0,0,0,43,18675,312,11,0,18998
JUSTICE/SUPREME COURT,Seamus  McCAFFERY,"Steelton--3rd Ward, 1st Precinct",37,0,0,0,37,18675,312,11,0,18998
JUSTICE/SUPREME COURT,Seamus  McCAFFERY,"Steelton--3rd Ward, 2nd Precinct",73,0,0,0,73,18675,312,11,0,18998
JUSTICE/SUPREME COURT,Seamus  McCAFFERY,Steelton--4th Ward,63,2,0,0,65,18675,312,11,0,18998
JUSTICE/SUPREME COURT,Seamus  McCAFFERY,Pillow Borough,27,0,0,0,27,18675,312,11,0,18998
JUSTICE/SUPREME COURT,Seamus  McCAFFERY,Williamstown--1st Ward,57,1,0,0,58,18675,312,11,0,18998
JUSTICE/SUPREME COURT,Seamus  McCAFFERY,Williamstown--2nd Ward,26,0,0,0,26,18675,312,11,0,18998
JUSTICE/SUPREME COURT,Seamus  McCAFFERY,Conewago Twp--1st Precinct,101,1,0,0,102,18675,312,11,0,18998
JUSTICE/SUPREME COURT,Seamus  McCAFFERY,Conewago Twp--2nd Precinct,77,0,0,0,77,18675,312,11,0,18998
JUSTICE/SUPREME COURT,Seamus  McCAFFERY,Derry Township--1st Precinct,156,1,0,0,157,18675,312,11,0,18998
JUSTICE/SUPREME COURT,Seamus  McCAFFERY,Derry Township--2nd Precinct,116,3,0,0,119,18675,312,11,0,18998
JUSTICE/SUPREME COURT,Seamus  McCAFFERY,Derry Township--3rd Precinct,134,3,1,0,138,18675,312,11,0,18998
JUSTICE/SUPREME COURT,Seamus  McCAFFERY,Derry Township--4th Precinct,95,2,0,0,97,18675,312,11,0,18998
JUSTICE/SUPREME COURT,Seamus  McCAFFERY,Derry Township--5th Precinct,73,0,0,0,73,18675,312,11,0,18998
JUSTICE/SUPREME COURT,Seamus  McCAFFERY,Derry Township--6th Precinct,92,0,0,0,92,18675,312,11,0,18998
JUSTICE/SUPREME COURT,Seamus  McCAFFERY,Derry Township--7th Precinct,144,8,0,0,152,18675,312,11,0,18998
JUSTICE/SUPREME COURT,Seamus  McCAFFERY,Derry Township--8th Precinct,104,0,0,0,104,18675,312,11,0,18998
JUSTICE/SUPREME COURT,Seamus  McCAFFERY,Derry Township--9th Precinct,61,2,0,0,63,18675,312,11,0,18998
JUSTICE/SUPREME COURT,Seamus  McCAFFERY,Derry Township--10th Precinct,102,3,0,0,105,18675,312,11,0,18998
JUSTICE/SUPREME COURT,Seamus  McCAFFERY,Derry Township--11th Precinct,169,2,0,0,171,18675,312,11,0,18998
JUSTICE/SUPREME COURT,Seamus  McCAFFERY,Derry Township--12th Precinct,97,5,0,0,102,18675,312,11,0,18998
JUSTICE/SUPREME COURT,Seamus  McCAFFERY,Derry Township--13th Precinct,126,4,0,0,130,18675,312,11,0,18998
JUSTICE/SUPREME COURT,Seamus  McCAFFERY,Derry Township--14th Precinct,103,2,0,0,105,18675,312,11,0,18998
JUSTICE/SUPREME COURT,Seamus  McCAFFERY,Derry Township--15th Precinct,152,4,0,0,156,18675,312,11,0,18998
JUSTICE/SUPREME COURT,Seamus  McCAFFERY,East Hanover Township--1st Precinct,149,2,0,0,151,18675,312,11,0,18998
JUSTICE/SUPREME COURT,Seamus  McCAFFERY,East Hanover Township--2nd Precinct,159,2,0,0,161,18675,312,11,0,18998
JUSTICE/SUPREME COURT,Seamus  McCAFFERY,Halifax Twp--1st Precinct,128,2,0,0,130,18675,312,11,0,18998
JUSTICE/SUPREME COURT,Seamus  McCAFFERY,Halifax Twp--2nd Precinct,130,4,0,0,134,18675,312,11,0,18998
JUSTICE/SUPREME COURT,Seamus  McCAFFERY,Jackson Township,97,1,0,0,98,18675,312,11,0,18998
JUSTICE/SUPREME COURT,Seamus  McCAFFERY,Jefferson Township,37,0,0,0,37,18675,312,11,0,18998
JUSTICE/SUPREME COURT,Seamus  McCAFFERY,Londonderry Twp--1st Precinct,117,0,0,0,117,18675,312,11,0,18998
JUSTICE/SUPREME COURT,Seamus  McCAFFERY,Londonderry Twp--2nd Precinct,132,0,0,0,132,18675,312,11,0,18998
JUSTICE/SUPREME COURT,Seamus  McCAFFERY,Londonderry Twp--3rd Precinct,63,0,0,0,63,18675,312,11,0,18998
JUSTICE/SUPREME COURT,Seamus  McCAFFERY,Lower Paxton Twp--1st Precinct,101,0,0,0,101,18675,312,11,0,18998
JUSTICE/SUPREME COURT,Seamus  McCAFFERY,Lower Paxton Twp--2nd Precinct,142,7,0,0,149,18675,312,11,0,18998
JUSTICE/SUPREME COURT,Seamus  McCAFFERY,Lower Paxton Twp--3rd precinct,202,7,0,0,209,18675,312,11,0,18998
JUSTICE/SUPREME COURT,Seamus  McCAFFERY,Lower Paxton Twp--4th Precinct,152,2,0,0,154,18675,312,11,0,18998
JUSTICE/SUPREME COURT,Seamus  McCAFFERY,Lower Paxton Twp--5th Precinct,143,0,1,0,144,18675,312,11,0,18998
JUSTICE/SUPREME COURT,Seamus  McCAFFERY,Lower Paxton Twp--6th Precinct,118,1,0,0,119,18675,312,11,0,18998
JUSTICE/SUPREME COURT,Seamus  McCAFFERY,Lower Paxton Twp--7th Precinct,160,2,0,0,162,18675,312,11,0,18998
JUSTICE/SUPREME COURT,Seamus  McCAFFERY,Lower Paxton Twp--8th Precinct,98,1,0,0,99,18675,312,11,0,18998
JUSTICE/SUPREME COURT,Seamus  McCAFFERY,Lower Paxton Twp--9th Precinct,98,3,0,0,101,18675,312,11,0,18998
JUSTICE/SUPREME COURT,Seamus  McCAFFERY,Lower Paxton Twp--10th Precinct,95,5,0,0,100,18675,312,11,0,18998
JUSTICE/SUPREME COURT,Seamus  McCAFFERY,Lower Paxton Twp--11th Precinct,103,3,0,0,106,18675,312,11,0,18998
JUSTICE/SUPREME COURT,Seamus  McCAFFERY,Lower Paxton Twp--12th Precinct,161,0,1,0,162,18675,312,11,0,18998
JUSTICE/SUPREME COURT,Seamus  McCAFFERY,Lower Paxton Twp--13th Precinct,172,4,0,0,176,18675,312,11,0,18998
JUSTICE/SUPREME COURT,Seamus  McCAFFERY,Lower Paxton Twp--14th Precinct,124,1,2,0,127,18675,312,11,0,18998
JUSTICE/SUPREME COURT,Seamus  McCAFFERY,Lower Paxton Twp--15th Precinct,153,1,0,0,154,18675,312,11,0,18998
JUSTICE/SUPREME COURT,Seamus  McCAFFERY,Lower Paxton Twp--16th Precinct,216,0,0,0,216,18675,312,11,0,18998
JUSTICE/SUPREME COURT,Seamus  McCAFFERY,Lower Paxton Twp--17th Precinct,125,5,0,0,130,18675,312,11,0,18998
JUSTICE/SUPREME COURT,Seamus  McCAFFERY,Lower Paxton Twp--18th Precinct,108,1,0,0,109,18675,312,11,0,18998
JUSTICE/SUPREME COURT,Seamus  McCAFFERY,Lower Paxton Twp--19th Precinct,210,2,0,0,212,18675,312,11,0,18998
JUSTICE/SUPREME COURT,Seamus  McCAFFERY,Lower Paxton Twp--20th Precinct,124,1,0,0,125,18675,312,11,0,18998
JUSTICE/SUPREME COURT,Seamus  McCAFFERY,Lower Paxton Twp--21st Precinct,197,9,0,0,206,18675,312,11,0,18998
JUSTICE/SUPREME COURT,Seamus  McCAFFERY,Lower Paxton Twp--22nd Precinct,150,0,0,0,150,18675,312,11,0,18998
JUSTICE/SUPREME COURT,Seamus  McCAFFERY,Lower Paxton Twp--23rd Precinct,115,0,0,0,115,18675,312,11,0,18998
JUSTICE/SUPREME COURT,Seamus  McCAFFERY,Lower Paxton Twp--24th Precinct,141,2,0,0,143,18675,312,11,0,18998
JUSTICE/SUPREME COURT,Seamus  McCAFFERY,Lower Paxton Twp--25th Precinct,114,1,0,0,115,18675,312,11,0,18998
JUSTICE/SUPREME COURT,Seamus  McCAFFERY,Lower Paxton Twp--26th Precinct,147,3,0,0,150,18675,312,11,0,18998
JUSTICE/SUPREME COURT,Seamus  McCAFFERY,Lower Paxton Twp--27th Precinct,136,2,0,0,138,18675,312,11,0,18998
JUSTICE/SUPREME COURT,Seamus  McCAFFERY,Lower Swatara Twp--1st Precinct,149,1,0,0,150,18675,312,11,0,18998
JUSTICE/SUPREME COURT,Seamus  McCAFFERY,Lower Swatara Twp--2nd Precinct,137,4,0,0,141,18675,312,11,0,18998
JUSTICE/SUPREME COURT,Seamus  McCAFFERY,Lower Swatara Twp--3rd Precinct,123,11,0,0,134,18675,312,11,0,18998
JUSTICE/SUPREME COURT,Seamus  McCAFFERY,Lower Swatara Twp--4th Precinct,131,0,0,0,131,18675,312,11,0,18998
JUSTICE/SUPREME COURT,Seamus  McCAFFERY,Lykens Township,30,0,0,0,30,18675,312,11,0,18998
JUSTICE/SUPREME COURT,Seamus  McCAFFERY,Middle Paxton Twp--1st Precinct,159,0,0,0,159,18675,312,11,0,18998
JUSTICE/SUPREME COURT,Seamus  McCAFFERY,Middle Paxton Twp--2nd Precinct,139,0,0,0,139,18675,312,11,0,18998
JUSTICE/SUPREME COURT,Seamus  McCAFFERY,Middle Paxton Twp--3rd Precinct,175,0,0,0,175,18675,312,11,0,18998
JUSTICE/SUPREME COURT,Seamus  McCAFFERY,Mifflin Township,31,0,0,0,31,18675,312,11,0,18998
JUSTICE/SUPREME COURT,Seamus  McCAFFERY,Reed Township,19,0,0,0,19,18675,312,11,0,18998
JUSTICE/SUPREME COURT,Seamus  McCAFFERY,Rush Township,12,0,0,0,12,18675,312,11,0,18998
JUSTICE/SUPREME COURT,Seamus  McCAFFERY,South Hanover Twp--1st Precinct,115,3,0,0,118,18675,312,11,0,18998
JUSTICE/SUPREME COURT,Seamus  McCAFFERY,South Hanover Twp--2nd Precinct,182,4,0,0,186,18675,312,11,0,18998
JUSTICE/SUPREME COURT,Seamus  McCAFFERY,South Hanover Twp--3rd Precinct,98,0,0,0,98,18675,312,11,0,18998
JUSTICE/SUPREME COURT,Seamus  McCAFFERY,Susquehanna Twp--1st Ward,330,8,0,0,338,18675,312,11,0,18998
JUSTICE/SUPREME COURT,Seamus  McCAFFERY,Susquehanna Twp--2nd Ward,372,11,0,0,383,18675,312,11,0,18998
JUSTICE/SUPREME COURT,Seamus  McCAFFERY,Susquehanna Twp--3rd Ward,204,4,0,0,208,18675,312,11,0,18998
JUSTICE/SUPREME COURT,Seamus  McCAFFERY,Susquehanna Twp--4th Ward,213,1,0,0,214,18675,312,11,0,18998
JUSTICE/SUPREME COURT,Seamus  McCAFFERY,Susquehanna Twp--5th Ward,200,4,0,0,204,18675,312,11,0,18998
JUSTICE/SUPREME COURT,Seamus  McCAFFERY,Susquehanna Twp--6th Ward,214,4,0,0,218,18675,312,11,0,18998
JUSTICE/SUPREME COURT,Seamus  McCAFFERY,Susquehanna Twp--7th Ward,131,0,0,0,131,18675,312,11,0,18998
JUSTICE/SUPREME COURT,Seamus  McCAFFERY,Susquehanna Twp--8th Ward,315,11,0,0,326,18675,312,11,0,18998
JUSTICE/SUPREME COURT,Seamus  McCAFFERY,Susquehanna Twp--9th Ward,280,0,0,0,280,18675,312,11,0,18998
JUSTICE/SUPREME COURT,Seamus  McCAFFERY,Swatara Township--1st Ward,211,2,0,0,213,18675,312,11,0,18998
JUSTICE/SUPREME COURT,Seamus  McCAFFERY,Swatara Township--2nd Ward,116,11,0,0,127,18675,312,11,0,18998
JUSTICE/SUPREME COURT,Seamus  McCAFFERY,Swatara Township--3rd Ward,126,3,0,0,129,18675,312,11,0,18998
JUSTICE/SUPREME COURT,Seamus  McCAFFERY,Swatara Township--4th Ward,178,1,0,0,179,18675,312,11,0,18998
JUSTICE/SUPREME COURT,Seamus  McCAFFERY,Swatara Township--5th Ward,217,0,0,0,217,18675,312,11,0,18998
JUSTICE/SUPREME COURT,Seamus  McCAFFERY,Swatara Township--6th Ward,232,2,1,0,235,18675,312,11,0,18998
JUSTICE/SUPREME COURT,Seamus  McCAFFERY,Swatara Township--7th Ward,261,4,0,0,265,18675,312,11,0,18998
JUSTICE/SUPREME COURT,Seamus  McCAFFERY,Swatara Township--8th Ward,222,1,0,0,223,18675,312,11,0,18998
JUSTICE/SUPREME COURT,Seamus  McCAFFERY,Swatara Township--9th Ward,121,6,0,0,127,18675,312,11,0,18998
JUSTICE/SUPREME COURT,Seamus  McCAFFERY,Upper Paxton Twp--1st Precinct,103,0,0,0,103,18675,312,11,0,18998
JUSTICE/SUPREME COURT,Seamus  McCAFFERY,Upper Paxton Twp--2nd Precinct,84,0,0,0,84,18675,312,11,0,18998
JUSTICE/SUPREME COURT,Seamus  McCAFFERY,Washington Township,102,1,0,0,103,18675,312,11,0,18998
JUSTICE/SUPREME COURT,Seamus  McCAFFERY,Wayne Township,105,0,0,0,105,18675,312,11,0,18998
JUSTICE/SUPREME COURT,Seamus  McCAFFERY,West Hanover Twp--1st Precinct,141,1,0,0,142,18675,312,11,0,18998
JUSTICE/SUPREME COURT,Seamus  McCAFFERY,West Hanover Twp--2nd Precinct,159,2,0,0,161,18675,312,11,0,18998
JUSTICE/SUPREME COURT,Seamus  McCAFFERY,West Hanover Twp--3rd Precinct,319,7,2,0,328,18675,312,11,0,18998
JUSTICE/SUPREME COURT,Seamus  McCAFFERY,West Hanover Twp--4th Precinct,171,1,0,0,172,18675,312,11,0,18998
JUSTICE/SUPREME COURT,Seamus  McCAFFERY,Wiconisco Twp--1st Precinct,45,0,0,0,45,18675,312,11,0,18998
JUSTICE/SUPREME COURT,Seamus  McCAFFERY,Wiconisco Twp--2nd Precinct,24,0,0,0,24,18675,312,11,0,18998
JUSTICE/SUPREME COURT,Seamus  McCAFFERY,Williams Twp,42,0,0,0,42,18675,312,11,0,18998
JUSTICE/SUPREME COURT,Write In  ,"City--1st Ward, 1st Precinct",0,0,0,0,0,41,0,0,0,41
JUSTICE/SUPREME COURT,Write In  ,"City--1st Ward, 2nd Precinct",0,0,0,0,0,41,0,0,0,41
JUSTICE/SUPREME COURT,Write In  ,"City--1st Ward, 3rd Precinct",0,0,0,0,0,41,0,0,0,41
JUSTICE/SUPREME COURT,Write In  ,"City--2nd Ward, 1st Precinct",0,0,0,0,0,41,0,0,0,41
JUSTICE/SUPREME COURT,Write In  ,"City--2nd Ward, 2nd Precinct",0,0,0,0,0,41,0,0,0,41
JUSTICE/SUPREME COURT,Write In  ,City--3rd Ward,0,0,0,0,0,41,0,0,0,41
JUSTICE/SUPREME COURT,Write In  ,City--4th Ward,1,0,0,0,1,41,0,0,0,41
JUSTICE/SUPREME COURT,Write In  ,City--5th Ward,2,0,0,0,2,41,0,0,0,41
JUSTICE/SUPREME COURT,Write In  ,City--6th Ward,0,0,0,0,0,41,0,0,0,41
JUSTICE/SUPREME COURT,Write In  ,"City--7th Ward, 1st Precinct",0,0,0,0,0,41,0,0,0,41
JUSTICE/SUPREME COURT,Write In  ,"City--7th Ward, 2nd Precinct",0,0,0,0,0,41,0,0,0,41
JUSTICE/SUPREME COURT,Write In  ,City--8th Ward,0,0,0,0,0,41,0,0,0,41
JUSTICE/SUPREME COURT,Write In  ,"City--9th Ward, 1st Precinct",0,0,0,0,0,41,0,0,0,41
JUSTICE/SUPREME COURT,Write In  ,"City--9th Ward, 2nd Precinct",1,0,0,0,1,41,0,0,0,41
JUSTICE/SUPREME COURT,Write In  ,"City--9th Ward, 3rd Precinct",0,0,0,0,0,41,0,0,0,41
JUSTICE/SUPREME COURT,Write In  ,"City--9th Ward, 4th Precinct",0,0,0,0,0,41,0,0,0,41
JUSTICE/SUPREME COURT,Write In  ,"City--9th Ward, 5th Precinct",1,0,0,0,1,41,0,0,0,41
JUSTICE/SUPREME COURT,Write In  ,"City--10th Ward, 1st Precinct",0,0,0,0,0,41,0,0,0,41
JUSTICE/SUPREME COURT,Write In  ,"City--10th Ward, 2nd Precinct",1,0,0,0,1,41,0,0,0,41
JUSTICE/SUPREME COURT,Write In  ,"City--10th Ward, 3rd Precinct",0,0,0,0,0,41,0,0,0,41
JUSTICE/SUPREME COURT,Write In  ,"City--10th Ward, 4th Precinct",1,0,0,0,1,41,0,0,0,41
JUSTICE/SUPREME COURT,Write In  ,City--11th Ward,0,0,0,0,0,41,0,0,0,41
JUSTICE/SUPREME COURT,Write In  ,City--12th Ward,1,0,0,0,1,41,0,0,0,41
JUSTICE/SUPREME COURT,Write In  ,"City--13th Ward, 1st Precinct",2,0,0,0,2,41,0,0,0,41
JUSTICE/SUPREME COURT,Write In  ,"City--13th Ward, 2nd Precinct",0,0,0,0,0,41,0,0,0,41
JUSTICE/SUPREME COURT,Write In  ,"City--13th Ward, 3rd Precinct",0,0,0,0,0,41,0,0,0,41
JUSTICE/SUPREME COURT,Write In  ,City--14th Ward,0,0,0,0,0,41,0,0,0,41
JUSTICE/SUPREME COURT,Write In  ,City--15th Ward,0,0,0,0,0,41,0,0,0,41
JUSTICE/SUPREME COURT,Write In  ,Berrysburg Borough,0,0,0,0,0,41,0,0,0,41
JUSTICE/SUPREME COURT,Write In  ,Dauphin Borough,0,0,0,0,0,41,0,0,0,41
JUSTICE/SUPREME COURT,Write In  ,Elizabethville Borough,0,0,0,0,0,41,0,0,0,41
JUSTICE/SUPREME COURT,Write In  ,Gratz Borough,0,0,0,0,0,41,0,0,0,41
JUSTICE/SUPREME COURT,Write In  ,Halifax Borough,0,0,0,0,0,41,0,0,0,41
JUSTICE/SUPREME COURT,Write In  ,Highspire--1st Precinct,0,0,0,0,0,41,0,0,0,41
JUSTICE/SUPREME COURT,Write In  ,Highspire--2nd Precinct,0,0,0,0,0,41,0,0,0,41
JUSTICE/SUPREME COURT,Write In  ,Hummelstown--1st Precinct,0,0,0,0,0,41,0,0,0,41
JUSTICE/SUPREME COURT,Write In  ,Hummelstown--2nd Precinct,1,0,0,0,1,41,0,0,0,41
JUSTICE/SUPREME COURT,Write In  ,Lykens Borough--1st Ward,0,0,0,0,0,41,0,0,0,41
JUSTICE/SUPREME COURT,Write In  ,Lykens Borough--2nd Ward,0,0,0,0,0,41,0,0,0,41
JUSTICE/SUPREME COURT,Write In  ,"Middletown--1st Ward, 1st Precinct",0,0,0,0,0,41,0,0,0,41
JUSTICE/SUPREME COURT,Write In  ,"Middletown--1st Ward, 2nd Precinct",0,0,0,0,0,41,0,0,0,41
JUSTICE/SUPREME COURT,Write In  ,"Middletown--2nd Ward, 1st Precinct",0,0,0,0,0,41,0,0,0,41
JUSTICE/SUPREME COURT,Write In  ,"Middletown--2nd Ward, 2nd Precinct",1,0,0,0,1,41,0,0,0,41
JUSTICE/SUPREME COURT,Write In  ,"Middletown--3rd Ward, 1st Precinct",1,0,0,0,1,41,0,0,0,41
JUSTICE/SUPREME COURT,Write In  ,"Middletown--3rd Ward, 2nd Precinct",0,0,0,0,0,41,0,0,0,41
JUSTICE/SUPREME COURT,Write In  ,Millersburg--1st Ward,1,0,0,0,1,41,0,0,0,41
JUSTICE/SUPREME COURT,Write In  ,Millersburg--2nd Ward,1,0,0,0,1,41,0,0,0,41
JUSTICE/SUPREME COURT,Write In  ,Paxtang Borough,1,0,0,0,1,41,0,0,0,41
JUSTICE/SUPREME COURT,Write In  ,Penbrook Borough--1st Ward,0,0,0,0,0,41,0,0,0,41
JUSTICE/SUPREME COURT,Write In  ,Penbrook Borough--2nd Ward,0,0,0,0,0,41,0,0,0,41
JUSTICE/SUPREME COURT,Write In  ,Penbrook Borough--3rd Ward,0,0,0,0,0,41,0,0,0,41
JUSTICE/SUPREME COURT,Write In  ,Penbrook Borough--4th Ward,1,0,0,0,1,41,0,0,0,41
JUSTICE/SUPREME COURT,Write In  ,Royalton Borough--1st Ward,0,0,0,0,0,41,0,0,0,41
JUSTICE/SUPREME COURT,Write In  ,Royalton Borough--2nd Ward,0,0,0,0,0,41,0,0,0,41
JUSTICE/SUPREME COURT,Write In  ,Steelton--1st Ward,0,0,0,0,0,41,0,0,0,41
JUSTICE/SUPREME COURT,Write In  ,"Steelton--2nd Ward, 1st Precinct",0,0,0,0,0,41,0,0,0,41
JUSTICE/SUPREME COURT,Write In  ,"Steelton--2nd Ward, 2nd Precinct",0,0,0,0,0,41,0,0,0,41
JUSTICE/SUPREME COURT,Write In  ,"Steelton--3rd Ward, 1st Precinct",0,0,0,0,0,41,0,0,0,41
JUSTICE/SUPREME COURT,Write In  ,"Steelton--3rd Ward, 2nd Precinct",0,0,0,0,0,41,0,0,0,41
JUSTICE/SUPREME COURT,Write In  ,Steelton--4th Ward,1,0,0,0,1,41,0,0,0,41
JUSTICE/SUPREME COURT,Write In  ,Pillow Borough,0,0,0,0,0,41,0,0,0,41
JUSTICE/SUPREME COURT,Write In  ,Williamstown--1st Ward,0,0,0,0,0,41,0,0,0,41
JUSTICE/SUPREME COURT,Write In  ,Williamstown--2nd Ward,0,0,0,0,0,41,0,0,0,41
JUSTICE/SUPREME COURT,Write In  ,Conewago Twp--1st Precinct,0,0,0,0,0,41,0,0,0,41
JUSTICE/SUPREME COURT,Write In  ,Conewago Twp--2nd Precinct,0,0,0,0,0,41,0,0,0,41
JUSTICE/SUPREME COURT,Write In  ,Derry Township--1st Precinct,1,0,0,0,1,41,0,0,0,41
JUSTICE/SUPREME COURT,Write In  ,Derry Township--2nd Precinct,0,0,0,0,0,41,0,0,0,41
JUSTICE/SUPREME COURT,Write In  ,Derry Township--3rd Precinct,0,0,0,0,0,41,0,0,0,41
JUSTICE/SUPREME COURT,Write In  ,Derry Township--4th Precinct,0,0,0,0,0,41,0,0,0,41
JUSTICE/SUPREME COURT,Write In  ,Derry Township--5th Precinct,0,0,0,0,0,41,0,0,0,41
JUSTICE/SUPREME COURT,Write In  ,Derry Township--6th Precinct,0,0,0,0,0,41,0,0,0,41
JUSTICE/SUPREME COURT,Write In  ,Derry Township--7th Precinct,0,0,0,0,0,41,0,0,0,41
JUSTICE/SUPREME COURT,Write In  ,Derry Township--8th Precinct,0,0,0,0,0,41,0,0,0,41
JUSTICE/SUPREME COURT,Write In  ,Derry Township--9th Precinct,0,0,0,0,0,41,0,0,0,41
JUSTICE/SUPREME COURT,Write In  ,Derry Township--10th Precinct,0,0,0,0,0,41,0,0,0,41
JUSTICE/SUPREME COURT,Write In  ,Derry Township--11th Precinct,0,0,0,0,0,41,0,0,0,41
JUSTICE/SUPREME COURT,Write In  ,Derry Township--12th Precinct,0,0,0,0,0,41,0,0,0,41
JUSTICE/SUPREME COURT,Write In  ,Derry Township--13th Precinct,0,0,0,0,0,41,0,0,0,41
JUSTICE/SUPREME COURT,Write In  ,Derry Township--14th Precinct,0,0,0,0,0,41,0,0,0,41
JUSTICE/SUPREME COURT,Write In  ,Derry Township--15th Precinct,0,0,0,0,0,41,0,0,0,41
JUSTICE/SUPREME COURT,Write In  ,East Hanover Township--1st Precinct,1,0,0,0,1,41,0,0,0,41
JUSTICE/SUPREME COURT,Write In  ,East Hanover Township--2nd Precinct,0,0,0,0,0,41,0,0,0,41
JUSTICE/SUPREME COURT,Write In  ,Halifax Twp--1st Precinct,1,0,0,0,1,41,0,0,0,41
JUSTICE/SUPREME COURT,Write In  ,Halifax Twp--2nd Precinct,0,0,0,0,0,41,0,0,0,41
JUSTICE/SUPREME COURT,Write In  ,Jackson Township,0,0,0,0,0,41,0,0,0,41
JUSTICE/SUPREME COURT,Write In  ,Jefferson Township,0,0,0,0,0,41,0,0,0,41
JUSTICE/SUPREME COURT,Write In  ,Londonderry Twp--1st Precinct,1,0,0,0,1,41,0,0,0,41
JUSTICE/SUPREME COURT,Write In  ,Londonderry Twp--2nd Precinct,1,0,0,0,1,41,0,0,0,41
JUSTICE/SUPREME COURT,Write In  ,Londonderry Twp--3rd Precinct,0,0,0,0,0,41,0,0,0,41
JUSTICE/SUPREME COURT,Write In  ,Lower Paxton Twp--1st Precinct,0,0,0,0,0,41,0,0,0,41
JUSTICE/SUPREME COURT,Write In  ,Lower Paxton Twp--2nd Precinct,1,0,0,0,1,41,0,0,0,41
JUSTICE/SUPREME COURT,Write In  ,Lower Paxton Twp--3rd precinct,1,0,0,0,1,41,0,0,0,41
JUSTICE/SUPREME COURT,Write In  ,Lower Paxton Twp--4th Precinct,0,0,0,0,0,41,0,0,0,41
JUSTICE/SUPREME COURT,Write In  ,Lower Paxton Twp--5th Precinct,0,0,0,0,0,41,0,0,0,41
JUSTICE/SUPREME COURT,Write In  ,Lower Paxton Twp--6th Precinct,0,0,0,0,0,41,0,0,0,41
JUSTICE/SUPREME COURT,Write In  ,Lower Paxton Twp--7th Precinct,0,0,0,0,0,41,0,0,0,41
JUSTICE/SUPREME COURT,Write In  ,Lower Paxton Twp--8th Precinct,0,0,0,0,0,41,0,0,0,41
JUSTICE/SUPREME COURT,Write In  ,Lower Paxton Twp--9th Precinct,0,0,0,0,0,41,0,0,0,41
JUSTICE/SUPREME COURT,Write In  ,Lower Paxton Twp--10th Precinct,1,0,0,0,1,41,0,0,0,41
JUSTICE/SUPREME COURT,Write In  ,Lower Paxton Twp--11th Precinct,0,0,0,0,0,41,0,0,0,41
JUSTICE/SUPREME COURT,Write In  ,Lower Paxton Twp--12th Precinct,0,0,0,0,0,41,0,0,0,41
JUSTICE/SUPREME COURT,Write In  ,Lower Paxton Twp--13th Precinct,1,0,0,0,1,41,0,0,0,41
JUSTICE/SUPREME COURT,Write In  ,Lower Paxton Twp--14th Precinct,0,0,0,0,0,41,0,0,0,41
JUSTICE/SUPREME COURT,Write In  ,Lower Paxton Twp--15th Precinct,0,0,0,0,0,41,0,0,0,41
JUSTICE/SUPREME COURT,Write In  ,Lower Paxton Twp--16th Precinct,1,0,0,0,1,41,0,0,0,41
JUSTICE/SUPREME COURT,Write In  ,Lower Paxton Twp--17th Precinct,0,0,0,0,0,41,0,0,0,41
JUSTICE/SUPREME COURT,Write In  ,Lower Paxton Twp--18th Precinct,1,0,0,0,1,41,0,0,0,41
JUSTICE/SUPREME COURT,Write In  ,Lower Paxton Twp--19th Precinct,0,0,0,0,0,41,0,0,0,41
JUSTICE/SUPREME COURT,Write In  ,Lower Paxton Twp--20th Precinct,1,0,0,0,1,41,0,0,0,41
JUSTICE/SUPREME COURT,Write In  ,Lower Paxton Twp--21st Precinct,0,0,0,0,0,41,0,0,0,41
JUSTICE/SUPREME COURT,Write In  ,Lower Paxton Twp--22nd Precinct,0,0,0,0,0,41,0,0,0,41
JUSTICE/SUPREME COURT,Write In  ,Lower Paxton Twp--23rd Precinct,1,0,0,0,1,41,0,0,0,41
JUSTICE/SUPREME COURT,Write In  ,Lower Paxton Twp--24th Precinct,0,0,0,0,0,41,0,0,0,41
JUSTICE/SUPREME COURT,Write In  ,Lower Paxton Twp--25th Precinct,0,0,0,0,0,41,0,0,0,41
JUSTICE/SUPREME COURT,Write In  ,Lower Paxton Twp--26th Precinct,2,0,0,0,2,41,0,0,0,41
JUSTICE/SUPREME COURT,Write In  ,Lower Paxton Twp--27th Precinct,0,0,0,0,0,41,0,0,0,41
JUSTICE/SUPREME COURT,Write In  ,Lower Swatara Twp--1st Precinct,0,0,0,0,0,41,0,0,0,41
JUSTICE/SUPREME COURT,Write In  ,Lower Swatara Twp--2nd Precinct,0,0,0,0,0,41,0,0,0,41
JUSTICE/SUPREME COURT,Write In  ,Lower Swatara Twp--3rd Precinct,0,0,0,0,0,41,0,0,0,41
JUSTICE/SUPREME COURT,Write In  ,Lower Swatara Twp--4th Precinct,0,0,0,0,0,41,0,0,0,41
JUSTICE/SUPREME COURT,Write In  ,Lykens Township,0,0,0,0,0,41,0,0,0,41
JUSTICE/SUPREME COURT,Write In  ,Middle Paxton Twp--1st Precinct,0,0,0,0,0,41,0,0,0,41
JUSTICE/SUPREME COURT,Write In  ,Middle Paxton Twp--2nd Precinct,0,0,0,0,0,41,0,0,0,41
JUSTICE/SUPREME COURT,Write In  ,Middle Paxton Twp--3rd Precinct,1,0,0,0,1,41,0,0,0,41
JUSTICE/SUPREME COURT,Write In  ,Mifflin Township,0,0,0,0,0,41,0,0,0,41
JUSTICE/SUPREME COURT,Write In  ,Reed Township,0,0,0,0,0,41,0,0,0,41
JUSTICE/SUPREME COURT,Write In  ,Rush Township,0,0,0,0,0,41,0,0,0,41
JUSTICE/SUPREME COURT,Write In  ,South Hanover Twp--1st Precinct,0,0,0,0,0,41,0,0,0,41
JUSTICE/SUPREME COURT,Write In  ,South Hanover Twp--2nd Precinct,0,0,0,0,0,41,0,0,0,41
JUSTICE/SUPREME COURT,Write In  ,South Hanover Twp--3rd Precinct,0,0,0,0,0,41,0,0,0,41
JUSTICE/SUPREME COURT,Write In  ,Susquehanna Twp--1st Ward,0,0,0,0,0,41,0,0,0,41
JUSTICE/SUPREME COURT,Write In  ,Susquehanna Twp--2nd Ward,0,0,0,0,0,41,0,0,0,41
JUSTICE/SUPREME COURT,Write In  ,Susquehanna Twp--3rd Ward,1,0,0,0,1,41,0,0,0,41
JUSTICE/SUPREME COURT,Write In  ,Susquehanna Twp--4th Ward,0,0,0,0,0,41,0,0,0,41
JUSTICE/SUPREME COURT,Write In  ,Susquehanna Twp--5th Ward,0,0,0,0,0,41,0,0,0,41
JUSTICE/SUPREME COURT,Write In  ,Susquehanna Twp--6th Ward,0,0,0,0,0,41,0,0,0,41
JUSTICE/SUPREME COURT,Write In  ,Susquehanna Twp--7th Ward,0,0,0,0,0,41,0,0,0,41
JUSTICE/SUPREME COURT,Write In  ,Susquehanna Twp--8th Ward,0,0,0,0,0,41,0,0,0,41
JUSTICE/SUPREME COURT,Write In  ,Susquehanna Twp--9th Ward,0,0,0,0,0,41,0,0,0,41
JUSTICE/SUPREME COURT,Write In  ,Swatara Township--1st Ward,0,0,0,0,0,41,0,0,0,41
JUSTICE/SUPREME COURT,Write In  ,Swatara Township--2nd Ward,0,0,0,0,0,41,0,0,0,41
JUSTICE/SUPREME COURT,Write In  ,Swatara Township--3rd Ward,0,0,0,0,0,41,0,0,0,41
JUSTICE/SUPREME COURT,Write In  ,Swatara Township--4th Ward,1,0,0,0,1,41,0,0,0,41
JUSTICE/SUPREME COURT,Write In  ,Swatara Township--5th Ward,0,0,0,0,0,41,0,0,0,41
JUSTICE/SUPREME COURT,Write In  ,Swatara Township--6th Ward,0,0,0,0,0,41,0,0,0,41
JUSTICE/SUPREME COURT,Write In  ,Swatara Township--7th Ward,0,0,0,0,0,41,0,0,0,41
JUSTICE/SUPREME COURT,Write In  ,Swatara Township--8th Ward,0,0,0,0,0,41,0,0,0,41
JUSTICE/SUPREME COURT,Write In  ,Swatara Township--9th Ward,0,0,0,0,0,41,0,0,0,41
JUSTICE/SUPREME COURT,Write In  ,Upper Paxton Twp--1st Precinct,1,0,0,0,1,41,0,0,0,41
JUSTICE/SUPREME COURT,Write In  ,Upper Paxton Twp--2nd Precinct,0,0,0,0,0,41,0,0,0,41
JUSTICE/SUPREME COURT,Write In  ,Washington Township,0,0,0,0,0,41,0,0,0,41
JUSTICE/SUPREME COURT,Write In  ,Wayne Township,0,0,0,0,0,41,0,0,0,41
JUSTICE/SUPREME COURT,Write In  ,West Hanover Twp--1st Precinct,0,0,0,0,0,41,0,0,0,41
JUSTICE/SUPREME COURT,Write In  ,West Hanover Twp--2nd Precinct,1,0,0,0,1,41,0,0,0,41
JUSTICE/SUPREME COURT,Write In  ,West Hanover Twp--3rd Precinct,2,0,0,0,2,41,0,0,0,41
JUSTICE/SUPREME COURT,Write In  ,West Hanover Twp--4th Precinct,0,0,0,0,0,41,0,0,0,41
JUSTICE/SUPREME COURT,Write In  ,Wiconisco Twp--1st Precinct,0,0,0,0,0,41,0,0,0,41
JUSTICE/SUPREME COURT,Write In  ,Wiconisco Twp--2nd Precinct,0,0,0,0,0,41,0,0,0,41
JUSTICE/SUPREME COURT,Write In  ,Williams Twp,1,0,0,0,1,41,0,0,0,41
LEADBETTER RETENTION,  LEADBETTER - NO,"City--1st Ward, 1st Precinct",47,3,0,0,50,21830,330,9,0,22169
LEADBETTER RETENTION,  LEADBETTER - NO,"City--1st Ward, 2nd Precinct",77,0,0,0,77,21830,330,9,0,22169
LEADBETTER RETENTION,  LEADBETTER - NO,"City--1st Ward, 3rd Precinct",32,0,0,0,32,21830,330,9,0,22169
LEADBETTER RETENTION,  LEADBETTER - NO,"City--2nd Ward, 1st Precinct",24,0,0,0,24,21830,330,9,0,22169
LEADBETTER RETENTION,  LEADBETTER - NO,"City--2nd Ward, 2nd Precinct",34,0,0,0,34,21830,330,9,0,22169
LEADBETTER RETENTION,  LEADBETTER - NO,City--3rd Ward,36,0,0,0,36,21830,330,9,0,22169
LEADBETTER RETENTION,  LEADBETTER - NO,City--4th Ward,80,1,0,0,81,21830,330,9,0,22169
LEADBETTER RETENTION,  LEADBETTER - NO,City--5th Ward,171,2,0,0,173,21830,330,9,0,22169
LEADBETTER RETENTION,  LEADBETTER - NO,City--6th Ward,93,1,0,0,94,21830,330,9,0,22169
LEADBETTER RETENTION,  LEADBETTER - NO,"City--7th Ward, 1st Precinct",29,2,0,0,31,21830,330,9,0,22169
LEADBETTER RETENTION,  LEADBETTER - NO,"City--7th Ward, 2nd Precinct",63,2,0,0,65,21830,330,9,0,22169
LEADBETTER RETENTION,  LEADBETTER - NO,City--8th Ward,59,1,0,0,60,21830,330,9,0,22169
LEADBETTER RETENTION,  LEADBETTER - NO,"City--9th Ward, 1st Precinct",28,0,0,0,28,21830,330,9,0,22169
LEADBETTER RETENTION,  LEADBETTER - NO,"City--9th Ward, 2nd Precinct",27,0,0,0,27,21830,330,9,0,22169
LEADBETTER RETENTION,  LEADBETTER - NO,"City--9th Ward, 3rd Precinct",97,0,0,0,97,21830,330,9,0,22169
LEADBETTER RETENTION,  LEADBETTER - NO,"City--9th Ward, 4th Precinct",109,3,0,0,112,21830,330,9,0,22169
LEADBETTER RETENTION,  LEADBETTER - NO,"City--9th Ward, 5th Precinct",55,3,0,0,58,21830,330,9,0,22169
LEADBETTER RETENTION,  LEADBETTER - NO,"City--10th Ward, 1st Precinct",122,0,0,0,122,21830,330,9,0,22169
LEADBETTER RETENTION,  LEADBETTER - NO,"City--10th Ward, 2nd Precinct",44,0,0,0,44,21830,330,9,0,22169
LEADBETTER RETENTION,  LEADBETTER - NO,"City--10th Ward, 3rd Precinct",58,0,0,0,58,21830,330,9,0,22169
LEADBETTER RETENTION,  LEADBETTER - NO,"City--10th Ward, 4th Precinct",51,0,0,0,51,21830,330,9,0,22169
LEADBETTER RETENTION,  LEADBETTER - NO,City--11th Ward,52,3,0,0,55,21830,330,9,0,22169
LEADBETTER RETENTION,  LEADBETTER - NO,City--12th Ward,150,5,0,0,155,21830,330,9,0,22169
LEADBETTER RETENTION,  LEADBETTER - NO,"City--13th Ward, 1st Precinct",70,0,0,0,70,21830,330,9,0,22169
LEADBETTER RETENTION,  LEADBETTER - NO,"City--13th Ward, 2nd Precinct",91,4,0,0,95,21830,330,9,0,22169
LEADBETTER RETENTION,  LEADBETTER - NO,"City--13th Ward, 3rd Precinct",108,2,0,0,110,21830,330,9,0,22169
LEADBETTER RETENTION,  LEADBETTER - NO,City--14th Ward,196,2,0,0,198,21830,330,9,0,22169
LEADBETTER RETENTION,  LEADBETTER - NO,City--15th Ward,39,0,0,0,39,21830,330,9,0,22169
LEADBETTER RETENTION,  LEADBETTER - NO,Berrysburg Borough,37,0,0,0,37,21830,330,9,0,22169
LEADBETTER RETENTION,  LEADBETTER - NO,Dauphin Borough,130,0,0,0,130,21830,330,9,0,22169
LEADBETTER RETENTION,  LEADBETTER - NO,Elizabethville Borough,111,2,0,0,113,21830,330,9,0,22169
LEADBETTER RETENTION,  LEADBETTER - NO,Gratz Borough,37,0,0,0,37,21830,330,9,0,22169
LEADBETTER RETENTION,  LEADBETTER - NO,Halifax Borough,58,1,0,0,59,21830,330,9,0,22169
LEADBETTER RETENTION,  LEADBETTER - NO,Highspire--1st Precinct,90,2,0,0,92,21830,330,9,0,22169
LEADBETTER RETENTION,  LEADBETTER - NO,Highspire--2nd Precinct,103,0,0,0,103,21830,330,9,0,22169
LEADBETTER RETENTION,  LEADBETTER - NO,Hummelstown--1st Precinct,123,5,0,0,128,21830,330,9,0,22169
LEADBETTER RETENTION,  LEADBETTER - NO,Hummelstown--2nd Precinct,246,3,0,0,249,21830,330,9,0,22169
LEADBETTER RETENTION,  LEADBETTER - NO,Lykens Borough--1st Ward,53,0,0,0,53,21830,330,9,0,22169
LEADBETTER RETENTION,  LEADBETTER - NO,Lykens Borough--2nd Ward,75,2,0,0,77,21830,330,9,0,22169
LEADBETTER RETENTION,  LEADBETTER - NO,"Middletown--1st Ward, 1st Precinct",52,0,0,0,52,21830,330,9,0,22169
LEADBETTER RETENTION,  LEADBETTER - NO,"Middletown--1st Ward, 2nd Precinct",94,1,1,0,96,21830,330,9,0,22169
LEADBETTER RETENTION,  LEADBETTER - NO,"Middletown--2nd Ward, 1st Precinct",117,2,0,0,119,21830,330,9,0,22169
LEADBETTER RETENTION,  LEADBETTER - NO,"Middletown--2nd Ward, 2nd Precinct",103,4,0,0,107,21830,330,9,0,22169
LEADBETTER RETENTION,  LEADBETTER - NO,"Middletown--3rd Ward, 1st Precinct",82,1,0,0,83,21830,330,9,0,22169
LEADBETTER RETENTION,  LEADBETTER - NO,"Middletown--3rd Ward, 2nd Precinct",139,0,0,0,139,21830,330,9,0,22169
LEADBETTER RETENTION,  LEADBETTER - NO,Millersburg--1st Ward,77,1,0,0,78,21830,330,9,0,22169
LEADBETTER RETENTION,  LEADBETTER - NO,Millersburg--2nd Ward,110,0,0,0,110,21830,330,9,0,22169
LEADBETTER RETENTION,  LEADBETTER - NO,Paxtang Borough,145,2,0,0,147,21830,330,9,0,22169
LEADBETTER RETENTION,  LEADBETTER - NO,Penbrook Borough--1st Ward,42,0,0,0,42,21830,330,9,0,22169
LEADBETTER RETENTION,  LEADBETTER - NO,Penbrook Borough--2nd Ward,44,1,0,0,45,21830,330,9,0,22169
LEADBETTER RETENTION,  LEADBETTER - NO,Penbrook Borough--3rd Ward,49,0,0,0,49,21830,330,9,0,22169
LEADBETTER RETENTION,  LEADBETTER - NO,Penbrook Borough--4th Ward,76,2,0,0,78,21830,330,9,0,22169
LEADBETTER RETENTION,  LEADBETTER - NO,Royalton Borough--1st Ward,27,0,0,0,27,21830,330,9,0,22169
LEADBETTER RETENTION,  LEADBETTER - NO,Royalton Borough--2nd Ward,48,0,0,0,48,21830,330,9,0,22169
LEADBETTER RETENTION,  LEADBETTER - NO,Steelton--1st Ward,85,4,0,0,89,21830,330,9,0,22169
LEADBETTER RETENTION,  LEADBETTER - NO,"Steelton--2nd Ward, 1st Precinct",52,0,0,0,52,21830,330,9,0,22169
LEADBETTER RETENTION,  LEADBETTER - NO,"Steelton--2nd Ward, 2nd Precinct",45,1,0,0,46,21830,330,9,0,22169
LEADBETTER RETENTION,  LEADBETTER - NO,"Steelton--3rd Ward, 1st Precinct",26,0,0,0,26,21830,330,9,0,22169
LEADBETTER RETENTION,  LEADBETTER - NO,"Steelton--3rd Ward, 2nd Precinct",51,0,0,0,51,21830,330,9,0,22169
LEADBETTER RETENTION,  LEADBETTER - NO,Steelton--4th Ward,46,1,0,0,47,21830,330,9,0,22169
LEADBETTER RETENTION,  LEADBETTER - NO,Pillow Borough,34,0,0,0,34,21830,330,9,0,22169
LEADBETTER RETENTION,  LEADBETTER - NO,Williamstown--1st Ward,55,1,0,0,56,21830,330,9,0,22169
LEADBETTER RETENTION,  LEADBETTER - NO,Williamstown--2nd Ward,40,0,0,0,40,21830,330,9,0,22169
LEADBETTER RETENTION,  LEADBETTER - NO,Conewago Twp--1st Precinct,158,0,0,0,158,21830,330,9,0,22169
LEADBETTER RETENTION,  LEADBETTER - NO,Conewago Twp--2nd Precinct,136,5,0,0,141,21830,330,9,0,22169
LEADBETTER RETENTION,  LEADBETTER - NO,Derry Township--1st Precinct,224,3,0,0,227,21830,330,9,0,22169
LEADBETTER RETENTION,  LEADBETTER - NO,Derry Township--2nd Precinct,157,2,0,0,159,21830,330,9,0,22169
LEADBETTER RETENTION,  LEADBETTER - NO,Derry Township--3rd Precinct,135,1,1,0,137,21830,330,9,0,22169
LEADBETTER RETENTION,  LEADBETTER - NO,Derry Township--4th Precinct,102,3,1,0,106,21830,330,9,0,22169
LEADBETTER RETENTION,  LEADBETTER - NO,Derry Township--5th Precinct,91,2,0,0,93,21830,330,9,0,22169
LEADBETTER RETENTION,  LEADBETTER - NO,Derry Township--6th Precinct,108,0,1,0,109,21830,330,9,0,22169
LEADBETTER RETENTION,  LEADBETTER - NO,Derry Township--7th Precinct,217,6,0,0,223,21830,330,9,0,22169
LEADBETTER RETENTION,  LEADBETTER - NO,Derry Township--8th Precinct,122,0,0,0,122,21830,330,9,0,22169
LEADBETTER RETENTION,  LEADBETTER - NO,Derry Township--9th Precinct,65,2,0,0,67,21830,330,9,0,22169
LEADBETTER RETENTION,  LEADBETTER - NO,Derry Township--10th Precinct,166,2,0,0,168,21830,330,9,0,22169
LEADBETTER RETENTION,  LEADBETTER - NO,Derry Township--11th Precinct,211,5,0,0,216,21830,330,9,0,22169
LEADBETTER RETENTION,  LEADBETTER - NO,Derry Township--12th Precinct,126,3,0,0,129,21830,330,9,0,22169
LEADBETTER RETENTION,  LEADBETTER - NO,Derry Township--13th Precinct,137,1,0,0,138,21830,330,9,0,22169
LEADBETTER RETENTION,  LEADBETTER - NO,Derry Township--14th Precinct,106,2,0,0,108,21830,330,9,0,22169
LEADBETTER RETENTION,  LEADBETTER - NO,Derry Township--15th Precinct,231,4,0,0,235,21830,330,9,0,22169
LEADBETTER RETENTION,  LEADBETTER - NO,East Hanover Township--1st Precinct,239,4,0,0,243,21830,330,9,0,22169
LEADBETTER RETENTION,  LEADBETTER - NO,East Hanover Township--2nd Precinct,251,3,0,0,254,21830,330,9,0,22169
LEADBETTER RETENTION,  LEADBETTER - NO,Halifax Twp--1st Precinct,214,3,0,0,217,21830,330,9,0,22169
LEADBETTER RETENTION,  LEADBETTER - NO,Halifax Twp--2nd Precinct,201,11,0,0,212,21830,330,9,0,22169
LEADBETTER RETENTION,  LEADBETTER - NO,Jackson Township,167,0,0,0,167,21830,330,9,0,22169
LEADBETTER RETENTION,  LEADBETTER - NO,Jefferson Township,50,0,0,0,50,21830,330,9,0,22169
LEADBETTER RETENTION,  LEADBETTER - NO,Londonderry Twp--1st Precinct,187,0,0,0,187,21830,330,9,0,22169
LEADBETTER RETENTION,  LEADBETTER - NO,Londonderry Twp--2nd Precinct,205,1,0,0,206,21830,330,9,0,22169
LEADBETTER RETENTION,  LEADBETTER - NO,Londonderry Twp--3rd Precinct,76,1,0,0,77,21830,330,9,0,22169
LEADBETTER RETENTION,  LEADBETTER - NO,Lower Paxton Twp--1st Precinct,123,1,0,0,124,21830,330,9,0,22169
LEADBETTER RETENTION,  LEADBETTER - NO,Lower Paxton Twp--2nd Precinct,142,7,0,0,149,21830,330,9,0,22169
LEADBETTER RETENTION,  LEADBETTER - NO,Lower Paxton Twp--3rd precinct,258,7,0,0,265,21830,330,9,0,22169
LEADBETTER RETENTION,  LEADBETTER - NO,Lower Paxton Twp--4th Precinct,208,1,0,0,209,21830,330,9,0,22169
LEADBETTER RETENTION,  LEADBETTER - NO,Lower Paxton Twp--5th Precinct,177,4,1,0,182,21830,330,9,0,22169
LEADBETTER RETENTION,  LEADBETTER - NO,Lower Paxton Twp--6th Precinct,128,0,0,0,128,21830,330,9,0,22169
LEADBETTER RETENTION,  LEADBETTER - NO,Lower Paxton Twp--7th Precinct,207,1,0,0,208,21830,330,9,0,22169
LEADBETTER RETENTION,  LEADBETTER - NO,Lower Paxton Twp--8th Precinct,108,1,0,0,109,21830,330,9,0,22169
LEADBETTER RETENTION,  LEADBETTER - NO,Lower Paxton Twp--9th Precinct,157,3,0,0,160,21830,330,9,0,22169
LEADBETTER RETENTION,  LEADBETTER - NO,Lower Paxton Twp--10th Precinct,84,2,0,0,86,21830,330,9,0,22169
LEADBETTER RETENTION,  LEADBETTER - NO,Lower Paxton Twp--11th Precinct,142,2,0,0,144,21830,330,9,0,22169
LEADBETTER RETENTION,  LEADBETTER - NO,Lower Paxton Twp--12th Precinct,180,3,1,0,184,21830,330,9,0,22169
LEADBETTER RETENTION,  LEADBETTER - NO,Lower Paxton Twp--13th Precinct,213,2,0,0,215,21830,330,9,0,22169
LEADBETTER RETENTION,  LEADBETTER - NO,Lower Paxton Twp--14th Precinct,105,1,0,0,106,21830,330,9,0,22169
LEADBETTER RETENTION,  LEADBETTER - NO,Lower Paxton Twp--15th Precinct,171,3,0,0,174,21830,330,9,0,22169
LEADBETTER RETENTION,  LEADBETTER - NO,Lower Paxton Twp--16th Precinct,274,3,0,0,277,21830,330,9,0,22169
LEADBETTER RETENTION,  LEADBETTER - NO,Lower Paxton Twp--17th Precinct,127,1,0,0,128,21830,330,9,0,22169
LEADBETTER RETENTION,  LEADBETTER - NO,Lower Paxton Twp--18th Precinct,121,1,0,0,122,21830,330,9,0,22169
LEADBETTER RETENTION,  LEADBETTER - NO,Lower Paxton Twp--19th Precinct,210,14,0,0,224,21830,330,9,0,22169
LEADBETTER RETENTION,  LEADBETTER - NO,Lower Paxton Twp--20th Precinct,165,3,0,0,168,21830,330,9,0,22169
LEADBETTER RETENTION,  LEADBETTER - NO,Lower Paxton Twp--21st Precinct,231,4,0,0,235,21830,330,9,0,22169
LEADBETTER RETENTION,  LEADBETTER - NO,Lower Paxton Twp--22nd Precinct,184,4,0,0,188,21830,330,9,0,22169
LEADBETTER RETENTION,  LEADBETTER - NO,Lower Paxton Twp--23rd Precinct,152,3,0,0,155,21830,330,9,0,22169
LEADBETTER RETENTION,  LEADBETTER - NO,Lower Paxton Twp--24th Precinct,178,5,0,0,183,21830,330,9,0,22169
LEADBETTER RETENTION,  LEADBETTER - NO,Lower Paxton Twp--25th Precinct,115,1,0,0,116,21830,330,9,0,22169
LEADBETTER RETENTION,  LEADBETTER - NO,Lower Paxton Twp--26th Precinct,168,5,0,0,173,21830,330,9,0,22169
LEADBETTER RETENTION,  LEADBETTER - NO,Lower Paxton Twp--27th Precinct,146,0,0,0,146,21830,330,9,0,22169
LEADBETTER RETENTION,  LEADBETTER - NO,Lower Swatara Twp--1st Precinct,236,2,0,0,238,21830,330,9,0,22169
LEADBETTER RETENTION,  LEADBETTER - NO,Lower Swatara Twp--2nd Precinct,185,5,0,0,190,21830,330,9,0,22169
LEADBETTER RETENTION,  LEADBETTER - NO,Lower Swatara Twp--3rd Precinct,155,4,0,0,159,21830,330,9,0,22169
LEADBETTER RETENTION,  LEADBETTER - NO,Lower Swatara Twp--4th Precinct,176,0,0,0,176,21830,330,9,0,22169
LEADBETTER RETENTION,  LEADBETTER - NO,Lykens Township,61,0,0,0,61,21830,330,9,0,22169
LEADBETTER RETENTION,  LEADBETTER - NO,Middle Paxton Twp--1st Precinct,293,2,0,0,295,21830,330,9,0,22169
LEADBETTER RETENTION,  LEADBETTER - NO,Middle Paxton Twp--2nd Precinct,203,2,0,0,205,21830,330,9,0,22169
LEADBETTER RETENTION,  LEADBETTER - NO,Middle Paxton Twp--3rd Precinct,287,0,0,0,287,21830,330,9,0,22169
LEADBETTER RETENTION,  LEADBETTER - NO,Mifflin Township,56,0,0,0,56,21830,330,9,0,22169
LEADBETTER RETENTION,  LEADBETTER - NO,Reed Township,33,0,0,0,33,21830,330,9,0,22169
LEADBETTER RETENTION,  LEADBETTER - NO,Rush Township,21,0,0,0,21,21830,330,9,0,22169
LEADBETTER RETENTION,  LEADBETTER - NO,South Hanover Twp--1st Precinct,197,4,0,0,201,21830,330,9,0,22169
LEADBETTER RETENTION,  LEADBETTER - NO,South Hanover Twp--2nd Precinct,244,5,0,0,249,21830,330,9,0,22169
LEADBETTER RETENTION,  LEADBETTER - NO,South Hanover Twp--3rd Precinct,166,0,0,0,166,21830,330,9,0,22169
LEADBETTER RETENTION,  LEADBETTER - NO,Susquehanna Twp--1st Ward,274,4,0,0,278,21830,330,9,0,22169
LEADBETTER RETENTION,  LEADBETTER - NO,Susquehanna Twp--2nd Ward,411,14,0,0,425,21830,330,9,0,22169
LEADBETTER RETENTION,  LEADBETTER - NO,Susquehanna Twp--3rd Ward,193,1,0,0,194,21830,330,9,0,22169
LEADBETTER RETENTION,  LEADBETTER - NO,Susquehanna Twp--4th Ward,216,2,0,0,218,21830,330,9,0,22169
LEADBETTER RETENTION,  LEADBETTER - NO,Susquehanna Twp--5th Ward,215,3,0,0,218,21830,330,9,0,22169
LEADBETTER RETENTION,  LEADBETTER - NO,Susquehanna Twp--6th Ward,251,6,0,0,257,21830,330,9,0,22169
LEADBETTER RETENTION,  LEADBETTER - NO,Susquehanna Twp--7th Ward,143,0,0,0,143,21830,330,9,0,22169
LEADBETTER RETENTION,  LEADBETTER - NO,Susquehanna Twp--8th Ward,301,10,0,0,311,21830,330,9,0,22169
LEADBETTER RETENTION,  LEADBETTER - NO,Susquehanna Twp--9th Ward,237,1,0,0,238,21830,330,9,0,22169
LEADBETTER RETENTION,  LEADBETTER - NO,Swatara Township--1st Ward,193,0,0,0,193,21830,330,9,0,22169
LEADBETTER RETENTION,  LEADBETTER - NO,Swatara Township--2nd Ward,119,5,0,0,124,21830,330,9,0,22169
LEADBETTER RETENTION,  LEADBETTER - NO,Swatara Township--3rd Ward,129,1,0,0,130,21830,330,9,0,22169
LEADBETTER RETENTION,  LEADBETTER - NO,Swatara Township--4th Ward,224,6,0,0,230,21830,330,9,0,22169
LEADBETTER RETENTION,  LEADBETTER - NO,Swatara Township--5th Ward,271,1,0,0,272,21830,330,9,0,22169
LEADBETTER RETENTION,  LEADBETTER - NO,Swatara Township--6th Ward,290,0,0,0,290,21830,330,9,0,22169
LEADBETTER RETENTION,  LEADBETTER - NO,Swatara Township--7th Ward,327,1,0,0,328,21830,330,9,0,22169
LEADBETTER RETENTION,  LEADBETTER - NO,Swatara Township--8th Ward,321,3,1,0,325,21830,330,9,0,22169
LEADBETTER RETENTION,  LEADBETTER - NO,Swatara Township--9th Ward,109,3,0,0,112,21830,330,9,0,22169
LEADBETTER RETENTION,  LEADBETTER - NO,Upper Paxton Twp--1st Precinct,185,2,0,0,187,21830,330,9,0,22169
LEADBETTER RETENTION,  LEADBETTER - NO,Upper Paxton Twp--2nd Precinct,139,1,0,0,140,21830,330,9,0,22169
LEADBETTER RETENTION,  LEADBETTER - NO,Washington Township,173,4,0,0,177,21830,330,9,0,22169
LEADBETTER RETENTION,  LEADBETTER - NO,Wayne Township,185,1,0,0,186,21830,330,9,0,22169
LEADBETTER RETENTION,  LEADBETTER - NO,West Hanover Twp--1st Precinct,223,4,0,0,227,21830,330,9,0,22169
LEADBETTER RETENTION,  LEADBETTER - NO,West Hanover Twp--2nd Precinct,196,2,0,0,198,21830,330,9,0,22169
LEADBETTER RETENTION,  LEADBETTER - NO,West Hanover Twp--3rd Precinct,468,11,2,0,481,21830,330,9,0,22169
LEADBETTER RETENTION,  LEADBETTER - NO,West Hanover Twp--4th Precinct,267,2,0,0,269,21830,330,9,0,22169
LEADBETTER RETENTION,  LEADBETTER - NO,Wiconisco Twp--1st Precinct,50,0,0,0,50,21830,330,9,0,22169
LEADBETTER RETENTION,  LEADBETTER - NO,Wiconisco Twp--2nd Precinct,32,1,0,0,33,21830,330,9,0,22169
LEADBETTER RETENTION,  LEADBETTER - NO,Williams Twp,75,1,0,0,76,21830,330,9,0,22169
LEADBETTER RETENTION,  LEADBETTER - YES,"City--1st Ward, 1st Precinct",47,1,0,0,48,14208,401,11,0,14620
LEADBETTER RETENTION,  LEADBETTER - YES,"City--1st Ward, 2nd Precinct",76,2,1,0,79,14208,401,11,0,14620
LEADBETTER RETENTION,  LEADBETTER - YES,"City--1st Ward, 3rd Precinct",28,0,0,0,28,14208,401,11,0,14620
LEADBETTER RETENTION,  LEADBETTER - YES,"City--2nd Ward, 1st Precinct",13,0,0,0,13,14208,401,11,0,14620
LEADBETTER RETENTION,  LEADBETTER - YES,"City--2nd Ward, 2nd Precinct",32,1,0,0,33,14208,401,11,0,14620
LEADBETTER RETENTION,  LEADBETTER - YES,City--3rd Ward,47,1,0,0,48,14208,401,11,0,14620
LEADBETTER RETENTION,  LEADBETTER - YES,City--4th Ward,74,4,0,0,78,14208,401,11,0,14620
LEADBETTER RETENTION,  LEADBETTER - YES,City--5th Ward,139,9,0,0,148,14208,401,11,0,14620
LEADBETTER RETENTION,  LEADBETTER - YES,City--6th Ward,67,1,3,0,71,14208,401,11,0,14620
LEADBETTER RETENTION,  LEADBETTER - YES,"City--7th Ward, 1st Precinct",29,0,0,0,29,14208,401,11,0,14620
LEADBETTER RETENTION,  LEADBETTER - YES,"City--7th Ward, 2nd Precinct",57,0,0,0,57,14208,401,11,0,14620
LEADBETTER RETENTION,  LEADBETTER - YES,City--8th Ward,55,0,0,0,55,14208,401,11,0,14620
LEADBETTER RETENTION,  LEADBETTER - YES,"City--9th Ward, 1st Precinct",21,2,0,0,23,14208,401,11,0,14620
LEADBETTER RETENTION,  LEADBETTER - YES,"City--9th Ward, 2nd Precinct",36,2,0,0,38,14208,401,11,0,14620
LEADBETTER RETENTION,  LEADBETTER - YES,"City--9th Ward, 3rd Precinct",68,1,0,0,69,14208,401,11,0,14620
LEADBETTER RETENTION,  LEADBETTER - YES,"City--9th Ward, 4th Precinct",86,3,0,0,89,14208,401,11,0,14620
LEADBETTER RETENTION,  LEADBETTER - YES,"City--9th Ward, 5th Precinct",60,1,0,0,61,14208,401,11,0,14620
LEADBETTER RETENTION,  LEADBETTER - YES,"City--10th Ward, 1st Precinct",92,6,0,0,98,14208,401,11,0,14620
LEADBETTER RETENTION,  LEADBETTER - YES,"City--10th Ward, 2nd Precinct",30,0,0,0,30,14208,401,11,0,14620
LEADBETTER RETENTION,  LEADBETTER - YES,"City--10th Ward, 3rd Precinct",49,0,0,0,49,14208,401,11,0,14620
LEADBETTER RETENTION,  LEADBETTER - YES,"City--10th Ward, 4th Precinct",50,0,0,0,50,14208,401,11,0,14620
LEADBETTER RETENTION,  LEADBETTER - YES,City--11th Ward,40,29,0,0,69,14208,401,11,0,14620
LEADBETTER RETENTION,  LEADBETTER - YES,City--12th Ward,104,4,0,0,108,14208,401,11,0,14620
LEADBETTER RETENTION,  LEADBETTER - YES,"City--13th Ward, 1st Precinct",50,0,0,0,50,14208,401,11,0,14620
LEADBETTER RETENTION,  LEADBETTER - YES,"City--13th Ward, 2nd Precinct",76,0,0,0,76,14208,401,11,0,14620
LEADBETTER RETENTION,  LEADBETTER - YES,"City--13th Ward, 3rd Precinct",84,0,0,0,84,14208,401,11,0,14620
LEADBETTER RETENTION,  LEADBETTER - YES,City--14th Ward,136,5,0,0,141,14208,401,11,0,14620
LEADBETTER RETENTION,  LEADBETTER - YES,City--15th Ward,28,1,0,0,29,14208,401,11,0,14620
LEADBETTER RETENTION,  LEADBETTER - YES,Berrysburg Borough,23,0,0,0,23,14208,401,11,0,14620
LEADBETTER RETENTION,  LEADBETTER - YES,Dauphin Borough,43,2,0,0,45,14208,401,11,0,14620
LEADBETTER RETENTION,  LEADBETTER - YES,Elizabethville Borough,59,1,0,0,60,14208,401,11,0,14620
LEADBETTER RETENTION,  LEADBETTER - YES,Gratz Borough,34,1,0,0,35,14208,401,11,0,14620
LEADBETTER RETENTION,  LEADBETTER - YES,Halifax Borough,31,2,0,0,33,14208,401,11,0,14620
LEADBETTER RETENTION,  LEADBETTER - YES,Highspire--1st Precinct,57,0,0,0,57,14208,401,11,0,14620
LEADBETTER RETENTION,  LEADBETTER - YES,Highspire--2nd Precinct,65,1,0,0,66,14208,401,11,0,14620
LEADBETTER RETENTION,  LEADBETTER - YES,Hummelstown--1st Precinct,73,1,0,0,74,14208,401,11,0,14620
LEADBETTER RETENTION,  LEADBETTER - YES,Hummelstown--2nd Precinct,165,4,0,0,169,14208,401,11,0,14620
LEADBETTER RETENTION,  LEADBETTER - YES,Lykens Borough--1st Ward,41,1,0,0,42,14208,401,11,0,14620
LEADBETTER RETENTION,  LEADBETTER - YES,Lykens Borough--2nd Ward,47,2,0,0,49,14208,401,11,0,14620
LEADBETTER RETENTION,  LEADBETTER - YES,"Middletown--1st Ward, 1st Precinct",45,0,0,0,45,14208,401,11,0,14620
LEADBETTER RETENTION,  LEADBETTER - YES,"Middletown--1st Ward, 2nd Precinct",70,5,0,0,75,14208,401,11,0,14620
LEADBETTER RETENTION,  LEADBETTER - YES,"Middletown--2nd Ward, 1st Precinct",52,0,0,0,52,14208,401,11,0,14620
LEADBETTER RETENTION,  LEADBETTER - YES,"Middletown--2nd Ward, 2nd Precinct",59,0,0,0,59,14208,401,11,0,14620
LEADBETTER RETENTION,  LEADBETTER - YES,"Middletown--3rd Ward, 1st Precinct",45,0,0,0,45,14208,401,11,0,14620
LEADBETTER RETENTION,  LEADBETTER - YES,"Middletown--3rd Ward, 2nd Precinct",83,0,0,0,83,14208,401,11,0,14620
LEADBETTER RETENTION,  LEADBETTER - YES,Millersburg--1st Ward,58,2,0,0,60,14208,401,11,0,14620
LEADBETTER RETENTION,  LEADBETTER - YES,Millersburg--2nd Ward,58,3,0,0,61,14208,401,11,0,14620
LEADBETTER RETENTION,  LEADBETTER - YES,Paxtang Borough,121,1,0,0,122,14208,401,11,0,14620
LEADBETTER RETENTION,  LEADBETTER - YES,Penbrook Borough--1st Ward,27,1,0,0,28,14208,401,11,0,14620
LEADBETTER RETENTION,  LEADBETTER - YES,Penbrook Borough--2nd Ward,34,0,0,0,34,14208,401,11,0,14620
LEADBETTER RETENTION,  LEADBETTER - YES,Penbrook Borough--3rd Ward,35,0,0,0,35,14208,401,11,0,14620
LEADBETTER RETENTION,  LEADBETTER - YES,Penbrook Borough--4th Ward,29,0,0,0,29,14208,401,11,0,14620
LEADBETTER RETENTION,  LEADBETTER - YES,Royalton Borough--1st Ward,17,0,0,0,17,14208,401,11,0,14620
LEADBETTER RETENTION,  LEADBETTER - YES,Royalton Borough--2nd Ward,26,0,0,0,26,14208,401,11,0,14620
LEADBETTER RETENTION,  LEADBETTER - YES,Steelton--1st Ward,55,2,0,0,57,14208,401,11,0,14620
LEADBETTER RETENTION,  LEADBETTER - YES,"Steelton--2nd Ward, 1st Precinct",48,1,0,0,49,14208,401,11,0,14620
LEADBETTER RETENTION,  LEADBETTER - YES,"Steelton--2nd Ward, 2nd Precinct",37,0,0,0,37,14208,401,11,0,14620
LEADBETTER RETENTION,  LEADBETTER - YES,"Steelton--3rd Ward, 1st Precinct",23,0,0,0,23,14208,401,11,0,14620
LEADBETTER RETENTION,  LEADBETTER - YES,"Steelton--3rd Ward, 2nd Precinct",39,0,0,0,39,14208,401,11,0,14620
LEADBETTER RETENTION,  LEADBETTER - YES,Steelton--4th Ward,39,1,1,0,41,14208,401,11,0,14620
LEADBETTER RETENTION,  LEADBETTER - YES,Pillow Borough,18,0,0,0,18,14208,401,11,0,14620
LEADBETTER RETENTION,  LEADBETTER - YES,Williamstown--1st Ward,38,0,0,0,38,14208,401,11,0,14620
LEADBETTER RETENTION,  LEADBETTER - YES,Williamstown--2nd Ward,26,0,0,0,26,14208,401,11,0,14620
LEADBETTER RETENTION,  LEADBETTER - YES,Conewago Twp--1st Precinct,86,1,0,0,87,14208,401,11,0,14620
LEADBETTER RETENTION,  LEADBETTER - YES,Conewago Twp--2nd Precinct,71,0,0,0,71,14208,401,11,0,14620
LEADBETTER RETENTION,  LEADBETTER - YES,Derry Township--1st Precinct,138,3,0,0,141,14208,401,11,0,14620
LEADBETTER RETENTION,  LEADBETTER - YES,Derry Township--2nd Precinct,110,3,0,0,113,14208,401,11,0,14620
LEADBETTER RETENTION,  LEADBETTER - YES,Derry Township--3rd Precinct,84,6,0,0,90,14208,401,11,0,14620
LEADBETTER RETENTION,  LEADBETTER - YES,Derry Township--4th Precinct,91,3,0,0,94,14208,401,11,0,14620
LEADBETTER RETENTION,  LEADBETTER - YES,Derry Township--5th Precinct,62,1,0,0,63,14208,401,11,0,14620
LEADBETTER RETENTION,  LEADBETTER - YES,Derry Township--6th Precinct,82,2,0,0,84,14208,401,11,0,14620
LEADBETTER RETENTION,  LEADBETTER - YES,Derry Township--7th Precinct,160,9,0,0,169,14208,401,11,0,14620
LEADBETTER RETENTION,  LEADBETTER - YES,Derry Township--8th Precinct,74,0,0,0,74,14208,401,11,0,14620
LEADBETTER RETENTION,  LEADBETTER - YES,Derry Township--9th Precinct,58,3,0,0,61,14208,401,11,0,14620
LEADBETTER RETENTION,  LEADBETTER - YES,Derry Township--10th Precinct,91,4,0,0,95,14208,401,11,0,14620
LEADBETTER RETENTION,  LEADBETTER - YES,Derry Township--11th Precinct,133,4,0,0,137,14208,401,11,0,14620
LEADBETTER RETENTION,  LEADBETTER - YES,Derry Township--12th Precinct,83,2,0,0,85,14208,401,11,0,14620
LEADBETTER RETENTION,  LEADBETTER - YES,Derry Township--13th Precinct,125,4,0,0,129,14208,401,11,0,14620
LEADBETTER RETENTION,  LEADBETTER - YES,Derry Township--14th Precinct,81,5,0,0,86,14208,401,11,0,14620
LEADBETTER RETENTION,  LEADBETTER - YES,Derry Township--15th Precinct,121,3,1,0,125,14208,401,11,0,14620
LEADBETTER RETENTION,  LEADBETTER - YES,East Hanover Township--1st Precinct,108,5,0,0,113,14208,401,11,0,14620
LEADBETTER RETENTION,  LEADBETTER - YES,East Hanover Township--2nd Precinct,146,2,0,0,148,14208,401,11,0,14620
LEADBETTER RETENTION,  LEADBETTER - YES,Halifax Twp--1st Precinct,95,1,0,0,96,14208,401,11,0,14620
LEADBETTER RETENTION,  LEADBETTER - YES,Halifax Twp--2nd Precinct,122,1,0,0,123,14208,401,11,0,14620
LEADBETTER RETENTION,  LEADBETTER - YES,Jackson Township,72,0,0,0,72,14208,401,11,0,14620
LEADBETTER RETENTION,  LEADBETTER - YES,Jefferson Township,16,0,0,0,16,14208,401,11,0,14620
LEADBETTER RETENTION,  LEADBETTER - YES,Londonderry Twp--1st Precinct,112,0,0,0,112,14208,401,11,0,14620
LEADBETTER RETENTION,  LEADBETTER - YES,Londonderry Twp--2nd Precinct,87,1,0,0,88,14208,401,11,0,14620
LEADBETTER RETENTION,  LEADBETTER - YES,Londonderry Twp--3rd Precinct,55,0,0,0,55,14208,401,11,0,14620
LEADBETTER RETENTION,  LEADBETTER - YES,Lower Paxton Twp--1st Precinct,102,2,0,0,104,14208,401,11,0,14620
LEADBETTER RETENTION,  LEADBETTER - YES,Lower Paxton Twp--2nd Precinct,100,4,0,0,104,14208,401,11,0,14620
LEADBETTER RETENTION,  LEADBETTER - YES,Lower Paxton Twp--3rd precinct,189,5,0,0,194,14208,401,11,0,14620
LEADBETTER RETENTION,  LEADBETTER - YES,Lower Paxton Twp--4th Precinct,119,2,0,0,121,14208,401,11,0,14620
LEADBETTER RETENTION,  LEADBETTER - YES,Lower Paxton Twp--5th Precinct,111,0,0,0,111,14208,401,11,0,14620
LEADBETTER RETENTION,  LEADBETTER - YES,Lower Paxton Twp--6th Precinct,89,5,0,0,94,14208,401,11,0,14620
LEADBETTER RETENTION,  LEADBETTER - YES,Lower Paxton Twp--7th Precinct,166,6,0,0,172,14208,401,11,0,14620
LEADBETTER RETENTION,  LEADBETTER - YES,Lower Paxton Twp--8th Precinct,78,2,0,0,80,14208,401,11,0,14620
LEADBETTER RETENTION,  LEADBETTER - YES,Lower Paxton Twp--9th Precinct,75,3,0,0,78,14208,401,11,0,14620
LEADBETTER RETENTION,  LEADBETTER - YES,Lower Paxton Twp--10th Precinct,77,3,0,0,80,14208,401,11,0,14620
LEADBETTER RETENTION,  LEADBETTER - YES,Lower Paxton Twp--11th Precinct,80,0,0,0,80,14208,401,11,0,14620
LEADBETTER RETENTION,  LEADBETTER - YES,Lower Paxton Twp--12th Precinct,166,4,0,0,170,14208,401,11,0,14620
LEADBETTER RETENTION,  LEADBETTER - YES,Lower Paxton Twp--13th Precinct,102,4,0,0,106,14208,401,11,0,14620
LEADBETTER RETENTION,  LEADBETTER - YES,Lower Paxton Twp--14th Precinct,86,1,3,0,90,14208,401,11,0,14620
LEADBETTER RETENTION,  LEADBETTER - YES,Lower Paxton Twp--15th Precinct,116,3,0,0,119,14208,401,11,0,14620
LEADBETTER RETENTION,  LEADBETTER - YES,Lower Paxton Twp--16th Precinct,189,7,0,0,196,14208,401,11,0,14620
LEADBETTER RETENTION,  LEADBETTER - YES,Lower Paxton Twp--17th Precinct,101,4,0,0,105,14208,401,11,0,14620
LEADBETTER RETENTION,  LEADBETTER - YES,Lower Paxton Twp--18th Precinct,101,1,0,0,102,14208,401,11,0,14620
LEADBETTER RETENTION,  LEADBETTER - YES,Lower Paxton Twp--19th Precinct,189,5,0,0,194,14208,401,11,0,14620
LEADBETTER RETENTION,  LEADBETTER - YES,Lower Paxton Twp--20th Precinct,122,3,0,0,125,14208,401,11,0,14620
LEADBETTER RETENTION,  LEADBETTER - YES,Lower Paxton Twp--21st Precinct,152,8,0,0,160,14208,401,11,0,14620
LEADBETTER RETENTION,  LEADBETTER - YES,Lower Paxton Twp--22nd Precinct,131,2,0,0,133,14208,401,11,0,14620
LEADBETTER RETENTION,  LEADBETTER - YES,Lower Paxton Twp--23rd Precinct,129,1,0,0,130,14208,401,11,0,14620
LEADBETTER RETENTION,  LEADBETTER - YES,Lower Paxton Twp--24th Precinct,126,2,0,0,128,14208,401,11,0,14620
LEADBETTER RETENTION,  LEADBETTER - YES,Lower Paxton Twp--25th Precinct,98,3,0,0,101,14208,401,11,0,14620
LEADBETTER RETENTION,  LEADBETTER - YES,Lower Paxton Twp--26th Precinct,131,3,0,0,134,14208,401,11,0,14620
LEADBETTER RETENTION,  LEADBETTER - YES,Lower Paxton Twp--27th Precinct,116,1,0,0,117,14208,401,11,0,14620
LEADBETTER RETENTION,  LEADBETTER - YES,Lower Swatara Twp--1st Precinct,143,3,0,0,146,14208,401,11,0,14620
LEADBETTER RETENTION,  LEADBETTER - YES,Lower Swatara Twp--2nd Precinct,137,3,0,0,140,14208,401,11,0,14620
LEADBETTER RETENTION,  LEADBETTER - YES,Lower Swatara Twp--3rd Precinct,122,16,0,0,138,14208,401,11,0,14620
LEADBETTER RETENTION,  LEADBETTER - YES,Lower Swatara Twp--4th Precinct,89,1,0,0,90,14208,401,11,0,14620
LEADBETTER RETENTION,  LEADBETTER - YES,Lykens Township,29,0,0,0,29,14208,401,11,0,14620
LEADBETTER RETENTION,  LEADBETTER - YES,Middle Paxton Twp--1st Precinct,80,0,0,0,80,14208,401,11,0,14620
LEADBETTER RETENTION,  LEADBETTER - YES,Middle Paxton Twp--2nd Precinct,107,0,0,0,107,14208,401,11,0,14620
LEADBETTER RETENTION,  LEADBETTER - YES,Middle Paxton Twp--3rd Precinct,96,2,0,0,98,14208,401,11,0,14620
LEADBETTER RETENTION,  LEADBETTER - YES,Mifflin Township,29,0,0,0,29,14208,401,11,0,14620
LEADBETTER RETENTION,  LEADBETTER - YES,Reed Township,14,0,0,0,14,14208,401,11,0,14620
LEADBETTER RETENTION,  LEADBETTER - YES,Rush Township,16,0,0,0,16,14208,401,11,0,14620
LEADBETTER RETENTION,  LEADBETTER - YES,South Hanover Twp--1st Precinct,94,1,0,0,95,14208,401,11,0,14620
LEADBETTER RETENTION,  LEADBETTER - YES,South Hanover Twp--2nd Precinct,158,5,0,0,163,14208,401,11,0,14620
LEADBETTER RETENTION,  LEADBETTER - YES,South Hanover Twp--3rd Precinct,83,0,0,0,83,14208,401,11,0,14620
LEADBETTER RETENTION,  LEADBETTER - YES,Susquehanna Twp--1st Ward,207,12,0,0,219,14208,401,11,0,14620
LEADBETTER RETENTION,  LEADBETTER - YES,Susquehanna Twp--2nd Ward,293,13,0,0,306,14208,401,11,0,14620
LEADBETTER RETENTION,  LEADBETTER - YES,Susquehanna Twp--3rd Ward,121,1,0,0,122,14208,401,11,0,14620
LEADBETTER RETENTION,  LEADBETTER - YES,Susquehanna Twp--4th Ward,127,1,0,0,128,14208,401,11,0,14620
LEADBETTER RETENTION,  LEADBETTER - YES,Susquehanna Twp--5th Ward,135,3,0,0,138,14208,401,11,0,14620
LEADBETTER RETENTION,  LEADBETTER - YES,Susquehanna Twp--6th Ward,159,3,0,0,162,14208,401,11,0,14620
LEADBETTER RETENTION,  LEADBETTER - YES,Susquehanna Twp--7th Ward,94,0,0,0,94,14208,401,11,0,14620
LEADBETTER RETENTION,  LEADBETTER - YES,Susquehanna Twp--8th Ward,265,10,0,0,275,14208,401,11,0,14620
LEADBETTER RETENTION,  LEADBETTER - YES,Susquehanna Twp--9th Ward,183,4,0,0,187,14208,401,11,0,14620
LEADBETTER RETENTION,  LEADBETTER - YES,Swatara Township--1st Ward,142,1,0,0,143,14208,401,11,0,14620
LEADBETTER RETENTION,  LEADBETTER - YES,Swatara Township--2nd Ward,87,16,0,0,103,14208,401,11,0,14620
LEADBETTER RETENTION,  LEADBETTER - YES,Swatara Township--3rd Ward,104,6,0,0,110,14208,401,11,0,14620
LEADBETTER RETENTION,  LEADBETTER - YES,Swatara Township--4th Ward,141,2,0,0,143,14208,401,11,0,14620
LEADBETTER RETENTION,  LEADBETTER - YES,Swatara Township--5th Ward,186,4,0,0,190,14208,401,11,0,14620
LEADBETTER RETENTION,  LEADBETTER - YES,Swatara Township--6th Ward,143,3,1,0,147,14208,401,11,0,14620
LEADBETTER RETENTION,  LEADBETTER - YES,Swatara Township--7th Ward,150,9,0,0,159,14208,401,11,0,14620
LEADBETTER RETENTION,  LEADBETTER - YES,Swatara Township--8th Ward,189,4,0,0,193,14208,401,11,0,14620
LEADBETTER RETENTION,  LEADBETTER - YES,Swatara Township--9th Ward,102,5,0,0,107,14208,401,11,0,14620
LEADBETTER RETENTION,  LEADBETTER - YES,Upper Paxton Twp--1st Precinct,113,1,0,0,114,14208,401,11,0,14620
LEADBETTER RETENTION,  LEADBETTER - YES,Upper Paxton Twp--2nd Precinct,56,2,0,0,58,14208,401,11,0,14620
LEADBETTER RETENTION,  LEADBETTER - YES,Washington Township,110,3,0,0,113,14208,401,11,0,14620
LEADBETTER RETENTION,  LEADBETTER - YES,Wayne Township,77,0,1,0,78,14208,401,11,0,14620
LEADBETTER RETENTION,  LEADBETTER - YES,West Hanover Twp--1st Precinct,96,2,0,0,98,14208,401,11,0,14620
LEADBETTER RETENTION,  LEADBETTER - YES,West Hanover Twp--2nd Precinct,108,4,0,0,112,14208,401,11,0,14620
LEADBETTER RETENTION,  LEADBETTER - YES,West Hanover Twp--3rd Precinct,246,8,0,0,254,14208,401,11,0,14620
LEADBETTER RETENTION,  LEADBETTER - YES,West Hanover Twp--4th Precinct,148,1,0,0,149,14208,401,11,0,14620
LEADBETTER RETENTION,  LEADBETTER - YES,Wiconisco Twp--1st Precinct,34,1,0,0,35,14208,401,11,0,14620
LEADBETTER RETENTION,  LEADBETTER - YES,Wiconisco Twp--2nd Precinct,31,0,0,0,31,14208,401,11,0,14620
LEADBETTER RETENTION,  LEADBETTER - YES,Williams Twp,66,0,0,0,66,14208,401,11,0,14620
MAYOR 2YR EVILLE,Timothy J. MATTER,Elizabethville Borough,120,3,0,0,123,120,3,0,0,123
MAYOR 2YR EVILLE,Write In  ,Elizabethville Borough,0,0,0,0,0,0,0,0,0,0
McGINLEY RETENTION,  MCGINLEY - NO,"City--1st Ward, 1st Precinct",46,2,0,0,48,22432,335,8,0,22775
McGINLEY RETENTION,  MCGINLEY - NO,"City--1st Ward, 2nd Precinct",75,0,0,0,75,22432,335,8,0,22775
McGINLEY RETENTION,  MCGINLEY - NO,"City--1st Ward, 3rd Precinct",37,0,0,0,37,22432,335,8,0,22775
McGINLEY RETENTION,  MCGINLEY - NO,"City--2nd Ward, 1st Precinct",27,0,0,0,27,22432,335,8,0,22775
McGINLEY RETENTION,  MCGINLEY - NO,"City--2nd Ward, 2nd Precinct",30,0,0,0,30,22432,335,8,0,22775
McGINLEY RETENTION,  MCGINLEY - NO,City--3rd Ward,37,0,0,0,37,22432,335,8,0,22775
McGINLEY RETENTION,  MCGINLEY - NO,City--4th Ward,82,1,0,0,83,22432,335,8,0,22775
McGINLEY RETENTION,  MCGINLEY - NO,City--5th Ward,171,4,0,0,175,22432,335,8,0,22775
McGINLEY RETENTION,  MCGINLEY - NO,City--6th Ward,96,1,0,0,97,22432,335,8,0,22775
McGINLEY RETENTION,  MCGINLEY - NO,"City--7th Ward, 1st Precinct",30,2,0,0,32,22432,335,8,0,22775
McGINLEY RETENTION,  MCGINLEY - NO,"City--7th Ward, 2nd Precinct",57,2,0,0,59,22432,335,8,0,22775
McGINLEY RETENTION,  MCGINLEY - NO,City--8th Ward,61,1,0,0,62,22432,335,8,0,22775
McGINLEY RETENTION,  MCGINLEY - NO,"City--9th Ward, 1st Precinct",29,1,0,0,30,22432,335,8,0,22775
McGINLEY RETENTION,  MCGINLEY - NO,"City--9th Ward, 2nd Precinct",33,1,0,0,34,22432,335,8,0,22775
McGINLEY RETENTION,  MCGINLEY - NO,"City--9th Ward, 3rd Precinct",98,0,0,0,98,22432,335,8,0,22775
McGINLEY RETENTION,  MCGINLEY - NO,"City--9th Ward, 4th Precinct",107,3,0,0,110,22432,335,8,0,22775
McGINLEY RETENTION,  MCGINLEY - NO,"City--9th Ward, 5th Precinct",60,3,0,0,63,22432,335,8,0,22775
McGINLEY RETENTION,  MCGINLEY - NO,"City--10th Ward, 1st Precinct",131,2,0,0,133,22432,335,8,0,22775
McGINLEY RETENTION,  MCGINLEY - NO,"City--10th Ward, 2nd Precinct",43,0,0,0,43,22432,335,8,0,22775
McGINLEY RETENTION,  MCGINLEY - NO,"City--10th Ward, 3rd Precinct",61,0,0,0,61,22432,335,8,0,22775
McGINLEY RETENTION,  MCGINLEY - NO,"City--10th Ward, 4th Precinct",47,0,0,0,47,22432,335,8,0,22775
McGINLEY RETENTION,  MCGINLEY - NO,City--11th Ward,56,2,0,0,58,22432,335,8,0,22775
McGINLEY RETENTION,  MCGINLEY - NO,City--12th Ward,138,4,0,0,142,22432,335,8,0,22775
McGINLEY RETENTION,  MCGINLEY - NO,"City--13th Ward, 1st Precinct",72,0,0,0,72,22432,335,8,0,22775
McGINLEY RETENTION,  MCGINLEY - NO,"City--13th Ward, 2nd Precinct",97,3,0,0,100,22432,335,8,0,22775
McGINLEY RETENTION,  MCGINLEY - NO,"City--13th Ward, 3rd Precinct",105,2,0,0,107,22432,335,8,0,22775
McGINLEY RETENTION,  MCGINLEY - NO,City--14th Ward,205,2,0,0,207,22432,335,8,0,22775
McGINLEY RETENTION,  MCGINLEY - NO,City--15th Ward,38,1,0,0,39,22432,335,8,0,22775
McGINLEY RETENTION,  MCGINLEY - NO,Berrysburg Borough,36,0,0,0,36,22432,335,8,0,22775
McGINLEY RETENTION,  MCGINLEY - NO,Dauphin Borough,131,0,0,0,131,22432,335,8,0,22775
McGINLEY RETENTION,  MCGINLEY - NO,Elizabethville Borough,115,2,0,0,117,22432,335,8,0,22775
McGINLEY RETENTION,  MCGINLEY - NO,Gratz Borough,41,0,0,0,41,22432,335,8,0,22775
McGINLEY RETENTION,  MCGINLEY - NO,Halifax Borough,69,0,0,0,69,22432,335,8,0,22775
McGINLEY RETENTION,  MCGINLEY - NO,Highspire--1st Precinct,96,2,0,0,98,22432,335,8,0,22775
McGINLEY RETENTION,  MCGINLEY - NO,Highspire--2nd Precinct,116,0,0,0,116,22432,335,8,0,22775
McGINLEY RETENTION,  MCGINLEY - NO,Hummelstown--1st Precinct,126,5,0,0,131,22432,335,8,0,22775
McGINLEY RETENTION,  MCGINLEY - NO,Hummelstown--2nd Precinct,263,3,0,0,266,22432,335,8,0,22775
McGINLEY RETENTION,  MCGINLEY - NO,Lykens Borough--1st Ward,49,0,0,0,49,22432,335,8,0,22775
McGINLEY RETENTION,  MCGINLEY - NO,Lykens Borough--2nd Ward,71,2,0,0,73,22432,335,8,0,22775
McGINLEY RETENTION,  MCGINLEY - NO,"Middletown--1st Ward, 1st Precinct",53,0,0,0,53,22432,335,8,0,22775
McGINLEY RETENTION,  MCGINLEY - NO,"Middletown--1st Ward, 2nd Precinct",97,1,0,0,98,22432,335,8,0,22775
McGINLEY RETENTION,  MCGINLEY - NO,"Middletown--2nd Ward, 1st Precinct",117,2,0,0,119,22432,335,8,0,22775
McGINLEY RETENTION,  MCGINLEY - NO,"Middletown--2nd Ward, 2nd Precinct",101,4,0,0,105,22432,335,8,0,22775
McGINLEY RETENTION,  MCGINLEY - NO,"Middletown--3rd Ward, 1st Precinct",78,1,0,0,79,22432,335,8,0,22775
McGINLEY RETENTION,  MCGINLEY - NO,"Middletown--3rd Ward, 2nd Precinct",146,0,0,0,146,22432,335,8,0,22775
McGINLEY RETENTION,  MCGINLEY - NO,Millersburg--1st Ward,80,1,0,0,81,22432,335,8,0,22775
McGINLEY RETENTION,  MCGINLEY - NO,Millersburg--2nd Ward,118,1,0,0,119,22432,335,8,0,22775
McGINLEY RETENTION,  MCGINLEY - NO,Paxtang Borough,159,1,0,0,160,22432,335,8,0,22775
McGINLEY RETENTION,  MCGINLEY - NO,Penbrook Borough--1st Ward,37,0,0,0,37,22432,335,8,0,22775
McGINLEY RETENTION,  MCGINLEY - NO,Penbrook Borough--2nd Ward,43,1,0,0,44,22432,335,8,0,22775
McGINLEY RETENTION,  MCGINLEY - NO,Penbrook Borough--3rd Ward,53,0,0,0,53,22432,335,8,0,22775
McGINLEY RETENTION,  MCGINLEY - NO,Penbrook Borough--4th Ward,81,2,0,0,83,22432,335,8,0,22775
McGINLEY RETENTION,  MCGINLEY - NO,Royalton Borough--1st Ward,28,0,0,0,28,22432,335,8,0,22775
McGINLEY RETENTION,  MCGINLEY - NO,Royalton Borough--2nd Ward,48,0,0,0,48,22432,335,8,0,22775
McGINLEY RETENTION,  MCGINLEY - NO,Steelton--1st Ward,85,2,0,0,87,22432,335,8,0,22775
McGINLEY RETENTION,  MCGINLEY - NO,"Steelton--2nd Ward, 1st Precinct",53,0,0,0,53,22432,335,8,0,22775
McGINLEY RETENTION,  MCGINLEY - NO,"Steelton--2nd Ward, 2nd Precinct",49,1,0,0,50,22432,335,8,0,22775
McGINLEY RETENTION,  MCGINLEY - NO,"Steelton--3rd Ward, 1st Precinct",27,0,0,0,27,22432,335,8,0,22775
McGINLEY RETENTION,  MCGINLEY - NO,"Steelton--3rd Ward, 2nd Precinct",55,0,0,0,55,22432,335,8,0,22775
McGINLEY RETENTION,  MCGINLEY - NO,Steelton--4th Ward,47,1,0,0,48,22432,335,8,0,22775
McGINLEY RETENTION,  MCGINLEY - NO,Pillow Borough,34,0,0,0,34,22432,335,8,0,22775
McGINLEY RETENTION,  MCGINLEY - NO,Williamstown--1st Ward,51,1,0,0,52,22432,335,8,0,22775
McGINLEY RETENTION,  MCGINLEY - NO,Williamstown--2nd Ward,44,0,0,0,44,22432,335,8,0,22775
McGINLEY RETENTION,  MCGINLEY - NO,Conewago Twp--1st Precinct,165,0,0,0,165,22432,335,8,0,22775
McGINLEY RETENTION,  MCGINLEY - NO,Conewago Twp--2nd Precinct,142,5,0,0,147,22432,335,8,0,22775
McGINLEY RETENTION,  MCGINLEY - NO,Derry Township--1st Precinct,223,2,0,0,225,22432,335,8,0,22775
McGINLEY RETENTION,  MCGINLEY - NO,Derry Township--2nd Precinct,160,2,0,0,162,22432,335,8,0,22775
McGINLEY RETENTION,  MCGINLEY - NO,Derry Township--3rd Precinct,140,1,1,0,142,22432,335,8,0,22775
McGINLEY RETENTION,  MCGINLEY - NO,Derry Township--4th Precinct,111,3,1,0,115,22432,335,8,0,22775
McGINLEY RETENTION,  MCGINLEY - NO,Derry Township--5th Precinct,95,2,0,0,97,22432,335,8,0,22775
McGINLEY RETENTION,  MCGINLEY - NO,Derry Township--6th Precinct,113,0,1,0,114,22432,335,8,0,22775
McGINLEY RETENTION,  MCGINLEY - NO,Derry Township--7th Precinct,235,8,0,0,243,22432,335,8,0,22775
McGINLEY RETENTION,  MCGINLEY - NO,Derry Township--8th Precinct,128,0,0,0,128,22432,335,8,0,22775
McGINLEY RETENTION,  MCGINLEY - NO,Derry Township--9th Precinct,68,1,0,0,69,22432,335,8,0,22775
McGINLEY RETENTION,  MCGINLEY - NO,Derry Township--10th Precinct,170,3,0,0,173,22432,335,8,0,22775
McGINLEY RETENTION,  MCGINLEY - NO,Derry Township--11th Precinct,217,6,0,0,223,22432,335,8,0,22775
McGINLEY RETENTION,  MCGINLEY - NO,Derry Township--12th Precinct,127,1,0,0,128,22432,335,8,0,22775
McGINLEY RETENTION,  MCGINLEY - NO,Derry Township--13th Precinct,140,1,0,0,141,22432,335,8,0,22775
McGINLEY RETENTION,  MCGINLEY - NO,Derry Township--14th Precinct,111,3,0,0,114,22432,335,8,0,22775
McGINLEY RETENTION,  MCGINLEY - NO,Derry Township--15th Precinct,244,4,0,0,248,22432,335,8,0,22775
McGINLEY RETENTION,  MCGINLEY - NO,East Hanover Township--1st Precinct,244,4,0,0,248,22432,335,8,0,22775
McGINLEY RETENTION,  MCGINLEY - NO,East Hanover Township--2nd Precinct,263,4,0,0,267,22432,335,8,0,22775
McGINLEY RETENTION,  MCGINLEY - NO,Halifax Twp--1st Precinct,212,2,0,0,214,22432,335,8,0,22775
McGINLEY RETENTION,  MCGINLEY - NO,Halifax Twp--2nd Precinct,214,11,0,0,225,22432,335,8,0,22775
McGINLEY RETENTION,  MCGINLEY - NO,Jackson Township,175,0,0,0,175,22432,335,8,0,22775
McGINLEY RETENTION,  MCGINLEY - NO,Jefferson Township,52,0,0,0,52,22432,335,8,0,22775
McGINLEY RETENTION,  MCGINLEY - NO,Londonderry Twp--1st Precinct,195,0,0,0,195,22432,335,8,0,22775
McGINLEY RETENTION,  MCGINLEY - NO,Londonderry Twp--2nd Precinct,209,1,0,0,210,22432,335,8,0,22775
McGINLEY RETENTION,  MCGINLEY - NO,Londonderry Twp--3rd Precinct,78,1,0,0,79,22432,335,8,0,22775
McGINLEY RETENTION,  MCGINLEY - NO,Lower Paxton Twp--1st Precinct,131,1,0,0,132,22432,335,8,0,22775
McGINLEY RETENTION,  MCGINLEY - NO,Lower Paxton Twp--2nd Precinct,147,6,0,0,153,22432,335,8,0,22775
McGINLEY RETENTION,  MCGINLEY - NO,Lower Paxton Twp--3rd precinct,277,7,0,0,284,22432,335,8,0,22775
McGINLEY RETENTION,  MCGINLEY - NO,Lower Paxton Twp--4th Precinct,209,3,0,0,212,22432,335,8,0,22775
McGINLEY RETENTION,  MCGINLEY - NO,Lower Paxton Twp--5th Precinct,179,4,1,0,184,22432,335,8,0,22775
McGINLEY RETENTION,  MCGINLEY - NO,Lower Paxton Twp--6th Precinct,132,0,0,0,132,22432,335,8,0,22775
McGINLEY RETENTION,  MCGINLEY - NO,Lower Paxton Twp--7th Precinct,212,1,0,0,213,22432,335,8,0,22775
McGINLEY RETENTION,  MCGINLEY - NO,Lower Paxton Twp--8th Precinct,112,1,0,0,113,22432,335,8,0,22775
McGINLEY RETENTION,  MCGINLEY - NO,Lower Paxton Twp--9th Precinct,153,3,0,0,156,22432,335,8,0,22775
McGINLEY RETENTION,  MCGINLEY - NO,Lower Paxton Twp--10th Precinct,81,2,0,0,83,22432,335,8,0,22775
McGINLEY RETENTION,  MCGINLEY - NO,Lower Paxton Twp--11th Precinct,145,2,0,0,147,22432,335,8,0,22775
McGINLEY RETENTION,  MCGINLEY - NO,Lower Paxton Twp--12th Precinct,184,4,1,0,189,22432,335,8,0,22775
McGINLEY RETENTION,  MCGINLEY - NO,Lower Paxton Twp--13th Precinct,213,2,0,0,215,22432,335,8,0,22775
McGINLEY RETENTION,  MCGINLEY - NO,Lower Paxton Twp--14th Precinct,105,1,0,0,106,22432,335,8,0,22775
McGINLEY RETENTION,  MCGINLEY - NO,Lower Paxton Twp--15th Precinct,178,4,0,0,182,22432,335,8,0,22775
McGINLEY RETENTION,  MCGINLEY - NO,Lower Paxton Twp--16th Precinct,283,4,0,0,287,22432,335,8,0,22775
McGINLEY RETENTION,  MCGINLEY - NO,Lower Paxton Twp--17th Precinct,127,0,0,0,127,22432,335,8,0,22775
McGINLEY RETENTION,  MCGINLEY - NO,Lower Paxton Twp--18th Precinct,140,1,0,0,141,22432,335,8,0,22775
McGINLEY RETENTION,  MCGINLEY - NO,Lower Paxton Twp--19th Precinct,223,14,0,0,237,22432,335,8,0,22775
McGINLEY RETENTION,  MCGINLEY - NO,Lower Paxton Twp--20th Precinct,168,3,0,0,171,22432,335,8,0,22775
McGINLEY RETENTION,  MCGINLEY - NO,Lower Paxton Twp--21st Precinct,225,4,0,0,229,22432,335,8,0,22775
McGINLEY RETENTION,  MCGINLEY - NO,Lower Paxton Twp--22nd Precinct,188,4,0,0,192,22432,335,8,0,22775
McGINLEY RETENTION,  MCGINLEY - NO,Lower Paxton Twp--23rd Precinct,163,3,0,0,166,22432,335,8,0,22775
McGINLEY RETENTION,  MCGINLEY - NO,Lower Paxton Twp--24th Precinct,168,5,0,0,173,22432,335,8,0,22775
McGINLEY RETENTION,  MCGINLEY - NO,Lower Paxton Twp--25th Precinct,130,1,0,0,131,22432,335,8,0,22775
McGINLEY RETENTION,  MCGINLEY - NO,Lower Paxton Twp--26th Precinct,173,5,0,0,178,22432,335,8,0,22775
McGINLEY RETENTION,  MCGINLEY - NO,Lower Paxton Twp--27th Precinct,151,0,0,0,151,22432,335,8,0,22775
McGINLEY RETENTION,  MCGINLEY - NO,Lower Swatara Twp--1st Precinct,244,2,0,0,246,22432,335,8,0,22775
McGINLEY RETENTION,  MCGINLEY - NO,Lower Swatara Twp--2nd Precinct,195,4,0,0,199,22432,335,8,0,22775
McGINLEY RETENTION,  MCGINLEY - NO,Lower Swatara Twp--3rd Precinct,158,3,0,0,161,22432,335,8,0,22775
McGINLEY RETENTION,  MCGINLEY - NO,Lower Swatara Twp--4th Precinct,178,0,0,0,178,22432,335,8,0,22775
McGINLEY RETENTION,  MCGINLEY - NO,Lykens Township,60,0,0,0,60,22432,335,8,0,22775
McGINLEY RETENTION,  MCGINLEY - NO,Middle Paxton Twp--1st Precinct,296,2,0,0,298,22432,335,8,0,22775
McGINLEY RETENTION,  MCGINLEY - NO,Middle Paxton Twp--2nd Precinct,209,2,0,0,211,22432,335,8,0,22775
McGINLEY RETENTION,  MCGINLEY - NO,Middle Paxton Twp--3rd Precinct,304,0,0,0,304,22432,335,8,0,22775
McGINLEY RETENTION,  MCGINLEY - NO,Mifflin Township,59,0,0,0,59,22432,335,8,0,22775
McGINLEY RETENTION,  MCGINLEY - NO,Reed Township,29,0,0,0,29,22432,335,8,0,22775
McGINLEY RETENTION,  MCGINLEY - NO,Rush Township,21,0,0,0,21,22432,335,8,0,22775
McGINLEY RETENTION,  MCGINLEY - NO,South Hanover Twp--1st Precinct,201,4,0,0,205,22432,335,8,0,22775
McGINLEY RETENTION,  MCGINLEY - NO,South Hanover Twp--2nd Precinct,252,6,0,0,258,22432,335,8,0,22775
McGINLEY RETENTION,  MCGINLEY - NO,South Hanover Twp--3rd Precinct,173,0,0,0,173,22432,335,8,0,22775
McGINLEY RETENTION,  MCGINLEY - NO,Susquehanna Twp--1st Ward,279,5,0,0,284,22432,335,8,0,22775
McGINLEY RETENTION,  MCGINLEY - NO,Susquehanna Twp--2nd Ward,418,11,0,0,429,22432,335,8,0,22775
McGINLEY RETENTION,  MCGINLEY - NO,Susquehanna Twp--3rd Ward,194,0,0,0,194,22432,335,8,0,22775
McGINLEY RETENTION,  MCGINLEY - NO,Susquehanna Twp--4th Ward,228,3,0,0,231,22432,335,8,0,22775
McGINLEY RETENTION,  MCGINLEY - NO,Susquehanna Twp--5th Ward,219,5,0,0,224,22432,335,8,0,22775
McGINLEY RETENTION,  MCGINLEY - NO,Susquehanna Twp--6th Ward,249,6,0,0,255,22432,335,8,0,22775
McGINLEY RETENTION,  MCGINLEY - NO,Susquehanna Twp--7th Ward,146,0,0,0,146,22432,335,8,0,22775
McGINLEY RETENTION,  MCGINLEY - NO,Susquehanna Twp--8th Ward,322,9,0,0,331,22432,335,8,0,22775
McGINLEY RETENTION,  MCGINLEY - NO,Susquehanna Twp--9th Ward,246,2,0,0,248,22432,335,8,0,22775
McGINLEY RETENTION,  MCGINLEY - NO,Swatara Township--1st Ward,196,0,0,0,196,22432,335,8,0,22775
McGINLEY RETENTION,  MCGINLEY - NO,Swatara Township--2nd Ward,109,2,0,0,111,22432,335,8,0,22775
McGINLEY RETENTION,  MCGINLEY - NO,Swatara Township--3rd Ward,133,2,0,0,135,22432,335,8,0,22775
McGINLEY RETENTION,  MCGINLEY - NO,Swatara Township--4th Ward,223,6,0,0,229,22432,335,8,0,22775
McGINLEY RETENTION,  MCGINLEY - NO,Swatara Township--5th Ward,293,3,0,0,296,22432,335,8,0,22775
McGINLEY RETENTION,  MCGINLEY - NO,Swatara Township--6th Ward,298,0,0,0,298,22432,335,8,0,22775
McGINLEY RETENTION,  MCGINLEY - NO,Swatara Township--7th Ward,326,2,0,0,328,22432,335,8,0,22775
McGINLEY RETENTION,  MCGINLEY - NO,Swatara Township--8th Ward,338,3,1,0,342,22432,335,8,0,22775
McGINLEY RETENTION,  MCGINLEY - NO,Swatara Township--9th Ward,107,3,0,0,110,22432,335,8,0,22775
McGINLEY RETENTION,  MCGINLEY - NO,Upper Paxton Twp--1st Precinct,187,2,0,0,189,22432,335,8,0,22775
McGINLEY RETENTION,  MCGINLEY - NO,Upper Paxton Twp--2nd Precinct,134,1,0,0,135,22432,335,8,0,22775
McGINLEY RETENTION,  MCGINLEY - NO,Washington Township,170,4,0,0,174,22432,335,8,0,22775
McGINLEY RETENTION,  MCGINLEY - NO,Wayne Township,187,1,0,0,188,22432,335,8,0,22775
McGINLEY RETENTION,  MCGINLEY - NO,West Hanover Twp--1st Precinct,235,4,0,0,239,22432,335,8,0,22775
McGINLEY RETENTION,  MCGINLEY - NO,West Hanover Twp--2nd Precinct,201,3,0,0,204,22432,335,8,0,22775
McGINLEY RETENTION,  MCGINLEY - NO,West Hanover Twp--3rd Precinct,487,11,2,0,500,22432,335,8,0,22775
McGINLEY RETENTION,  MCGINLEY - NO,West Hanover Twp--4th Precinct,271,2,0,0,273,22432,335,8,0,22775
McGINLEY RETENTION,  MCGINLEY - NO,Wiconisco Twp--1st Precinct,55,0,0,0,55,22432,335,8,0,22775
McGINLEY RETENTION,  MCGINLEY - NO,Wiconisco Twp--2nd Precinct,35,1,0,0,36,22432,335,8,0,22775
McGINLEY RETENTION,  MCGINLEY - NO,Williams Twp,73,1,0,0,74,22432,335,8,0,22775
McGINLEY RETENTION,  MCGINLEY - YES,"City--1st Ward, 1st Precinct",49,2,0,0,51,13274,389,12,0,13675
McGINLEY RETENTION,  MCGINLEY - YES,"City--1st Ward, 2nd Precinct",76,2,1,0,79,13274,389,12,0,13675
McGINLEY RETENTION,  MCGINLEY - YES,"City--1st Ward, 3rd Precinct",19,0,0,0,19,13274,389,12,0,13675
McGINLEY RETENTION,  MCGINLEY - YES,"City--2nd Ward, 1st Precinct",11,0,0,0,11,13274,389,12,0,13675
McGINLEY RETENTION,  MCGINLEY - YES,"City--2nd Ward, 2nd Precinct",32,1,0,0,33,13274,389,12,0,13675
McGINLEY RETENTION,  MCGINLEY - YES,City--3rd Ward,41,1,0,0,42,13274,389,12,0,13675
McGINLEY RETENTION,  MCGINLEY - YES,City--4th Ward,72,4,0,0,76,13274,389,12,0,13675
McGINLEY RETENTION,  MCGINLEY - YES,City--5th Ward,141,7,0,0,148,13274,389,12,0,13675
McGINLEY RETENTION,  MCGINLEY - YES,City--6th Ward,60,1,3,0,64,13274,389,12,0,13675
McGINLEY RETENTION,  MCGINLEY - YES,"City--7th Ward, 1st Precinct",27,0,0,0,27,13274,389,12,0,13675
McGINLEY RETENTION,  MCGINLEY - YES,"City--7th Ward, 2nd Precinct",62,0,0,0,62,13274,389,12,0,13675
McGINLEY RETENTION,  MCGINLEY - YES,City--8th Ward,49,0,0,0,49,13274,389,12,0,13675
McGINLEY RETENTION,  MCGINLEY - YES,"City--9th Ward, 1st Precinct",21,1,0,0,22,13274,389,12,0,13675
McGINLEY RETENTION,  MCGINLEY - YES,"City--9th Ward, 2nd Precinct",28,1,0,0,29,13274,389,12,0,13675
McGINLEY RETENTION,  MCGINLEY - YES,"City--9th Ward, 3rd Precinct",65,1,0,0,66,13274,389,12,0,13675
McGINLEY RETENTION,  MCGINLEY - YES,"City--9th Ward, 4th Precinct",90,3,0,0,93,13274,389,12,0,13675
McGINLEY RETENTION,  MCGINLEY - YES,"City--9th Ward, 5th Precinct",53,1,0,0,54,13274,389,12,0,13675
McGINLEY RETENTION,  MCGINLEY - YES,"City--10th Ward, 1st Precinct",86,4,0,0,90,13274,389,12,0,13675
McGINLEY RETENTION,  MCGINLEY - YES,"City--10th Ward, 2nd Precinct",28,0,0,0,28,13274,389,12,0,13675
McGINLEY RETENTION,  MCGINLEY - YES,"City--10th Ward, 3rd Precinct",47,0,0,0,47,13274,389,12,0,13675
McGINLEY RETENTION,  MCGINLEY - YES,"City--10th Ward, 4th Precinct",52,0,0,0,52,13274,389,12,0,13675
McGINLEY RETENTION,  MCGINLEY - YES,City--11th Ward,35,30,0,0,65,13274,389,12,0,13675
McGINLEY RETENTION,  MCGINLEY - YES,City--12th Ward,111,5,0,0,116,13274,389,12,0,13675
McGINLEY RETENTION,  MCGINLEY - YES,"City--13th Ward, 1st Precinct",46,0,0,0,46,13274,389,12,0,13675
McGINLEY RETENTION,  MCGINLEY - YES,"City--13th Ward, 2nd Precinct",72,1,0,0,73,13274,389,12,0,13675
McGINLEY RETENTION,  MCGINLEY - YES,"City--13th Ward, 3rd Precinct",86,0,0,0,86,13274,389,12,0,13675
McGINLEY RETENTION,  MCGINLEY - YES,City--14th Ward,125,5,0,0,130,13274,389,12,0,13675
McGINLEY RETENTION,  MCGINLEY - YES,City--15th Ward,33,0,0,0,33,13274,389,12,0,13675
McGINLEY RETENTION,  MCGINLEY - YES,Berrysburg Borough,22,0,0,0,22,13274,389,12,0,13675
McGINLEY RETENTION,  MCGINLEY - YES,Dauphin Borough,40,2,0,0,42,13274,389,12,0,13675
McGINLEY RETENTION,  MCGINLEY - YES,Elizabethville Borough,53,1,0,0,54,13274,389,12,0,13675
McGINLEY RETENTION,  MCGINLEY - YES,Gratz Borough,28,1,0,0,29,13274,389,12,0,13675
McGINLEY RETENTION,  MCGINLEY - YES,Halifax Borough,21,3,0,0,24,13274,389,12,0,13675
McGINLEY RETENTION,  MCGINLEY - YES,Highspire--1st Precinct,50,0,0,0,50,13274,389,12,0,13675
McGINLEY RETENTION,  MCGINLEY - YES,Highspire--2nd Precinct,50,1,0,0,51,13274,389,12,0,13675
McGINLEY RETENTION,  MCGINLEY - YES,Hummelstown--1st Precinct,73,1,0,0,74,13274,389,12,0,13675
McGINLEY RETENTION,  MCGINLEY - YES,Hummelstown--2nd Precinct,143,4,0,0,147,13274,389,12,0,13675
McGINLEY RETENTION,  MCGINLEY - YES,Lykens Borough--1st Ward,44,1,0,0,45,13274,389,12,0,13675
McGINLEY RETENTION,  MCGINLEY - YES,Lykens Borough--2nd Ward,53,2,0,0,55,13274,389,12,0,13675
McGINLEY RETENTION,  MCGINLEY - YES,"Middletown--1st Ward, 1st Precinct",43,0,0,0,43,13274,389,12,0,13675
McGINLEY RETENTION,  MCGINLEY - YES,"Middletown--1st Ward, 2nd Precinct",61,5,1,0,67,13274,389,12,0,13675
McGINLEY RETENTION,  MCGINLEY - YES,"Middletown--2nd Ward, 1st Precinct",50,0,0,0,50,13274,389,12,0,13675
McGINLEY RETENTION,  MCGINLEY - YES,"Middletown--2nd Ward, 2nd Precinct",60,0,0,0,60,13274,389,12,0,13675
McGINLEY RETENTION,  MCGINLEY - YES,"Middletown--3rd Ward, 1st Precinct",44,0,0,0,44,13274,389,12,0,13675
McGINLEY RETENTION,  MCGINLEY - YES,"Middletown--3rd Ward, 2nd Precinct",79,0,0,0,79,13274,389,12,0,13675
McGINLEY RETENTION,  MCGINLEY - YES,Millersburg--1st Ward,51,2,0,0,53,13274,389,12,0,13675
McGINLEY RETENTION,  MCGINLEY - YES,Millersburg--2nd Ward,51,2,0,0,53,13274,389,12,0,13675
McGINLEY RETENTION,  MCGINLEY - YES,Paxtang Borough,103,2,0,0,105,13274,389,12,0,13675
McGINLEY RETENTION,  MCGINLEY - YES,Penbrook Borough--1st Ward,30,1,0,0,31,13274,389,12,0,13675
McGINLEY RETENTION,  MCGINLEY - YES,Penbrook Borough--2nd Ward,33,0,0,0,33,13274,389,12,0,13675
McGINLEY RETENTION,  MCGINLEY - YES,Penbrook Borough--3rd Ward,31,0,0,0,31,13274,389,12,0,13675
McGINLEY RETENTION,  MCGINLEY - YES,Penbrook Borough--4th Ward,25,0,0,0,25,13274,389,12,0,13675
McGINLEY RETENTION,  MCGINLEY - YES,Royalton Borough--1st Ward,16,0,0,0,16,13274,389,12,0,13675
McGINLEY RETENTION,  MCGINLEY - YES,Royalton Borough--2nd Ward,26,0,0,0,26,13274,389,12,0,13675
McGINLEY RETENTION,  MCGINLEY - YES,Steelton--1st Ward,57,4,0,0,61,13274,389,12,0,13675
McGINLEY RETENTION,  MCGINLEY - YES,"Steelton--2nd Ward, 1st Precinct",50,1,0,0,51,13274,389,12,0,13675
McGINLEY RETENTION,  MCGINLEY - YES,"Steelton--2nd Ward, 2nd Precinct",33,0,0,0,33,13274,389,12,0,13675
McGINLEY RETENTION,  MCGINLEY - YES,"Steelton--3rd Ward, 1st Precinct",23,0,0,0,23,13274,389,12,0,13675
McGINLEY RETENTION,  MCGINLEY - YES,"Steelton--3rd Ward, 2nd Precinct",31,0,0,0,31,13274,389,12,0,13675
McGINLEY RETENTION,  MCGINLEY - YES,Steelton--4th Ward,35,1,1,0,37,13274,389,12,0,13675
McGINLEY RETENTION,  MCGINLEY - YES,Pillow Borough,17,0,0,0,17,13274,389,12,0,13675
McGINLEY RETENTION,  MCGINLEY - YES,Williamstown--1st Ward,42,0,0,0,42,13274,389,12,0,13675
McGINLEY RETENTION,  MCGINLEY - YES,Williamstown--2nd Ward,24,0,0,0,24,13274,389,12,0,13675
McGINLEY RETENTION,  MCGINLEY - YES,Conewago Twp--1st Precinct,70,1,0,0,71,13274,389,12,0,13675
McGINLEY RETENTION,  MCGINLEY - YES,Conewago Twp--2nd Precinct,62,0,0,0,62,13274,389,12,0,13675
McGINLEY RETENTION,  MCGINLEY - YES,Derry Township--1st Precinct,136,4,0,0,140,13274,389,12,0,13675
McGINLEY RETENTION,  MCGINLEY - YES,Derry Township--2nd Precinct,105,4,0,0,109,13274,389,12,0,13675
McGINLEY RETENTION,  MCGINLEY - YES,Derry Township--3rd Precinct,80,6,0,0,86,13274,389,12,0,13675
McGINLEY RETENTION,  MCGINLEY - YES,Derry Township--4th Precinct,82,3,0,0,85,13274,389,12,0,13675
McGINLEY RETENTION,  MCGINLEY - YES,Derry Township--5th Precinct,62,1,0,0,63,13274,389,12,0,13675
McGINLEY RETENTION,  MCGINLEY - YES,Derry Township--6th Precinct,81,2,0,0,83,13274,389,12,0,13675
McGINLEY RETENTION,  MCGINLEY - YES,Derry Township--7th Precinct,137,7,0,0,144,13274,389,12,0,13675
McGINLEY RETENTION,  MCGINLEY - YES,Derry Township--8th Precinct,69,0,0,0,69,13274,389,12,0,13675
McGINLEY RETENTION,  MCGINLEY - YES,Derry Township--9th Precinct,58,4,0,0,62,13274,389,12,0,13675
McGINLEY RETENTION,  MCGINLEY - YES,Derry Township--10th Precinct,87,3,0,0,90,13274,389,12,0,13675
McGINLEY RETENTION,  MCGINLEY - YES,Derry Township--11th Precinct,129,2,0,0,131,13274,389,12,0,13675
McGINLEY RETENTION,  MCGINLEY - YES,Derry Township--12th Precinct,78,4,0,0,82,13274,389,12,0,13675
McGINLEY RETENTION,  MCGINLEY - YES,Derry Township--13th Precinct,122,4,0,0,126,13274,389,12,0,13675
McGINLEY RETENTION,  MCGINLEY - YES,Derry Township--14th Precinct,74,4,0,0,78,13274,389,12,0,13675
McGINLEY RETENTION,  MCGINLEY - YES,Derry Township--15th Precinct,107,3,1,0,111,13274,389,12,0,13675
McGINLEY RETENTION,  MCGINLEY - YES,East Hanover Township--1st Precinct,100,5,0,0,105,13274,389,12,0,13675
McGINLEY RETENTION,  MCGINLEY - YES,East Hanover Township--2nd Precinct,125,1,0,0,126,13274,389,12,0,13675
McGINLEY RETENTION,  MCGINLEY - YES,Halifax Twp--1st Precinct,96,2,0,0,98,13274,389,12,0,13675
McGINLEY RETENTION,  MCGINLEY - YES,Halifax Twp--2nd Precinct,105,1,0,0,106,13274,389,12,0,13675
McGINLEY RETENTION,  MCGINLEY - YES,Jackson Township,64,0,0,0,64,13274,389,12,0,13675
McGINLEY RETENTION,  MCGINLEY - YES,Jefferson Township,15,0,0,0,15,13274,389,12,0,13675
McGINLEY RETENTION,  MCGINLEY - YES,Londonderry Twp--1st Precinct,100,0,0,0,100,13274,389,12,0,13675
McGINLEY RETENTION,  MCGINLEY - YES,Londonderry Twp--2nd Precinct,82,1,0,0,83,13274,389,12,0,13675
McGINLEY RETENTION,  MCGINLEY - YES,Londonderry Twp--3rd Precinct,50,0,0,0,50,13274,389,12,0,13675
McGINLEY RETENTION,  MCGINLEY - YES,Lower Paxton Twp--1st Precinct,89,2,0,0,91,13274,389,12,0,13675
McGINLEY RETENTION,  MCGINLEY - YES,Lower Paxton Twp--2nd Precinct,84,5,0,0,89,13274,389,12,0,13675
McGINLEY RETENTION,  MCGINLEY - YES,Lower Paxton Twp--3rd precinct,164,5,0,0,169,13274,389,12,0,13675
McGINLEY RETENTION,  MCGINLEY - YES,Lower Paxton Twp--4th Precinct,114,0,0,0,114,13274,389,12,0,13675
McGINLEY RETENTION,  MCGINLEY - YES,Lower Paxton Twp--5th Precinct,107,0,0,0,107,13274,389,12,0,13675
McGINLEY RETENTION,  MCGINLEY - YES,Lower Paxton Twp--6th Precinct,79,5,0,0,84,13274,389,12,0,13675
McGINLEY RETENTION,  MCGINLEY - YES,Lower Paxton Twp--7th Precinct,149,6,0,0,155,13274,389,12,0,13675
McGINLEY RETENTION,  MCGINLEY - YES,Lower Paxton Twp--8th Precinct,74,2,0,0,76,13274,389,12,0,13675
McGINLEY RETENTION,  MCGINLEY - YES,Lower Paxton Twp--9th Precinct,75,3,0,0,78,13274,389,12,0,13675
McGINLEY RETENTION,  MCGINLEY - YES,Lower Paxton Twp--10th Precinct,73,3,0,0,76,13274,389,12,0,13675
McGINLEY RETENTION,  MCGINLEY - YES,Lower Paxton Twp--11th Precinct,78,0,0,0,78,13274,389,12,0,13675
McGINLEY RETENTION,  MCGINLEY - YES,Lower Paxton Twp--12th Precinct,158,3,0,0,161,13274,389,12,0,13675
McGINLEY RETENTION,  MCGINLEY - YES,Lower Paxton Twp--13th Precinct,102,3,0,0,105,13274,389,12,0,13675
McGINLEY RETENTION,  MCGINLEY - YES,Lower Paxton Twp--14th Precinct,78,1,3,0,82,13274,389,12,0,13675
McGINLEY RETENTION,  MCGINLEY - YES,Lower Paxton Twp--15th Precinct,104,1,0,0,105,13274,389,12,0,13675
McGINLEY RETENTION,  MCGINLEY - YES,Lower Paxton Twp--16th Precinct,173,6,0,0,179,13274,389,12,0,13675
McGINLEY RETENTION,  MCGINLEY - YES,Lower Paxton Twp--17th Precinct,95,5,0,0,100,13274,389,12,0,13675
McGINLEY RETENTION,  MCGINLEY - YES,Lower Paxton Twp--18th Precinct,82,1,0,0,83,13274,389,12,0,13675
McGINLEY RETENTION,  MCGINLEY - YES,Lower Paxton Twp--19th Precinct,169,5,0,0,174,13274,389,12,0,13675
McGINLEY RETENTION,  MCGINLEY - YES,Lower Paxton Twp--20th Precinct,109,3,0,0,112,13274,389,12,0,13675
McGINLEY RETENTION,  MCGINLEY - YES,Lower Paxton Twp--21st Precinct,153,8,0,0,161,13274,389,12,0,13675
McGINLEY RETENTION,  MCGINLEY - YES,Lower Paxton Twp--22nd Precinct,121,2,0,0,123,13274,389,12,0,13675
McGINLEY RETENTION,  MCGINLEY - YES,Lower Paxton Twp--23rd Precinct,117,1,0,0,118,13274,389,12,0,13675
McGINLEY RETENTION,  MCGINLEY - YES,Lower Paxton Twp--24th Precinct,118,2,0,0,120,13274,389,12,0,13675
McGINLEY RETENTION,  MCGINLEY - YES,Lower Paxton Twp--25th Precinct,84,3,0,0,87,13274,389,12,0,13675
McGINLEY RETENTION,  MCGINLEY - YES,Lower Paxton Twp--26th Precinct,128,3,0,0,131,13274,389,12,0,13675
McGINLEY RETENTION,  MCGINLEY - YES,Lower Paxton Twp--27th Precinct,109,1,0,0,110,13274,389,12,0,13675
McGINLEY RETENTION,  MCGINLEY - YES,Lower Swatara Twp--1st Precinct,139,3,0,0,142,13274,389,12,0,13675
McGINLEY RETENTION,  MCGINLEY - YES,Lower Swatara Twp--2nd Precinct,124,3,0,0,127,13274,389,12,0,13675
McGINLEY RETENTION,  MCGINLEY - YES,Lower Swatara Twp--3rd Precinct,119,17,0,0,136,13274,389,12,0,13675
McGINLEY RETENTION,  MCGINLEY - YES,Lower Swatara Twp--4th Precinct,81,1,0,0,82,13274,389,12,0,13675
McGINLEY RETENTION,  MCGINLEY - YES,Lykens Township,30,0,0,0,30,13274,389,12,0,13675
McGINLEY RETENTION,  MCGINLEY - YES,Middle Paxton Twp--1st Precinct,74,0,0,0,74,13274,389,12,0,13675
McGINLEY RETENTION,  MCGINLEY - YES,Middle Paxton Twp--2nd Precinct,94,0,0,0,94,13274,389,12,0,13675
McGINLEY RETENTION,  MCGINLEY - YES,Middle Paxton Twp--3rd Precinct,83,2,0,0,85,13274,389,12,0,13675
McGINLEY RETENTION,  MCGINLEY - YES,Mifflin Township,25,0,0,0,25,13274,389,12,0,13675
McGINLEY RETENTION,  MCGINLEY - YES,Reed Township,17,0,0,0,17,13274,389,12,0,13675
McGINLEY RETENTION,  MCGINLEY - YES,Rush Township,18,0,0,0,18,13274,389,12,0,13675
McGINLEY RETENTION,  MCGINLEY - YES,South Hanover Twp--1st Precinct,87,1,0,0,88,13274,389,12,0,13675
McGINLEY RETENTION,  MCGINLEY - YES,South Hanover Twp--2nd Precinct,148,4,0,0,152,13274,389,12,0,13675
McGINLEY RETENTION,  MCGINLEY - YES,South Hanover Twp--3rd Precinct,75,0,0,0,75,13274,389,12,0,13675
McGINLEY RETENTION,  MCGINLEY - YES,Susquehanna Twp--1st Ward,206,10,0,0,216,13274,389,12,0,13675
McGINLEY RETENTION,  MCGINLEY - YES,Susquehanna Twp--2nd Ward,280,16,0,0,296,13274,389,12,0,13675
McGINLEY RETENTION,  MCGINLEY - YES,Susquehanna Twp--3rd Ward,118,2,0,0,120,13274,389,12,0,13675
McGINLEY RETENTION,  MCGINLEY - YES,Susquehanna Twp--4th Ward,116,0,0,0,116,13274,389,12,0,13675
McGINLEY RETENTION,  MCGINLEY - YES,Susquehanna Twp--5th Ward,132,1,0,0,133,13274,389,12,0,13675
McGINLEY RETENTION,  MCGINLEY - YES,Susquehanna Twp--6th Ward,150,3,0,0,153,13274,389,12,0,13675
McGINLEY RETENTION,  MCGINLEY - YES,Susquehanna Twp--7th Ward,90,0,0,0,90,13274,389,12,0,13675
McGINLEY RETENTION,  MCGINLEY - YES,Susquehanna Twp--8th Ward,251,9,0,0,260,13274,389,12,0,13675
McGINLEY RETENTION,  MCGINLEY - YES,Susquehanna Twp--9th Ward,169,2,0,0,171,13274,389,12,0,13675
McGINLEY RETENTION,  MCGINLEY - YES,Swatara Township--1st Ward,134,1,0,0,135,13274,389,12,0,13675
McGINLEY RETENTION,  MCGINLEY - YES,Swatara Township--2nd Ward,83,19,0,0,102,13274,389,12,0,13675
McGINLEY RETENTION,  MCGINLEY - YES,Swatara Township--3rd Ward,101,5,0,0,106,13274,389,12,0,13675
McGINLEY RETENTION,  MCGINLEY - YES,Swatara Township--4th Ward,136,2,0,0,138,13274,389,12,0,13675
McGINLEY RETENTION,  MCGINLEY - YES,Swatara Township--5th Ward,169,2,0,0,171,13274,389,12,0,13675
McGINLEY RETENTION,  MCGINLEY - YES,Swatara Township--6th Ward,130,3,1,0,134,13274,389,12,0,13675
McGINLEY RETENTION,  MCGINLEY - YES,Swatara Township--7th Ward,144,8,0,0,152,13274,389,12,0,13675
McGINLEY RETENTION,  MCGINLEY - YES,Swatara Township--8th Ward,164,4,0,0,168,13274,389,12,0,13675
McGINLEY RETENTION,  MCGINLEY - YES,Swatara Township--9th Ward,97,5,0,0,102,13274,389,12,0,13675
McGINLEY RETENTION,  MCGINLEY - YES,Upper Paxton Twp--1st Precinct,110,1,0,0,111,13274,389,12,0,13675
McGINLEY RETENTION,  MCGINLEY - YES,Upper Paxton Twp--2nd Precinct,59,2,0,0,61,13274,389,12,0,13675
McGINLEY RETENTION,  MCGINLEY - YES,Washington Township,110,3,0,0,113,13274,389,12,0,13675
McGINLEY RETENTION,  MCGINLEY - YES,Wayne Township,74,0,1,0,75,13274,389,12,0,13675
McGINLEY RETENTION,  MCGINLEY - YES,West Hanover Twp--1st Precinct,87,2,0,0,89,13274,389,12,0,13675
McGINLEY RETENTION,  MCGINLEY - YES,West Hanover Twp--2nd Precinct,101,3,0,0,104,13274,389,12,0,13675
McGINLEY RETENTION,  MCGINLEY - YES,West Hanover Twp--3rd Precinct,221,8,0,0,229,13274,389,12,0,13675
McGINLEY RETENTION,  MCGINLEY - YES,West Hanover Twp--4th Precinct,132,1,0,0,133,13274,389,12,0,13675
McGINLEY RETENTION,  MCGINLEY - YES,Wiconisco Twp--1st Precinct,29,1,0,0,30,13274,389,12,0,13675
McGINLEY RETENTION,  MCGINLEY - YES,Wiconisco Twp--2nd Precinct,27,0,0,0,27,13274,389,12,0,13675
McGINLEY RETENTION,  MCGINLEY - YES,Williams Twp,69,0,0,0,69,13274,389,12,0,13675
MELVIN RETENTION,  MELVIN - NO,"City--1st Ward, 1st Precinct",56,2,0,0,58,20842,301,10,0,21153
MELVIN RETENTION,  MELVIN - NO,"City--1st Ward, 2nd Precinct",77,0,0,0,77,20842,301,10,0,21153
MELVIN RETENTION,  MELVIN - NO,"City--1st Ward, 3rd Precinct",31,1,0,0,32,20842,301,10,0,21153
MELVIN RETENTION,  MELVIN - NO,"City--2nd Ward, 1st Precinct",21,0,0,0,21,20842,301,10,0,21153
MELVIN RETENTION,  MELVIN - NO,"City--2nd Ward, 2nd Precinct",29,0,0,0,29,20842,301,10,0,21153
MELVIN RETENTION,  MELVIN - NO,City--3rd Ward,30,0,0,0,30,20842,301,10,0,21153
MELVIN RETENTION,  MELVIN - NO,City--4th Ward,82,1,0,0,83,20842,301,10,0,21153
MELVIN RETENTION,  MELVIN - NO,City--5th Ward,176,2,0,0,178,20842,301,10,0,21153
MELVIN RETENTION,  MELVIN - NO,City--6th Ward,94,1,1,0,96,20842,301,10,0,21153
MELVIN RETENTION,  MELVIN - NO,"City--7th Ward, 1st Precinct",26,1,0,0,27,20842,301,10,0,21153
MELVIN RETENTION,  MELVIN - NO,"City--7th Ward, 2nd Precinct",56,2,0,0,58,20842,301,10,0,21153
MELVIN RETENTION,  MELVIN - NO,City--8th Ward,57,1,0,0,58,20842,301,10,0,21153
MELVIN RETENTION,  MELVIN - NO,"City--9th Ward, 1st Precinct",26,0,0,0,26,20842,301,10,0,21153
MELVIN RETENTION,  MELVIN - NO,"City--9th Ward, 2nd Precinct",31,1,0,0,32,20842,301,10,0,21153
MELVIN RETENTION,  MELVIN - NO,"City--9th Ward, 3rd Precinct",94,0,0,0,94,20842,301,10,0,21153
MELVIN RETENTION,  MELVIN - NO,"City--9th Ward, 4th Precinct",109,3,0,0,112,20842,301,10,0,21153
MELVIN RETENTION,  MELVIN - NO,"City--9th Ward, 5th Precinct",53,3,0,0,56,20842,301,10,0,21153
MELVIN RETENTION,  MELVIN - NO,"City--10th Ward, 1st Precinct",123,0,0,0,123,20842,301,10,0,21153
MELVIN RETENTION,  MELVIN - NO,"City--10th Ward, 2nd Precinct",41,0,0,0,41,20842,301,10,0,21153
MELVIN RETENTION,  MELVIN - NO,"City--10th Ward, 3rd Precinct",55,0,0,0,55,20842,301,10,0,21153
MELVIN RETENTION,  MELVIN - NO,"City--10th Ward, 4th Precinct",45,0,0,0,45,20842,301,10,0,21153
MELVIN RETENTION,  MELVIN - NO,City--11th Ward,56,1,0,0,57,20842,301,10,0,21153
MELVIN RETENTION,  MELVIN - NO,City--12th Ward,152,4,0,0,156,20842,301,10,0,21153
MELVIN RETENTION,  MELVIN - NO,"City--13th Ward, 1st Precinct",71,0,0,0,71,20842,301,10,0,21153
MELVIN RETENTION,  MELVIN - NO,"City--13th Ward, 2nd Precinct",92,4,0,0,96,20842,301,10,0,21153
MELVIN RETENTION,  MELVIN - NO,"City--13th Ward, 3rd Precinct",108,2,0,0,110,20842,301,10,0,21153
MELVIN RETENTION,  MELVIN - NO,City--14th Ward,200,2,0,0,202,20842,301,10,0,21153
MELVIN RETENTION,  MELVIN - NO,City--15th Ward,41,0,0,0,41,20842,301,10,0,21153
MELVIN RETENTION,  MELVIN - NO,Berrysburg Borough,37,0,0,0,37,20842,301,10,0,21153
MELVIN RETENTION,  MELVIN - NO,Dauphin Borough,118,0,0,0,118,20842,301,10,0,21153
MELVIN RETENTION,  MELVIN - NO,Elizabethville Borough,113,2,0,0,115,20842,301,10,0,21153
MELVIN RETENTION,  MELVIN - NO,Gratz Borough,36,0,0,0,36,20842,301,10,0,21153
MELVIN RETENTION,  MELVIN - NO,Halifax Borough,55,1,0,0,56,20842,301,10,0,21153
MELVIN RETENTION,  MELVIN - NO,Highspire--1st Precinct,92,2,0,0,94,20842,301,10,0,21153
MELVIN RETENTION,  MELVIN - NO,Highspire--2nd Precinct,95,0,0,0,95,20842,301,10,0,21153
MELVIN RETENTION,  MELVIN - NO,Hummelstown--1st Precinct,124,5,0,0,129,20842,301,10,0,21153
MELVIN RETENTION,  MELVIN - NO,Hummelstown--2nd Precinct,240,3,0,0,243,20842,301,10,0,21153
MELVIN RETENTION,  MELVIN - NO,Lykens Borough--1st Ward,49,0,0,0,49,20842,301,10,0,21153
MELVIN RETENTION,  MELVIN - NO,Lykens Borough--2nd Ward,72,2,0,0,74,20842,301,10,0,21153
MELVIN RETENTION,  MELVIN - NO,"Middletown--1st Ward, 1st Precinct",53,0,0,0,53,20842,301,10,0,21153
MELVIN RETENTION,  MELVIN - NO,"Middletown--1st Ward, 2nd Precinct",88,1,1,0,90,20842,301,10,0,21153
MELVIN RETENTION,  MELVIN - NO,"Middletown--2nd Ward, 1st Precinct",115,2,0,0,117,20842,301,10,0,21153
MELVIN RETENTION,  MELVIN - NO,"Middletown--2nd Ward, 2nd Precinct",99,3,0,0,102,20842,301,10,0,21153
MELVIN RETENTION,  MELVIN - NO,"Middletown--3rd Ward, 1st Precinct",70,1,0,0,71,20842,301,10,0,21153
MELVIN RETENTION,  MELVIN - NO,"Middletown--3rd Ward, 2nd Precinct",139,0,0,0,139,20842,301,10,0,21153
MELVIN RETENTION,  MELVIN - NO,Millersburg--1st Ward,73,1,0,0,74,20842,301,10,0,21153
MELVIN RETENTION,  MELVIN - NO,Millersburg--2nd Ward,111,0,0,0,111,20842,301,10,0,21153
MELVIN RETENTION,  MELVIN - NO,Paxtang Borough,148,0,0,0,148,20842,301,10,0,21153
MELVIN RETENTION,  MELVIN - NO,Penbrook Borough--1st Ward,39,0,0,0,39,20842,301,10,0,21153
MELVIN RETENTION,  MELVIN - NO,Penbrook Borough--2nd Ward,39,1,0,0,40,20842,301,10,0,21153
MELVIN RETENTION,  MELVIN - NO,Penbrook Borough--3rd Ward,48,0,0,0,48,20842,301,10,0,21153
MELVIN RETENTION,  MELVIN - NO,Penbrook Borough--4th Ward,76,2,0,0,78,20842,301,10,0,21153
MELVIN RETENTION,  MELVIN - NO,Royalton Borough--1st Ward,26,0,0,0,26,20842,301,10,0,21153
MELVIN RETENTION,  MELVIN - NO,Royalton Borough--2nd Ward,40,0,0,0,40,20842,301,10,0,21153
MELVIN RETENTION,  MELVIN - NO,Steelton--1st Ward,85,4,0,0,89,20842,301,10,0,21153
MELVIN RETENTION,  MELVIN - NO,"Steelton--2nd Ward, 1st Precinct",61,0,0,0,61,20842,301,10,0,21153
MELVIN RETENTION,  MELVIN - NO,"Steelton--2nd Ward, 2nd Precinct",48,1,0,0,49,20842,301,10,0,21153
MELVIN RETENTION,  MELVIN - NO,"Steelton--3rd Ward, 1st Precinct",23,0,0,0,23,20842,301,10,0,21153
MELVIN RETENTION,  MELVIN - NO,"Steelton--3rd Ward, 2nd Precinct",48,0,0,0,48,20842,301,10,0,21153
MELVIN RETENTION,  MELVIN - NO,Steelton--4th Ward,44,1,0,0,45,20842,301,10,0,21153
MELVIN RETENTION,  MELVIN - NO,Pillow Borough,31,0,0,0,31,20842,301,10,0,21153
MELVIN RETENTION,  MELVIN - NO,Williamstown--1st Ward,54,1,0,0,55,20842,301,10,0,21153
MELVIN RETENTION,  MELVIN - NO,Williamstown--2nd Ward,41,0,0,0,41,20842,301,10,0,21153
MELVIN RETENTION,  MELVIN - NO,Conewago Twp--1st Precinct,150,0,0,0,150,20842,301,10,0,21153
MELVIN RETENTION,  MELVIN - NO,Conewago Twp--2nd Precinct,122,3,0,0,125,20842,301,10,0,21153
MELVIN RETENTION,  MELVIN - NO,Derry Township--1st Precinct,198,2,0,0,200,20842,301,10,0,21153
MELVIN RETENTION,  MELVIN - NO,Derry Township--2nd Precinct,145,1,0,0,146,20842,301,10,0,21153
MELVIN RETENTION,  MELVIN - NO,Derry Township--3rd Precinct,134,1,1,0,136,20842,301,10,0,21153
MELVIN RETENTION,  MELVIN - NO,Derry Township--4th Precinct,99,3,1,0,103,20842,301,10,0,21153
MELVIN RETENTION,  MELVIN - NO,Derry Township--5th Precinct,89,3,0,0,92,20842,301,10,0,21153
MELVIN RETENTION,  MELVIN - NO,Derry Township--6th Precinct,95,0,1,0,96,20842,301,10,0,21153
MELVIN RETENTION,  MELVIN - NO,Derry Township--7th Precinct,201,6,0,0,207,20842,301,10,0,21153
MELVIN RETENTION,  MELVIN - NO,Derry Township--8th Precinct,112,0,0,0,112,20842,301,10,0,21153
MELVIN RETENTION,  MELVIN - NO,Derry Township--9th Precinct,67,1,0,0,68,20842,301,10,0,21153
MELVIN RETENTION,  MELVIN - NO,Derry Township--10th Precinct,153,2,0,0,155,20842,301,10,0,21153
MELVIN RETENTION,  MELVIN - NO,Derry Township--11th Precinct,201,4,0,0,205,20842,301,10,0,21153
MELVIN RETENTION,  MELVIN - NO,Derry Township--12th Precinct,110,3,0,0,113,20842,301,10,0,21153
MELVIN RETENTION,  MELVIN - NO,Derry Township--13th Precinct,131,1,0,0,132,20842,301,10,0,21153
MELVIN RETENTION,  MELVIN - NO,Derry Township--14th Precinct,106,2,0,0,108,20842,301,10,0,21153
MELVIN RETENTION,  MELVIN - NO,Derry Township--15th Precinct,205,4,0,0,209,20842,301,10,0,21153
MELVIN RETENTION,  MELVIN - NO,East Hanover Township--1st Precinct,221,3,0,0,224,20842,301,10,0,21153
MELVIN RETENTION,  MELVIN - NO,East Hanover Township--2nd Precinct,250,4,0,0,254,20842,301,10,0,21153
MELVIN RETENTION,  MELVIN - NO,Halifax Twp--1st Precinct,203,2,0,0,205,20842,301,10,0,21153
MELVIN RETENTION,  MELVIN - NO,Halifax Twp--2nd Precinct,184,11,0,0,195,20842,301,10,0,21153
MELVIN RETENTION,  MELVIN - NO,Jackson Township,158,0,0,0,158,20842,301,10,0,21153
MELVIN RETENTION,  MELVIN - NO,Jefferson Township,47,0,0,0,47,20842,301,10,0,21153
MELVIN RETENTION,  MELVIN - NO,Londonderry Twp--1st Precinct,176,0,0,0,176,20842,301,10,0,21153
MELVIN RETENTION,  MELVIN - NO,Londonderry Twp--2nd Precinct,194,1,0,0,195,20842,301,10,0,21153
MELVIN RETENTION,  MELVIN - NO,Londonderry Twp--3rd Precinct,62,1,0,0,63,20842,301,10,0,21153
MELVIN RETENTION,  MELVIN - NO,Lower Paxton Twp--1st Precinct,117,1,0,0,118,20842,301,10,0,21153
MELVIN RETENTION,  MELVIN - NO,Lower Paxton Twp--2nd Precinct,136,4,0,0,140,20842,301,10,0,21153
MELVIN RETENTION,  MELVIN - NO,Lower Paxton Twp--3rd precinct,248,7,0,0,255,20842,301,10,0,21153
MELVIN RETENTION,  MELVIN - NO,Lower Paxton Twp--4th Precinct,195,1,0,0,196,20842,301,10,0,21153
MELVIN RETENTION,  MELVIN - NO,Lower Paxton Twp--5th Precinct,169,4,1,0,174,20842,301,10,0,21153
MELVIN RETENTION,  MELVIN - NO,Lower Paxton Twp--6th Precinct,123,0,0,0,123,20842,301,10,0,21153
MELVIN RETENTION,  MELVIN - NO,Lower Paxton Twp--7th Precinct,205,0,0,0,205,20842,301,10,0,21153
MELVIN RETENTION,  MELVIN - NO,Lower Paxton Twp--8th Precinct,103,1,0,0,104,20842,301,10,0,21153
MELVIN RETENTION,  MELVIN - NO,Lower Paxton Twp--9th Precinct,146,3,0,0,149,20842,301,10,0,21153
MELVIN RETENTION,  MELVIN - NO,Lower Paxton Twp--10th Precinct,75,1,0,0,76,20842,301,10,0,21153
MELVIN RETENTION,  MELVIN - NO,Lower Paxton Twp--11th Precinct,125,2,0,0,127,20842,301,10,0,21153
MELVIN RETENTION,  MELVIN - NO,Lower Paxton Twp--12th Precinct,171,3,1,0,175,20842,301,10,0,21153
MELVIN RETENTION,  MELVIN - NO,Lower Paxton Twp--13th Precinct,188,3,0,0,191,20842,301,10,0,21153
MELVIN RETENTION,  MELVIN - NO,Lower Paxton Twp--14th Precinct,101,1,0,0,102,20842,301,10,0,21153
MELVIN RETENTION,  MELVIN - NO,Lower Paxton Twp--15th Precinct,158,3,0,0,161,20842,301,10,0,21153
MELVIN RETENTION,  MELVIN - NO,Lower Paxton Twp--16th Precinct,277,3,0,0,280,20842,301,10,0,21153
MELVIN RETENTION,  MELVIN - NO,Lower Paxton Twp--17th Precinct,120,0,0,0,120,20842,301,10,0,21153
MELVIN RETENTION,  MELVIN - NO,Lower Paxton Twp--18th Precinct,113,1,0,0,114,20842,301,10,0,21153
MELVIN RETENTION,  MELVIN - NO,Lower Paxton Twp--19th Precinct,203,12,0,0,215,20842,301,10,0,21153
MELVIN RETENTION,  MELVIN - NO,Lower Paxton Twp--20th Precinct,148,4,0,0,152,20842,301,10,0,21153
MELVIN RETENTION,  MELVIN - NO,Lower Paxton Twp--21st Precinct,206,4,0,0,210,20842,301,10,0,21153
MELVIN RETENTION,  MELVIN - NO,Lower Paxton Twp--22nd Precinct,168,3,0,0,171,20842,301,10,0,21153
MELVIN RETENTION,  MELVIN - NO,Lower Paxton Twp--23rd Precinct,142,2,0,0,144,20842,301,10,0,21153
MELVIN RETENTION,  MELVIN - NO,Lower Paxton Twp--24th Precinct,168,5,0,0,173,20842,301,10,0,21153
MELVIN RETENTION,  MELVIN - NO,Lower Paxton Twp--25th Precinct,121,1,0,0,122,20842,301,10,0,21153
MELVIN RETENTION,  MELVIN - NO,Lower Paxton Twp--26th Precinct,168,5,0,0,173,20842,301,10,0,21153
MELVIN RETENTION,  MELVIN - NO,Lower Paxton Twp--27th Precinct,132,0,0,0,132,20842,301,10,0,21153
MELVIN RETENTION,  MELVIN - NO,Lower Swatara Twp--1st Precinct,231,0,0,0,231,20842,301,10,0,21153
MELVIN RETENTION,  MELVIN - NO,Lower Swatara Twp--2nd Precinct,172,5,0,0,177,20842,301,10,0,21153
MELVIN RETENTION,  MELVIN - NO,Lower Swatara Twp--3rd Precinct,153,4,0,0,157,20842,301,10,0,21153
MELVIN RETENTION,  MELVIN - NO,Lower Swatara Twp--4th Precinct,163,0,0,0,163,20842,301,10,0,21153
MELVIN RETENTION,  MELVIN - NO,Lykens Township,59,0,0,0,59,20842,301,10,0,21153
MELVIN RETENTION,  MELVIN - NO,Middle Paxton Twp--1st Precinct,285,2,0,0,287,20842,301,10,0,21153
MELVIN RETENTION,  MELVIN - NO,Middle Paxton Twp--2nd Precinct,187,0,0,0,187,20842,301,10,0,21153
MELVIN RETENTION,  MELVIN - NO,Middle Paxton Twp--3rd Precinct,280,0,0,0,280,20842,301,10,0,21153
MELVIN RETENTION,  MELVIN - NO,Mifflin Township,48,0,0,0,48,20842,301,10,0,21153
MELVIN RETENTION,  MELVIN - NO,Reed Township,31,0,0,0,31,20842,301,10,0,21153
MELVIN RETENTION,  MELVIN - NO,Rush Township,21,0,0,0,21,20842,301,10,0,21153
MELVIN RETENTION,  MELVIN - NO,South Hanover Twp--1st Precinct,191,3,0,0,194,20842,301,10,0,21153
MELVIN RETENTION,  MELVIN - NO,South Hanover Twp--2nd Precinct,222,5,0,0,227,20842,301,10,0,21153
MELVIN RETENTION,  MELVIN - NO,South Hanover Twp--3rd Precinct,162,0,0,0,162,20842,301,10,0,21153
MELVIN RETENTION,  MELVIN - NO,Susquehanna Twp--1st Ward,264,6,0,0,270,20842,301,10,0,21153
MELVIN RETENTION,  MELVIN - NO,Susquehanna Twp--2nd Ward,402,13,0,0,415,20842,301,10,0,21153
MELVIN RETENTION,  MELVIN - NO,Susquehanna Twp--3rd Ward,183,0,0,0,183,20842,301,10,0,21153
MELVIN RETENTION,  MELVIN - NO,Susquehanna Twp--4th Ward,209,2,0,0,211,20842,301,10,0,21153
MELVIN RETENTION,  MELVIN - NO,Susquehanna Twp--5th Ward,210,3,0,0,213,20842,301,10,0,21153
MELVIN RETENTION,  MELVIN - NO,Susquehanna Twp--6th Ward,241,5,0,0,246,20842,301,10,0,21153
MELVIN RETENTION,  MELVIN - NO,Susquehanna Twp--7th Ward,139,0,0,0,139,20842,301,10,0,21153
MELVIN RETENTION,  MELVIN - NO,Susquehanna Twp--8th Ward,312,9,0,0,321,20842,301,10,0,21153
MELVIN RETENTION,  MELVIN - NO,Susquehanna Twp--9th Ward,241,2,0,0,243,20842,301,10,0,21153
MELVIN RETENTION,  MELVIN - NO,Swatara Township--1st Ward,195,0,0,0,195,20842,301,10,0,21153
MELVIN RETENTION,  MELVIN - NO,Swatara Township--2nd Ward,116,4,0,0,120,20842,301,10,0,21153
MELVIN RETENTION,  MELVIN - NO,Swatara Township--3rd Ward,128,3,0,0,131,20842,301,10,0,21153
MELVIN RETENTION,  MELVIN - NO,Swatara Township--4th Ward,170,6,0,0,176,20842,301,10,0,21153
MELVIN RETENTION,  MELVIN - NO,Swatara Township--5th Ward,260,2,0,0,262,20842,301,10,0,21153
MELVIN RETENTION,  MELVIN - NO,Swatara Township--6th Ward,271,0,0,0,271,20842,301,10,0,21153
MELVIN RETENTION,  MELVIN - NO,Swatara Township--7th Ward,252,2,0,0,254,20842,301,10,0,21153
MELVIN RETENTION,  MELVIN - NO,Swatara Township--8th Ward,317,3,1,0,321,20842,301,10,0,21153
MELVIN RETENTION,  MELVIN - NO,Swatara Township--9th Ward,109,1,0,0,110,20842,301,10,0,21153
MELVIN RETENTION,  MELVIN - NO,Upper Paxton Twp--1st Precinct,171,2,0,0,173,20842,301,10,0,21153
MELVIN RETENTION,  MELVIN - NO,Upper Paxton Twp--2nd Precinct,125,1,0,0,126,20842,301,10,0,21153
MELVIN RETENTION,  MELVIN - NO,Washington Township,168,4,0,0,172,20842,301,10,0,21153
MELVIN RETENTION,  MELVIN - NO,Wayne Township,183,1,0,0,184,20842,301,10,0,21153
MELVIN RETENTION,  MELVIN - NO,West Hanover Twp--1st Precinct,222,3,0,0,225,20842,301,10,0,21153
MELVIN RETENTION,  MELVIN - NO,West Hanover Twp--2nd Precinct,185,2,0,0,187,20842,301,10,0,21153
MELVIN RETENTION,  MELVIN - NO,West Hanover Twp--3rd Precinct,445,8,2,0,455,20842,301,10,0,21153
MELVIN RETENTION,  MELVIN - NO,West Hanover Twp--4th Precinct,263,2,0,0,265,20842,301,10,0,21153
MELVIN RETENTION,  MELVIN - NO,Wiconisco Twp--1st Precinct,52,0,0,0,52,20842,301,10,0,21153
MELVIN RETENTION,  MELVIN - NO,Wiconisco Twp--2nd Precinct,31,1,0,0,32,20842,301,10,0,21153
MELVIN RETENTION,  MELVIN - NO,Williams Twp,72,1,0,0,73,20842,301,10,0,21153
MELVIN RETENTION,  MELVIN - YES,"City--1st Ward, 1st Precinct",43,1,0,0,44,15861,430,10,0,16301
MELVIN RETENTION,  MELVIN - YES,"City--1st Ward, 2nd Precinct",90,2,1,0,93,15861,430,10,0,16301
MELVIN RETENTION,  MELVIN - YES,"City--1st Ward, 3rd Precinct",31,0,0,0,31,15861,430,10,0,16301
MELVIN RETENTION,  MELVIN - YES,"City--2nd Ward, 1st Precinct",15,0,0,0,15,15861,430,10,0,16301
MELVIN RETENTION,  MELVIN - YES,"City--2nd Ward, 2nd Precinct",30,1,0,0,31,15861,430,10,0,16301
MELVIN RETENTION,  MELVIN - YES,City--3rd Ward,50,1,0,0,51,15861,430,10,0,16301
MELVIN RETENTION,  MELVIN - YES,City--4th Ward,75,4,0,0,79,15861,430,10,0,16301
MELVIN RETENTION,  MELVIN - YES,City--5th Ward,140,9,0,0,149,15861,430,10,0,16301
MELVIN RETENTION,  MELVIN - YES,City--6th Ward,66,1,2,0,69,15861,430,10,0,16301
MELVIN RETENTION,  MELVIN - YES,"City--7th Ward, 1st Precinct",33,0,0,0,33,15861,430,10,0,16301
MELVIN RETENTION,  MELVIN - YES,"City--7th Ward, 2nd Precinct",67,0,0,0,67,15861,430,10,0,16301
MELVIN RETENTION,  MELVIN - YES,City--8th Ward,56,0,0,0,56,15861,430,10,0,16301
MELVIN RETENTION,  MELVIN - YES,"City--9th Ward, 1st Precinct",23,2,0,0,25,15861,430,10,0,16301
MELVIN RETENTION,  MELVIN - YES,"City--9th Ward, 2nd Precinct",33,1,0,0,34,15861,430,10,0,16301
MELVIN RETENTION,  MELVIN - YES,"City--9th Ward, 3rd Precinct",72,1,0,0,73,15861,430,10,0,16301
MELVIN RETENTION,  MELVIN - YES,"City--9th Ward, 4th Precinct",89,3,0,0,92,15861,430,10,0,16301
MELVIN RETENTION,  MELVIN - YES,"City--9th Ward, 5th Precinct",61,1,0,0,62,15861,430,10,0,16301
MELVIN RETENTION,  MELVIN - YES,"City--10th Ward, 1st Precinct",94,6,0,0,100,15861,430,10,0,16301
MELVIN RETENTION,  MELVIN - YES,"City--10th Ward, 2nd Precinct",35,0,0,0,35,15861,430,10,0,16301
MELVIN RETENTION,  MELVIN - YES,"City--10th Ward, 3rd Precinct",54,1,0,0,55,15861,430,10,0,16301
MELVIN RETENTION,  MELVIN - YES,"City--10th Ward, 4th Precinct",54,0,0,0,54,15861,430,10,0,16301
MELVIN RETENTION,  MELVIN - YES,City--11th Ward,34,31,0,0,65,15861,430,10,0,16301
MELVIN RETENTION,  MELVIN - YES,City--12th Ward,107,5,0,0,112,15861,430,10,0,16301
MELVIN RETENTION,  MELVIN - YES,"City--13th Ward, 1st Precinct",47,0,0,0,47,15861,430,10,0,16301
MELVIN RETENTION,  MELVIN - YES,"City--13th Ward, 2nd Precinct",83,1,0,0,84,15861,430,10,0,16301
MELVIN RETENTION,  MELVIN - YES,"City--13th Ward, 3rd Precinct",89,0,0,0,89,15861,430,10,0,16301
MELVIN RETENTION,  MELVIN - YES,City--14th Ward,137,5,0,0,142,15861,430,10,0,16301
MELVIN RETENTION,  MELVIN - YES,City--15th Ward,33,1,0,0,34,15861,430,10,0,16301
MELVIN RETENTION,  MELVIN - YES,Berrysburg Borough,22,0,0,0,22,15861,430,10,0,16301
MELVIN RETENTION,  MELVIN - YES,Dauphin Borough,57,2,0,0,59,15861,430,10,0,16301
MELVIN RETENTION,  MELVIN - YES,Elizabethville Borough,60,1,0,0,61,15861,430,10,0,16301
MELVIN RETENTION,  MELVIN - YES,Gratz Borough,37,1,0,0,38,15861,430,10,0,16301
MELVIN RETENTION,  MELVIN - YES,Halifax Borough,36,2,0,0,38,15861,430,10,0,16301
MELVIN RETENTION,  MELVIN - YES,Highspire--1st Precinct,58,0,0,0,58,15861,430,10,0,16301
MELVIN RETENTION,  MELVIN - YES,Highspire--2nd Precinct,72,1,0,0,73,15861,430,10,0,16301
MELVIN RETENTION,  MELVIN - YES,Hummelstown--1st Precinct,79,0,0,0,79,15861,430,10,0,16301
MELVIN RETENTION,  MELVIN - YES,Hummelstown--2nd Precinct,173,4,0,0,177,15861,430,10,0,16301
MELVIN RETENTION,  MELVIN - YES,Lykens Borough--1st Ward,44,1,0,0,45,15861,430,10,0,16301
MELVIN RETENTION,  MELVIN - YES,Lykens Borough--2nd Ward,51,2,0,0,53,15861,430,10,0,16301
MELVIN RETENTION,  MELVIN - YES,"Middletown--1st Ward, 1st Precinct",47,0,0,0,47,15861,430,10,0,16301
MELVIN RETENTION,  MELVIN - YES,"Middletown--1st Ward, 2nd Precinct",77,6,0,0,83,15861,430,10,0,16301
MELVIN RETENTION,  MELVIN - YES,"Middletown--2nd Ward, 1st Precinct",56,0,0,0,56,15861,430,10,0,16301
MELVIN RETENTION,  MELVIN - YES,"Middletown--2nd Ward, 2nd Precinct",68,1,0,0,69,15861,430,10,0,16301
MELVIN RETENTION,  MELVIN - YES,"Middletown--3rd Ward, 1st Precinct",58,0,0,0,58,15861,430,10,0,16301
MELVIN RETENTION,  MELVIN - YES,"Middletown--3rd Ward, 2nd Precinct",90,0,0,0,90,15861,430,10,0,16301
MELVIN RETENTION,  MELVIN - YES,Millersburg--1st Ward,63,2,0,0,65,15861,430,10,0,16301
MELVIN RETENTION,  MELVIN - YES,Millersburg--2nd Ward,61,3,0,0,64,15861,430,10,0,16301
MELVIN RETENTION,  MELVIN - YES,Paxtang Borough,116,2,0,0,118,15861,430,10,0,16301
MELVIN RETENTION,  MELVIN - YES,Penbrook Borough--1st Ward,30,1,0,0,31,15861,430,10,0,16301
MELVIN RETENTION,  MELVIN - YES,Penbrook Borough--2nd Ward,38,0,0,0,38,15861,430,10,0,16301
MELVIN RETENTION,  MELVIN - YES,Penbrook Borough--3rd Ward,38,0,0,0,38,15861,430,10,0,16301
MELVIN RETENTION,  MELVIN - YES,Penbrook Borough--4th Ward,29,0,0,0,29,15861,430,10,0,16301
MELVIN RETENTION,  MELVIN - YES,Royalton Borough--1st Ward,19,0,0,0,19,15861,430,10,0,16301
MELVIN RETENTION,  MELVIN - YES,Royalton Borough--2nd Ward,35,0,0,0,35,15861,430,10,0,16301
MELVIN RETENTION,  MELVIN - YES,Steelton--1st Ward,62,2,0,0,64,15861,430,10,0,16301
MELVIN RETENTION,  MELVIN - YES,"Steelton--2nd Ward, 1st Precinct",42,1,0,0,43,15861,430,10,0,16301
MELVIN RETENTION,  MELVIN - YES,"Steelton--2nd Ward, 2nd Precinct",37,0,0,0,37,15861,430,10,0,16301
MELVIN RETENTION,  MELVIN - YES,"Steelton--3rd Ward, 1st Precinct",28,0,0,0,28,15861,430,10,0,16301
MELVIN RETENTION,  MELVIN - YES,"Steelton--3rd Ward, 2nd Precinct",44,0,0,0,44,15861,430,10,0,16301
MELVIN RETENTION,  MELVIN - YES,Steelton--4th Ward,44,1,1,0,46,15861,430,10,0,16301
MELVIN RETENTION,  MELVIN - YES,Pillow Borough,24,0,0,0,24,15861,430,10,0,16301
MELVIN RETENTION,  MELVIN - YES,Williamstown--1st Ward,42,0,0,0,42,15861,430,10,0,16301
MELVIN RETENTION,  MELVIN - YES,Williamstown--2nd Ward,25,0,0,0,25,15861,430,10,0,16301
MELVIN RETENTION,  MELVIN - YES,Conewago Twp--1st Precinct,99,1,0,0,100,15861,430,10,0,16301
MELVIN RETENTION,  MELVIN - YES,Conewago Twp--2nd Precinct,92,0,0,0,92,15861,430,10,0,16301
MELVIN RETENTION,  MELVIN - YES,Derry Township--1st Precinct,175,4,0,0,179,15861,430,10,0,16301
MELVIN RETENTION,  MELVIN - YES,Derry Township--2nd Precinct,125,4,0,0,129,15861,430,10,0,16301
MELVIN RETENTION,  MELVIN - YES,Derry Township--3rd Precinct,96,6,0,0,102,15861,430,10,0,16301
MELVIN RETENTION,  MELVIN - YES,Derry Township--4th Precinct,93,2,0,0,95,15861,430,10,0,16301
MELVIN RETENTION,  MELVIN - YES,Derry Township--5th Precinct,74,0,0,0,74,15861,430,10,0,16301
MELVIN RETENTION,  MELVIN - YES,Derry Township--6th Precinct,99,2,0,0,101,15861,430,10,0,16301
MELVIN RETENTION,  MELVIN - YES,Derry Township--7th Precinct,184,9,0,0,193,15861,430,10,0,16301
MELVIN RETENTION,  MELVIN - YES,Derry Township--8th Precinct,90,0,0,0,90,15861,430,10,0,16301
MELVIN RETENTION,  MELVIN - YES,Derry Township--9th Precinct,56,4,0,0,60,15861,430,10,0,16301
MELVIN RETENTION,  MELVIN - YES,Derry Township--10th Precinct,115,4,0,0,119,15861,430,10,0,16301
MELVIN RETENTION,  MELVIN - YES,Derry Township--11th Precinct,149,4,0,0,153,15861,430,10,0,16301
MELVIN RETENTION,  MELVIN - YES,Derry Township--12th Precinct,105,2,0,0,107,15861,430,10,0,16301
MELVIN RETENTION,  MELVIN - YES,Derry Township--13th Precinct,143,4,0,0,147,15861,430,10,0,16301
MELVIN RETENTION,  MELVIN - YES,Derry Township--14th Precinct,80,5,0,0,85,15861,430,10,0,16301
MELVIN RETENTION,  MELVIN - YES,Derry Township--15th Precinct,154,3,1,0,158,15861,430,10,0,16301
MELVIN RETENTION,  MELVIN - YES,East Hanover Township--1st Precinct,131,6,0,0,137,15861,430,10,0,16301
MELVIN RETENTION,  MELVIN - YES,East Hanover Township--2nd Precinct,155,2,0,0,157,15861,430,10,0,16301
MELVIN RETENTION,  MELVIN - YES,Halifax Twp--1st Precinct,112,2,0,0,114,15861,430,10,0,16301
MELVIN RETENTION,  MELVIN - YES,Halifax Twp--2nd Precinct,150,1,0,0,151,15861,430,10,0,16301
MELVIN RETENTION,  MELVIN - YES,Jackson Township,89,0,0,0,89,15861,430,10,0,16301
MELVIN RETENTION,  MELVIN - YES,Jefferson Township,23,0,0,0,23,15861,430,10,0,16301
MELVIN RETENTION,  MELVIN - YES,Londonderry Twp--1st Precinct,126,0,0,0,126,15861,430,10,0,16301
MELVIN RETENTION,  MELVIN - YES,Londonderry Twp--2nd Precinct,101,1,0,0,102,15861,430,10,0,16301
MELVIN RETENTION,  MELVIN - YES,Londonderry Twp--3rd Precinct,74,0,0,0,74,15861,430,10,0,16301
MELVIN RETENTION,  MELVIN - YES,Lower Paxton Twp--1st Precinct,105,2,0,0,107,15861,430,10,0,16301
MELVIN RETENTION,  MELVIN - YES,Lower Paxton Twp--2nd Precinct,109,7,0,0,116,15861,430,10,0,16301
MELVIN RETENTION,  MELVIN - YES,Lower Paxton Twp--3rd precinct,204,5,0,0,209,15861,430,10,0,16301
MELVIN RETENTION,  MELVIN - YES,Lower Paxton Twp--4th Precinct,142,2,0,0,144,15861,430,10,0,16301
MELVIN RETENTION,  MELVIN - YES,Lower Paxton Twp--5th Precinct,125,0,0,0,125,15861,430,10,0,16301
MELVIN RETENTION,  MELVIN - YES,Lower Paxton Twp--6th Precinct,101,5,0,0,106,15861,430,10,0,16301
MELVIN RETENTION,  MELVIN - YES,Lower Paxton Twp--7th Precinct,171,7,0,0,178,15861,430,10,0,16301
MELVIN RETENTION,  MELVIN - YES,Lower Paxton Twp--8th Precinct,90,2,0,0,92,15861,430,10,0,16301
MELVIN RETENTION,  MELVIN - YES,Lower Paxton Twp--9th Precinct,89,3,0,0,92,15861,430,10,0,16301
MELVIN RETENTION,  MELVIN - YES,Lower Paxton Twp--10th Precinct,87,4,0,0,91,15861,430,10,0,16301
MELVIN RETENTION,  MELVIN - YES,Lower Paxton Twp--11th Precinct,100,0,0,0,100,15861,430,10,0,16301
MELVIN RETENTION,  MELVIN - YES,Lower Paxton Twp--12th Precinct,178,4,0,0,182,15861,430,10,0,16301
MELVIN RETENTION,  MELVIN - YES,Lower Paxton Twp--13th Precinct,133,3,0,0,136,15861,430,10,0,16301
MELVIN RETENTION,  MELVIN - YES,Lower Paxton Twp--14th Precinct,92,1,3,0,96,15861,430,10,0,16301
MELVIN RETENTION,  MELVIN - YES,Lower Paxton Twp--15th Precinct,137,2,0,0,139,15861,430,10,0,16301
MELVIN RETENTION,  MELVIN - YES,Lower Paxton Twp--16th Precinct,200,7,0,0,207,15861,430,10,0,16301
MELVIN RETENTION,  MELVIN - YES,Lower Paxton Twp--17th Precinct,112,5,0,0,117,15861,430,10,0,16301
MELVIN RETENTION,  MELVIN - YES,Lower Paxton Twp--18th Precinct,111,2,0,0,113,15861,430,10,0,16301
MELVIN RETENTION,  MELVIN - YES,Lower Paxton Twp--19th Precinct,203,6,0,0,209,15861,430,10,0,16301
MELVIN RETENTION,  MELVIN - YES,Lower Paxton Twp--20th Precinct,141,2,0,0,143,15861,430,10,0,16301
MELVIN RETENTION,  MELVIN - YES,Lower Paxton Twp--21st Precinct,180,9,0,0,189,15861,430,10,0,16301
MELVIN RETENTION,  MELVIN - YES,Lower Paxton Twp--22nd Precinct,153,3,0,0,156,15861,430,10,0,16301
MELVIN RETENTION,  MELVIN - YES,Lower Paxton Twp--23rd Precinct,147,3,0,0,150,15861,430,10,0,16301
MELVIN RETENTION,  MELVIN - YES,Lower Paxton Twp--24th Precinct,140,2,0,0,142,15861,430,10,0,16301
MELVIN RETENTION,  MELVIN - YES,Lower Paxton Twp--25th Precinct,92,3,0,0,95,15861,430,10,0,16301
MELVIN RETENTION,  MELVIN - YES,Lower Paxton Twp--26th Precinct,136,3,0,0,139,15861,430,10,0,16301
MELVIN RETENTION,  MELVIN - YES,Lower Paxton Twp--27th Precinct,132,1,0,0,133,15861,430,10,0,16301
MELVIN RETENTION,  MELVIN - YES,Lower Swatara Twp--1st Precinct,160,5,0,0,165,15861,430,10,0,16301
MELVIN RETENTION,  MELVIN - YES,Lower Swatara Twp--2nd Precinct,158,3,0,0,161,15861,430,10,0,16301
MELVIN RETENTION,  MELVIN - YES,Lower Swatara Twp--3rd Precinct,132,16,0,0,148,15861,430,10,0,16301
MELVIN RETENTION,  MELVIN - YES,Lower Swatara Twp--4th Precinct,107,1,0,0,108,15861,430,10,0,16301
MELVIN RETENTION,  MELVIN - YES,Lykens Township,33,0,0,0,33,15861,430,10,0,16301
MELVIN RETENTION,  MELVIN - YES,Middle Paxton Twp--1st Precinct,96,0,0,0,96,15861,430,10,0,16301
MELVIN RETENTION,  MELVIN - YES,Middle Paxton Twp--2nd Precinct,122,2,0,0,124,15861,430,10,0,16301
MELVIN RETENTION,  MELVIN - YES,Middle Paxton Twp--3rd Precinct,113,2,0,0,115,15861,430,10,0,16301
MELVIN RETENTION,  MELVIN - YES,Mifflin Township,41,0,0,0,41,15861,430,10,0,16301
MELVIN RETENTION,  MELVIN - YES,Reed Township,16,0,0,0,16,15861,430,10,0,16301
MELVIN RETENTION,  MELVIN - YES,Rush Township,17,0,0,0,17,15861,430,10,0,16301
MELVIN RETENTION,  MELVIN - YES,South Hanover Twp--1st Precinct,109,2,0,0,111,15861,430,10,0,16301
MELVIN RETENTION,  MELVIN - YES,South Hanover Twp--2nd Precinct,187,5,0,0,192,15861,430,10,0,16301
MELVIN RETENTION,  MELVIN - YES,South Hanover Twp--3rd Precinct,92,0,0,0,92,15861,430,10,0,16301
MELVIN RETENTION,  MELVIN - YES,Susquehanna Twp--1st Ward,226,10,0,0,236,15861,430,10,0,16301
MELVIN RETENTION,  MELVIN - YES,Susquehanna Twp--2nd Ward,320,15,0,0,335,15861,430,10,0,16301
MELVIN RETENTION,  MELVIN - YES,Susquehanna Twp--3rd Ward,135,2,0,0,137,15861,430,10,0,16301
MELVIN RETENTION,  MELVIN - YES,Susquehanna Twp--4th Ward,141,1,0,0,142,15861,430,10,0,16301
MELVIN RETENTION,  MELVIN - YES,Susquehanna Twp--5th Ward,152,3,0,0,155,15861,430,10,0,16301
MELVIN RETENTION,  MELVIN - YES,Susquehanna Twp--6th Ward,179,4,0,0,183,15861,430,10,0,16301
MELVIN RETENTION,  MELVIN - YES,Susquehanna Twp--7th Ward,100,0,0,0,100,15861,430,10,0,16301
MELVIN RETENTION,  MELVIN - YES,Susquehanna Twp--8th Ward,266,12,0,0,278,15861,430,10,0,16301
MELVIN RETENTION,  MELVIN - YES,Susquehanna Twp--9th Ward,184,3,0,0,187,15861,430,10,0,16301
MELVIN RETENTION,  MELVIN - YES,Swatara Township--1st Ward,149,1,0,0,150,15861,430,10,0,16301
MELVIN RETENTION,  MELVIN - YES,Swatara Township--2nd Ward,93,16,0,0,109,15861,430,10,0,16301
MELVIN RETENTION,  MELVIN - YES,Swatara Township--3rd Ward,111,5,0,0,116,15861,430,10,0,16301
MELVIN RETENTION,  MELVIN - YES,Swatara Township--4th Ward,193,2,0,0,195,15861,430,10,0,16301
MELVIN RETENTION,  MELVIN - YES,Swatara Township--5th Ward,209,3,0,0,212,15861,430,10,0,16301
MELVIN RETENTION,  MELVIN - YES,Swatara Township--6th Ward,169,3,1,0,173,15861,430,10,0,16301
MELVIN RETENTION,  MELVIN - YES,Swatara Township--7th Ward,224,7,0,0,231,15861,430,10,0,16301
MELVIN RETENTION,  MELVIN - YES,Swatara Township--8th Ward,204,4,0,0,208,15861,430,10,0,16301
MELVIN RETENTION,  MELVIN - YES,Swatara Township--9th Ward,106,7,0,0,113,15861,430,10,0,16301
MELVIN RETENTION,  MELVIN - YES,Upper Paxton Twp--1st Precinct,131,1,0,0,132,15861,430,10,0,16301
MELVIN RETENTION,  MELVIN - YES,Upper Paxton Twp--2nd Precinct,71,2,0,0,73,15861,430,10,0,16301
MELVIN RETENTION,  MELVIN - YES,Washington Township,117,3,0,0,120,15861,430,10,0,16301
MELVIN RETENTION,  MELVIN - YES,Wayne Township,88,0,1,0,89,15861,430,10,0,16301
MELVIN RETENTION,  MELVIN - YES,West Hanover Twp--1st Precinct,105,3,0,0,108,15861,430,10,0,16301
MELVIN RETENTION,  MELVIN - YES,West Hanover Twp--2nd Precinct,125,5,0,0,130,15861,430,10,0,16301
MELVIN RETENTION,  MELVIN - YES,West Hanover Twp--3rd Precinct,287,11,0,0,298,15861,430,10,0,16301
MELVIN RETENTION,  MELVIN - YES,West Hanover Twp--4th Precinct,151,1,0,0,152,15861,430,10,0,16301
MELVIN RETENTION,  MELVIN - YES,Wiconisco Twp--1st Precinct,32,1,0,0,33,15861,430,10,0,16301
MELVIN RETENTION,  MELVIN - YES,Wiconisco Twp--2nd Precinct,36,0,0,0,36,15861,430,10,0,16301
MELVIN RETENTION,  MELVIN - YES,Williams Twp,71,0,0,0,71,15861,430,10,0,16301
MUSMANNO RETENTION,  MUSMANNO - NO,"City--1st Ward, 1st Precinct",51,2,0,0,53,22976,337,9,0,23322
MUSMANNO RETENTION,  MUSMANNO - NO,"City--1st Ward, 2nd Precinct",80,0,0,0,80,22976,337,9,0,23322
MUSMANNO RETENTION,  MUSMANNO - NO,"City--1st Ward, 3rd Precinct",32,0,0,0,32,22976,337,9,0,23322
MUSMANNO RETENTION,  MUSMANNO - NO,"City--2nd Ward, 1st Precinct",25,0,0,0,25,22976,337,9,0,23322
MUSMANNO RETENTION,  MUSMANNO - NO,"City--2nd Ward, 2nd Precinct",32,0,0,0,32,22976,337,9,0,23322
MUSMANNO RETENTION,  MUSMANNO - NO,City--3rd Ward,36,0,0,0,36,22976,337,9,0,23322
MUSMANNO RETENTION,  MUSMANNO - NO,City--4th Ward,83,1,0,0,84,22976,337,9,0,23322
MUSMANNO RETENTION,  MUSMANNO - NO,City--5th Ward,165,4,0,0,169,22976,337,9,0,23322
MUSMANNO RETENTION,  MUSMANNO - NO,City--6th Ward,96,1,1,0,98,22976,337,9,0,23322
MUSMANNO RETENTION,  MUSMANNO - NO,"City--7th Ward, 1st Precinct",30,1,0,0,31,22976,337,9,0,23322
MUSMANNO RETENTION,  MUSMANNO - NO,"City--7th Ward, 2nd Precinct",65,2,0,0,67,22976,337,9,0,23322
MUSMANNO RETENTION,  MUSMANNO - NO,City--8th Ward,60,1,0,0,61,22976,337,9,0,23322
MUSMANNO RETENTION,  MUSMANNO - NO,"City--9th Ward, 1st Precinct",31,1,0,0,32,22976,337,9,0,23322
MUSMANNO RETENTION,  MUSMANNO - NO,"City--9th Ward, 2nd Precinct",34,0,0,0,34,22976,337,9,0,23322
MUSMANNO RETENTION,  MUSMANNO - NO,"City--9th Ward, 3rd Precinct",100,0,0,0,100,22976,337,9,0,23322
MUSMANNO RETENTION,  MUSMANNO - NO,"City--9th Ward, 4th Precinct",110,3,0,0,113,22976,337,9,0,23322
MUSMANNO RETENTION,  MUSMANNO - NO,"City--9th Ward, 5th Precinct",59,3,0,0,62,22976,337,9,0,23322
MUSMANNO RETENTION,  MUSMANNO - NO,"City--10th Ward, 1st Precinct",133,2,0,0,135,22976,337,9,0,23322
MUSMANNO RETENTION,  MUSMANNO - NO,"City--10th Ward, 2nd Precinct",38,0,0,0,38,22976,337,9,0,23322
MUSMANNO RETENTION,  MUSMANNO - NO,"City--10th Ward, 3rd Precinct",57,0,0,0,57,22976,337,9,0,23322
MUSMANNO RETENTION,  MUSMANNO - NO,"City--10th Ward, 4th Precinct",55,0,0,0,55,22976,337,9,0,23322
MUSMANNO RETENTION,  MUSMANNO - NO,City--11th Ward,55,1,0,0,56,22976,337,9,0,23322
MUSMANNO RETENTION,  MUSMANNO - NO,City--12th Ward,139,3,0,0,142,22976,337,9,0,23322
MUSMANNO RETENTION,  MUSMANNO - NO,"City--13th Ward, 1st Precinct",74,0,0,0,74,22976,337,9,0,23322
MUSMANNO RETENTION,  MUSMANNO - NO,"City--13th Ward, 2nd Precinct",96,4,0,0,100,22976,337,9,0,23322
MUSMANNO RETENTION,  MUSMANNO - NO,"City--13th Ward, 3rd Precinct",105,2,0,0,107,22976,337,9,0,23322
MUSMANNO RETENTION,  MUSMANNO - NO,City--14th Ward,195,2,0,0,197,22976,337,9,0,23322
MUSMANNO RETENTION,  MUSMANNO - NO,City--15th Ward,41,1,0,0,42,22976,337,9,0,23322
MUSMANNO RETENTION,  MUSMANNO - NO,Berrysburg Borough,43,0,0,0,43,22976,337,9,0,23322
MUSMANNO RETENTION,  MUSMANNO - NO,Dauphin Borough,140,0,0,0,140,22976,337,9,0,23322
MUSMANNO RETENTION,  MUSMANNO - NO,Elizabethville Borough,117,2,0,0,119,22976,337,9,0,23322
MUSMANNO RETENTION,  MUSMANNO - NO,Gratz Borough,40,0,0,0,40,22976,337,9,0,23322
MUSMANNO RETENTION,  MUSMANNO - NO,Halifax Borough,69,0,0,0,69,22976,337,9,0,23322
MUSMANNO RETENTION,  MUSMANNO - NO,Highspire--1st Precinct,95,2,0,0,97,22976,337,9,0,23322
MUSMANNO RETENTION,  MUSMANNO - NO,Highspire--2nd Precinct,116,0,0,0,116,22976,337,9,0,23322
MUSMANNO RETENTION,  MUSMANNO - NO,Hummelstown--1st Precinct,126,5,0,0,131,22976,337,9,0,23322
MUSMANNO RETENTION,  MUSMANNO - NO,Hummelstown--2nd Precinct,263,3,0,0,266,22976,337,9,0,23322
MUSMANNO RETENTION,  MUSMANNO - NO,Lykens Borough--1st Ward,49,0,0,0,49,22976,337,9,0,23322
MUSMANNO RETENTION,  MUSMANNO - NO,Lykens Borough--2nd Ward,79,2,0,0,81,22976,337,9,0,23322
MUSMANNO RETENTION,  MUSMANNO - NO,"Middletown--1st Ward, 1st Precinct",55,0,0,0,55,22976,337,9,0,23322
MUSMANNO RETENTION,  MUSMANNO - NO,"Middletown--1st Ward, 2nd Precinct",96,1,0,0,97,22976,337,9,0,23322
MUSMANNO RETENTION,  MUSMANNO - NO,"Middletown--2nd Ward, 1st Precinct",118,2,0,0,120,22976,337,9,0,23322
MUSMANNO RETENTION,  MUSMANNO - NO,"Middletown--2nd Ward, 2nd Precinct",102,4,0,0,106,22976,337,9,0,23322
MUSMANNO RETENTION,  MUSMANNO - NO,"Middletown--3rd Ward, 1st Precinct",85,1,0,0,86,22976,337,9,0,23322
MUSMANNO RETENTION,  MUSMANNO - NO,"Middletown--3rd Ward, 2nd Precinct",140,0,0,0,140,22976,337,9,0,23322
MUSMANNO RETENTION,  MUSMANNO - NO,Millersburg--1st Ward,84,1,0,0,85,22976,337,9,0,23322
MUSMANNO RETENTION,  MUSMANNO - NO,Millersburg--2nd Ward,118,1,0,0,119,22976,337,9,0,23322
MUSMANNO RETENTION,  MUSMANNO - NO,Paxtang Borough,164,1,0,0,165,22976,337,9,0,23322
MUSMANNO RETENTION,  MUSMANNO - NO,Penbrook Borough--1st Ward,42,0,0,0,42,22976,337,9,0,23322
MUSMANNO RETENTION,  MUSMANNO - NO,Penbrook Borough--2nd Ward,45,1,0,0,46,22976,337,9,0,23322
MUSMANNO RETENTION,  MUSMANNO - NO,Penbrook Borough--3rd Ward,56,0,0,0,56,22976,337,9,0,23322
MUSMANNO RETENTION,  MUSMANNO - NO,Penbrook Borough--4th Ward,80,2,0,0,82,22976,337,9,0,23322
MUSMANNO RETENTION,  MUSMANNO - NO,Royalton Borough--1st Ward,27,0,0,0,27,22976,337,9,0,23322
MUSMANNO RETENTION,  MUSMANNO - NO,Royalton Borough--2nd Ward,48,0,0,0,48,22976,337,9,0,23322
MUSMANNO RETENTION,  MUSMANNO - NO,Steelton--1st Ward,88,3,0,0,91,22976,337,9,0,23322
MUSMANNO RETENTION,  MUSMANNO - NO,"Steelton--2nd Ward, 1st Precinct",53,0,0,0,53,22976,337,9,0,23322
MUSMANNO RETENTION,  MUSMANNO - NO,"Steelton--2nd Ward, 2nd Precinct",51,1,0,0,52,22976,337,9,0,23322
MUSMANNO RETENTION,  MUSMANNO - NO,"Steelton--3rd Ward, 1st Precinct",26,0,0,0,26,22976,337,9,0,23322
MUSMANNO RETENTION,  MUSMANNO - NO,"Steelton--3rd Ward, 2nd Precinct",55,0,0,0,55,22976,337,9,0,23322
MUSMANNO RETENTION,  MUSMANNO - NO,Steelton--4th Ward,50,1,0,0,51,22976,337,9,0,23322
MUSMANNO RETENTION,  MUSMANNO - NO,Pillow Borough,34,0,0,0,34,22976,337,9,0,23322
MUSMANNO RETENTION,  MUSMANNO - NO,Williamstown--1st Ward,55,1,0,0,56,22976,337,9,0,23322
MUSMANNO RETENTION,  MUSMANNO - NO,Williamstown--2nd Ward,45,0,0,0,45,22976,337,9,0,23322
MUSMANNO RETENTION,  MUSMANNO - NO,Conewago Twp--1st Precinct,169,0,0,0,169,22976,337,9,0,23322
MUSMANNO RETENTION,  MUSMANNO - NO,Conewago Twp--2nd Precinct,145,5,0,0,150,22976,337,9,0,23322
MUSMANNO RETENTION,  MUSMANNO - NO,Derry Township--1st Precinct,230,2,0,0,232,22976,337,9,0,23322
MUSMANNO RETENTION,  MUSMANNO - NO,Derry Township--2nd Precinct,162,2,0,0,164,22976,337,9,0,23322
MUSMANNO RETENTION,  MUSMANNO - NO,Derry Township--3rd Precinct,137,4,1,0,142,22976,337,9,0,23322
MUSMANNO RETENTION,  MUSMANNO - NO,Derry Township--4th Precinct,115,3,1,0,119,22976,337,9,0,23322
MUSMANNO RETENTION,  MUSMANNO - NO,Derry Township--5th Precinct,97,3,0,0,100,22976,337,9,0,23322
MUSMANNO RETENTION,  MUSMANNO - NO,Derry Township--6th Precinct,119,0,1,0,120,22976,337,9,0,23322
MUSMANNO RETENTION,  MUSMANNO - NO,Derry Township--7th Precinct,233,8,0,0,241,22976,337,9,0,23322
MUSMANNO RETENTION,  MUSMANNO - NO,Derry Township--8th Precinct,126,0,0,0,126,22976,337,9,0,23322
MUSMANNO RETENTION,  MUSMANNO - NO,Derry Township--9th Precinct,72,3,0,0,75,22976,337,9,0,23322
MUSMANNO RETENTION,  MUSMANNO - NO,Derry Township--10th Precinct,178,2,0,0,180,22976,337,9,0,23322
MUSMANNO RETENTION,  MUSMANNO - NO,Derry Township--11th Precinct,213,7,0,0,220,22976,337,9,0,23322
MUSMANNO RETENTION,  MUSMANNO - NO,Derry Township--12th Precinct,130,1,0,0,131,22976,337,9,0,23322
MUSMANNO RETENTION,  MUSMANNO - NO,Derry Township--13th Precinct,152,1,0,0,153,22976,337,9,0,23322
MUSMANNO RETENTION,  MUSMANNO - NO,Derry Township--14th Precinct,114,3,0,0,117,22976,337,9,0,23322
MUSMANNO RETENTION,  MUSMANNO - NO,Derry Township--15th Precinct,243,4,0,0,247,22976,337,9,0,23322
MUSMANNO RETENTION,  MUSMANNO - NO,East Hanover Township--1st Precinct,251,4,0,0,255,22976,337,9,0,23322
MUSMANNO RETENTION,  MUSMANNO - NO,East Hanover Township--2nd Precinct,274,3,0,0,277,22976,337,9,0,23322
MUSMANNO RETENTION,  MUSMANNO - NO,Halifax Twp--1st Precinct,222,2,0,0,224,22976,337,9,0,23322
MUSMANNO RETENTION,  MUSMANNO - NO,Halifax Twp--2nd Precinct,219,10,0,0,229,22976,337,9,0,23322
MUSMANNO RETENTION,  MUSMANNO - NO,Jackson Township,178,0,0,0,178,22976,337,9,0,23322
MUSMANNO RETENTION,  MUSMANNO - NO,Jefferson Township,53,0,0,0,53,22976,337,9,0,23322
MUSMANNO RETENTION,  MUSMANNO - NO,Londonderry Twp--1st Precinct,199,0,0,0,199,22976,337,9,0,23322
MUSMANNO RETENTION,  MUSMANNO - NO,Londonderry Twp--2nd Precinct,219,1,0,0,220,22976,337,9,0,23322
MUSMANNO RETENTION,  MUSMANNO - NO,Londonderry Twp--3rd Precinct,86,1,0,0,87,22976,337,9,0,23322
MUSMANNO RETENTION,  MUSMANNO - NO,Lower Paxton Twp--1st Precinct,129,1,0,0,130,22976,337,9,0,23322
MUSMANNO RETENTION,  MUSMANNO - NO,Lower Paxton Twp--2nd Precinct,155,5,0,0,160,22976,337,9,0,23322
MUSMANNO RETENTION,  MUSMANNO - NO,Lower Paxton Twp--3rd precinct,288,7,0,0,295,22976,337,9,0,23322
MUSMANNO RETENTION,  MUSMANNO - NO,Lower Paxton Twp--4th Precinct,209,3,0,0,212,22976,337,9,0,23322
MUSMANNO RETENTION,  MUSMANNO - NO,Lower Paxton Twp--5th Precinct,182,4,1,0,187,22976,337,9,0,23322
MUSMANNO RETENTION,  MUSMANNO - NO,Lower Paxton Twp--6th Precinct,131,0,0,0,131,22976,337,9,0,23322
MUSMANNO RETENTION,  MUSMANNO - NO,Lower Paxton Twp--7th Precinct,224,0,0,0,224,22976,337,9,0,23322
MUSMANNO RETENTION,  MUSMANNO - NO,Lower Paxton Twp--8th Precinct,118,1,0,0,119,22976,337,9,0,23322
MUSMANNO RETENTION,  MUSMANNO - NO,Lower Paxton Twp--9th Precinct,160,3,0,0,163,22976,337,9,0,23322
MUSMANNO RETENTION,  MUSMANNO - NO,Lower Paxton Twp--10th Precinct,87,1,0,0,88,22976,337,9,0,23322
MUSMANNO RETENTION,  MUSMANNO - NO,Lower Paxton Twp--11th Precinct,149,2,0,0,151,22976,337,9,0,23322
MUSMANNO RETENTION,  MUSMANNO - NO,Lower Paxton Twp--12th Precinct,200,4,1,0,205,22976,337,9,0,23322
MUSMANNO RETENTION,  MUSMANNO - NO,Lower Paxton Twp--13th Precinct,212,2,0,0,214,22976,337,9,0,23322
MUSMANNO RETENTION,  MUSMANNO - NO,Lower Paxton Twp--14th Precinct,108,1,0,0,109,22976,337,9,0,23322
MUSMANNO RETENTION,  MUSMANNO - NO,Lower Paxton Twp--15th Precinct,184,4,0,0,188,22976,337,9,0,23322
MUSMANNO RETENTION,  MUSMANNO - NO,Lower Paxton Twp--16th Precinct,283,3,0,0,286,22976,337,9,0,23322
MUSMANNO RETENTION,  MUSMANNO - NO,Lower Paxton Twp--17th Precinct,137,0,0,0,137,22976,337,9,0,23322
MUSMANNO RETENTION,  MUSMANNO - NO,Lower Paxton Twp--18th Precinct,133,2,0,0,135,22976,337,9,0,23322
MUSMANNO RETENTION,  MUSMANNO - NO,Lower Paxton Twp--19th Precinct,229,8,0,0,237,22976,337,9,0,23322
MUSMANNO RETENTION,  MUSMANNO - NO,Lower Paxton Twp--20th Precinct,173,4,0,0,177,22976,337,9,0,23322
MUSMANNO RETENTION,  MUSMANNO - NO,Lower Paxton Twp--21st Precinct,231,6,0,0,237,22976,337,9,0,23322
MUSMANNO RETENTION,  MUSMANNO - NO,Lower Paxton Twp--22nd Precinct,196,4,0,0,200,22976,337,9,0,23322
MUSMANNO RETENTION,  MUSMANNO - NO,Lower Paxton Twp--23rd Precinct,163,3,0,0,166,22976,337,9,0,23322
MUSMANNO RETENTION,  MUSMANNO - NO,Lower Paxton Twp--24th Precinct,189,5,0,0,194,22976,337,9,0,23322
MUSMANNO RETENTION,  MUSMANNO - NO,Lower Paxton Twp--25th Precinct,126,1,0,0,127,22976,337,9,0,23322
MUSMANNO RETENTION,  MUSMANNO - NO,Lower Paxton Twp--26th Precinct,181,6,0,0,187,22976,337,9,0,23322
MUSMANNO RETENTION,  MUSMANNO - NO,Lower Paxton Twp--27th Precinct,154,0,0,0,154,22976,337,9,0,23322
MUSMANNO RETENTION,  MUSMANNO - NO,Lower Swatara Twp--1st Precinct,254,2,0,0,256,22976,337,9,0,23322
MUSMANNO RETENTION,  MUSMANNO - NO,Lower Swatara Twp--2nd Precinct,199,5,0,0,204,22976,337,9,0,23322
MUSMANNO RETENTION,  MUSMANNO - NO,Lower Swatara Twp--3rd Precinct,169,4,0,0,173,22976,337,9,0,23322
MUSMANNO RETENTION,  MUSMANNO - NO,Lower Swatara Twp--4th Precinct,194,0,0,0,194,22976,337,9,0,23322
MUSMANNO RETENTION,  MUSMANNO - NO,Lykens Township,63,0,0,0,63,22976,337,9,0,23322
MUSMANNO RETENTION,  MUSMANNO - NO,Middle Paxton Twp--1st Precinct,305,2,0,0,307,22976,337,9,0,23322
MUSMANNO RETENTION,  MUSMANNO - NO,Middle Paxton Twp--2nd Precinct,212,2,0,0,214,22976,337,9,0,23322
MUSMANNO RETENTION,  MUSMANNO - NO,Middle Paxton Twp--3rd Precinct,312,0,0,0,312,22976,337,9,0,23322
MUSMANNO RETENTION,  MUSMANNO - NO,Mifflin Township,59,0,0,0,59,22976,337,9,0,23322
MUSMANNO RETENTION,  MUSMANNO - NO,Reed Township,32,0,0,0,32,22976,337,9,0,23322
MUSMANNO RETENTION,  MUSMANNO - NO,Rush Township,19,0,0,0,19,22976,337,9,0,23322
MUSMANNO RETENTION,  MUSMANNO - NO,South Hanover Twp--1st Precinct,205,3,0,0,208,22976,337,9,0,23322
MUSMANNO RETENTION,  MUSMANNO - NO,South Hanover Twp--2nd Precinct,252,6,0,0,258,22976,337,9,0,23322
MUSMANNO RETENTION,  MUSMANNO - NO,South Hanover Twp--3rd Precinct,174,0,0,0,174,22976,337,9,0,23322
MUSMANNO RETENTION,  MUSMANNO - NO,Susquehanna Twp--1st Ward,291,5,0,0,296,22976,337,9,0,23322
MUSMANNO RETENTION,  MUSMANNO - NO,Susquehanna Twp--2nd Ward,419,11,0,0,430,22976,337,9,0,23322
MUSMANNO RETENTION,  MUSMANNO - NO,Susquehanna Twp--3rd Ward,201,0,0,0,201,22976,337,9,0,23322
MUSMANNO RETENTION,  MUSMANNO - NO,Susquehanna Twp--4th Ward,234,3,0,0,237,22976,337,9,0,23322
MUSMANNO RETENTION,  MUSMANNO - NO,Susquehanna Twp--5th Ward,215,5,0,0,220,22976,337,9,0,23322
MUSMANNO RETENTION,  MUSMANNO - NO,Susquehanna Twp--6th Ward,263,6,0,0,269,22976,337,9,0,23322
MUSMANNO RETENTION,  MUSMANNO - NO,Susquehanna Twp--7th Ward,147,0,0,0,147,22976,337,9,0,23322
MUSMANNO RETENTION,  MUSMANNO - NO,Susquehanna Twp--8th Ward,325,11,0,0,336,22976,337,9,0,23322
MUSMANNO RETENTION,  MUSMANNO - NO,Susquehanna Twp--9th Ward,257,3,0,0,260,22976,337,9,0,23322
MUSMANNO RETENTION,  MUSMANNO - NO,Swatara Township--1st Ward,208,0,0,0,208,22976,337,9,0,23322
MUSMANNO RETENTION,  MUSMANNO - NO,Swatara Township--2nd Ward,128,2,0,0,130,22976,337,9,0,23322
MUSMANNO RETENTION,  MUSMANNO - NO,Swatara Township--3rd Ward,135,3,0,0,138,22976,337,9,0,23322
MUSMANNO RETENTION,  MUSMANNO - NO,Swatara Township--4th Ward,224,7,0,0,231,22976,337,9,0,23322
MUSMANNO RETENTION,  MUSMANNO - NO,Swatara Township--5th Ward,291,3,0,0,294,22976,337,9,0,23322
MUSMANNO RETENTION,  MUSMANNO - NO,Swatara Township--6th Ward,306,0,0,0,306,22976,337,9,0,23322
MUSMANNO RETENTION,  MUSMANNO - NO,Swatara Township--7th Ward,330,2,0,0,332,22976,337,9,0,23322
MUSMANNO RETENTION,  MUSMANNO - NO,Swatara Township--8th Ward,344,4,1,0,349,22976,337,9,0,23322
MUSMANNO RETENTION,  MUSMANNO - NO,Swatara Township--9th Ward,121,1,0,0,122,22976,337,9,0,23322
MUSMANNO RETENTION,  MUSMANNO - NO,Upper Paxton Twp--1st Precinct,186,2,0,0,188,22976,337,9,0,23322
MUSMANNO RETENTION,  MUSMANNO - NO,Upper Paxton Twp--2nd Precinct,144,1,0,0,145,22976,337,9,0,23322
MUSMANNO RETENTION,  MUSMANNO - NO,Washington Township,184,4,0,0,188,22976,337,9,0,23322
MUSMANNO RETENTION,  MUSMANNO - NO,Wayne Township,196,1,0,0,197,22976,337,9,0,23322
MUSMANNO RETENTION,  MUSMANNO - NO,West Hanover Twp--1st Precinct,235,4,0,0,239,22976,337,9,0,23322
MUSMANNO RETENTION,  MUSMANNO - NO,West Hanover Twp--2nd Precinct,207,3,0,0,210,22976,337,9,0,23322
MUSMANNO RETENTION,  MUSMANNO - NO,West Hanover Twp--3rd Precinct,493,11,2,0,506,22976,337,9,0,23322
MUSMANNO RETENTION,  MUSMANNO - NO,West Hanover Twp--4th Precinct,277,2,0,0,279,22976,337,9,0,23322
MUSMANNO RETENTION,  MUSMANNO - NO,Wiconisco Twp--1st Precinct,52,0,0,0,52,22976,337,9,0,23322
MUSMANNO RETENTION,  MUSMANNO - NO,Wiconisco Twp--2nd Precinct,35,1,0,0,36,22976,337,9,0,23322
MUSMANNO RETENTION,  MUSMANNO - NO,Williams Twp,81,1,0,0,82,22976,337,9,0,23322
MUSMANNO RETENTION,  MUSMANNO - YES,"City--1st Ward, 1st Precinct",47,2,0,0,49,13123,388,11,0,13522
MUSMANNO RETENTION,  MUSMANNO - YES,"City--1st Ward, 2nd Precinct",80,2,1,0,83,13123,388,11,0,13522
MUSMANNO RETENTION,  MUSMANNO - YES,"City--1st Ward, 3rd Precinct",27,0,0,0,27,13123,388,11,0,13522
MUSMANNO RETENTION,  MUSMANNO - YES,"City--2nd Ward, 1st Precinct",11,0,0,0,11,13123,388,11,0,13522
MUSMANNO RETENTION,  MUSMANNO - YES,"City--2nd Ward, 2nd Precinct",34,1,0,0,35,13123,388,11,0,13522
MUSMANNO RETENTION,  MUSMANNO - YES,City--3rd Ward,46,1,0,0,47,13123,388,11,0,13522
MUSMANNO RETENTION,  MUSMANNO - YES,City--4th Ward,72,4,0,0,76,13123,388,11,0,13522
MUSMANNO RETENTION,  MUSMANNO - YES,City--5th Ward,149,7,0,0,156,13123,388,11,0,13522
MUSMANNO RETENTION,  MUSMANNO - YES,City--6th Ward,63,1,2,0,66,13123,388,11,0,13522
MUSMANNO RETENTION,  MUSMANNO - YES,"City--7th Ward, 1st Precinct",28,0,0,0,28,13123,388,11,0,13522
MUSMANNO RETENTION,  MUSMANNO - YES,"City--7th Ward, 2nd Precinct",58,0,0,0,58,13123,388,11,0,13522
MUSMANNO RETENTION,  MUSMANNO - YES,City--8th Ward,53,0,0,0,53,13123,388,11,0,13522
MUSMANNO RETENTION,  MUSMANNO - YES,"City--9th Ward, 1st Precinct",17,1,0,0,18,13123,388,11,0,13522
MUSMANNO RETENTION,  MUSMANNO - YES,"City--9th Ward, 2nd Precinct",29,2,0,0,31,13123,388,11,0,13522
MUSMANNO RETENTION,  MUSMANNO - YES,"City--9th Ward, 3rd Precinct",65,1,0,0,66,13123,388,11,0,13522
MUSMANNO RETENTION,  MUSMANNO - YES,"City--9th Ward, 4th Precinct",91,3,0,0,94,13123,388,11,0,13522
MUSMANNO RETENTION,  MUSMANNO - YES,"City--9th Ward, 5th Precinct",57,1,0,0,58,13123,388,11,0,13522
MUSMANNO RETENTION,  MUSMANNO - YES,"City--10th Ward, 1st Precinct",86,3,0,0,89,13123,388,11,0,13522
MUSMANNO RETENTION,  MUSMANNO - YES,"City--10th Ward, 2nd Precinct",36,0,0,0,36,13123,388,11,0,13522
MUSMANNO RETENTION,  MUSMANNO - YES,"City--10th Ward, 3rd Precinct",53,0,0,0,53,13123,388,11,0,13522
MUSMANNO RETENTION,  MUSMANNO - YES,"City--10th Ward, 4th Precinct",45,0,0,0,45,13123,388,11,0,13522
MUSMANNO RETENTION,  MUSMANNO - YES,City--11th Ward,37,31,0,0,68,13123,388,11,0,13522
MUSMANNO RETENTION,  MUSMANNO - YES,City--12th Ward,116,6,0,0,122,13123,388,11,0,13522
MUSMANNO RETENTION,  MUSMANNO - YES,"City--13th Ward, 1st Precinct",46,0,0,0,46,13123,388,11,0,13522
MUSMANNO RETENTION,  MUSMANNO - YES,"City--13th Ward, 2nd Precinct",75,0,0,0,75,13123,388,11,0,13522
MUSMANNO RETENTION,  MUSMANNO - YES,"City--13th Ward, 3rd Precinct",87,0,0,0,87,13123,388,11,0,13522
MUSMANNO RETENTION,  MUSMANNO - YES,City--14th Ward,144,5,0,0,149,13123,388,11,0,13522
MUSMANNO RETENTION,  MUSMANNO - YES,City--15th Ward,36,0,0,0,36,13123,388,11,0,13522
MUSMANNO RETENTION,  MUSMANNO - YES,Berrysburg Borough,15,0,0,0,15,13123,388,11,0,13522
MUSMANNO RETENTION,  MUSMANNO - YES,Dauphin Borough,34,2,0,0,36,13123,388,11,0,13522
MUSMANNO RETENTION,  MUSMANNO - YES,Elizabethville Borough,50,1,0,0,51,13123,388,11,0,13522
MUSMANNO RETENTION,  MUSMANNO - YES,Gratz Borough,26,1,0,0,27,13123,388,11,0,13522
MUSMANNO RETENTION,  MUSMANNO - YES,Halifax Borough,22,3,0,0,25,13123,388,11,0,13522
MUSMANNO RETENTION,  MUSMANNO - YES,Highspire--1st Precinct,52,0,0,0,52,13123,388,11,0,13522
MUSMANNO RETENTION,  MUSMANNO - YES,Highspire--2nd Precinct,52,1,0,0,53,13123,388,11,0,13522
MUSMANNO RETENTION,  MUSMANNO - YES,Hummelstown--1st Precinct,73,1,0,0,74,13123,388,11,0,13522
MUSMANNO RETENTION,  MUSMANNO - YES,Hummelstown--2nd Precinct,148,4,0,0,152,13123,388,11,0,13522
MUSMANNO RETENTION,  MUSMANNO - YES,Lykens Borough--1st Ward,42,1,0,0,43,13123,388,11,0,13522
MUSMANNO RETENTION,  MUSMANNO - YES,Lykens Borough--2nd Ward,44,2,0,0,46,13123,388,11,0,13522
MUSMANNO RETENTION,  MUSMANNO - YES,"Middletown--1st Ward, 1st Precinct",43,0,0,0,43,13123,388,11,0,13522
MUSMANNO RETENTION,  MUSMANNO - YES,"Middletown--1st Ward, 2nd Precinct",65,5,1,0,71,13123,388,11,0,13522
MUSMANNO RETENTION,  MUSMANNO - YES,"Middletown--2nd Ward, 1st Precinct",52,0,0,0,52,13123,388,11,0,13522
MUSMANNO RETENTION,  MUSMANNO - YES,"Middletown--2nd Ward, 2nd Precinct",60,2,0,0,62,13123,388,11,0,13522
MUSMANNO RETENTION,  MUSMANNO - YES,"Middletown--3rd Ward, 1st Precinct",40,0,0,0,40,13123,388,11,0,13522
MUSMANNO RETENTION,  MUSMANNO - YES,"Middletown--3rd Ward, 2nd Precinct",83,0,0,0,83,13123,388,11,0,13522
MUSMANNO RETENTION,  MUSMANNO - YES,Millersburg--1st Ward,49,2,0,0,51,13123,388,11,0,13522
MUSMANNO RETENTION,  MUSMANNO - YES,Millersburg--2nd Ward,51,2,0,0,53,13123,388,11,0,13522
MUSMANNO RETENTION,  MUSMANNO - YES,Paxtang Borough,102,1,0,0,103,13123,388,11,0,13522
MUSMANNO RETENTION,  MUSMANNO - YES,Penbrook Borough--1st Ward,27,1,0,0,28,13123,388,11,0,13522
MUSMANNO RETENTION,  MUSMANNO - YES,Penbrook Borough--2nd Ward,34,0,0,0,34,13123,388,11,0,13522
MUSMANNO RETENTION,  MUSMANNO - YES,Penbrook Borough--3rd Ward,25,0,0,0,25,13123,388,11,0,13522
MUSMANNO RETENTION,  MUSMANNO - YES,Penbrook Borough--4th Ward,23,0,0,0,23,13123,388,11,0,13522
MUSMANNO RETENTION,  MUSMANNO - YES,Royalton Borough--1st Ward,16,0,0,0,16,13123,388,11,0,13522
MUSMANNO RETENTION,  MUSMANNO - YES,Royalton Borough--2nd Ward,26,0,0,0,26,13123,388,11,0,13522
MUSMANNO RETENTION,  MUSMANNO - YES,Steelton--1st Ward,53,3,0,0,56,13123,388,11,0,13522
MUSMANNO RETENTION,  MUSMANNO - YES,"Steelton--2nd Ward, 1st Precinct",49,1,0,0,50,13123,388,11,0,13522
MUSMANNO RETENTION,  MUSMANNO - YES,"Steelton--2nd Ward, 2nd Precinct",36,0,0,0,36,13123,388,11,0,13522
MUSMANNO RETENTION,  MUSMANNO - YES,"Steelton--3rd Ward, 1st Precinct",25,0,0,0,25,13123,388,11,0,13522
MUSMANNO RETENTION,  MUSMANNO - YES,"Steelton--3rd Ward, 2nd Precinct",31,0,0,0,31,13123,388,11,0,13522
MUSMANNO RETENTION,  MUSMANNO - YES,Steelton--4th Ward,35,1,1,0,37,13123,388,11,0,13522
MUSMANNO RETENTION,  MUSMANNO - YES,Pillow Borough,19,0,0,0,19,13123,388,11,0,13522
MUSMANNO RETENTION,  MUSMANNO - YES,Williamstown--1st Ward,34,0,0,0,34,13123,388,11,0,13522
MUSMANNO RETENTION,  MUSMANNO - YES,Williamstown--2nd Ward,19,0,0,0,19,13123,388,11,0,13522
MUSMANNO RETENTION,  MUSMANNO - YES,Conewago Twp--1st Precinct,70,1,0,0,71,13123,388,11,0,13522
MUSMANNO RETENTION,  MUSMANNO - YES,Conewago Twp--2nd Precinct,61,0,0,0,61,13123,388,11,0,13522
MUSMANNO RETENTION,  MUSMANNO - YES,Derry Township--1st Precinct,130,4,0,0,134,13123,388,11,0,13522
MUSMANNO RETENTION,  MUSMANNO - YES,Derry Township--2nd Precinct,108,4,0,0,112,13123,388,11,0,13522
MUSMANNO RETENTION,  MUSMANNO - YES,Derry Township--3rd Precinct,82,3,0,0,85,13123,388,11,0,13522
MUSMANNO RETENTION,  MUSMANNO - YES,Derry Township--4th Precinct,75,3,0,0,78,13123,388,11,0,13522
MUSMANNO RETENTION,  MUSMANNO - YES,Derry Township--5th Precinct,61,0,0,0,61,13123,388,11,0,13522
MUSMANNO RETENTION,  MUSMANNO - YES,Derry Township--6th Precinct,75,1,0,0,76,13123,388,11,0,13522
MUSMANNO RETENTION,  MUSMANNO - YES,Derry Township--7th Precinct,140,7,0,0,147,13123,388,11,0,13522
MUSMANNO RETENTION,  MUSMANNO - YES,Derry Township--8th Precinct,78,0,0,0,78,13123,388,11,0,13522
MUSMANNO RETENTION,  MUSMANNO - YES,Derry Township--9th Precinct,56,2,0,0,58,13123,388,11,0,13522
MUSMANNO RETENTION,  MUSMANNO - YES,Derry Township--10th Precinct,82,4,0,0,86,13123,388,11,0,13522
MUSMANNO RETENTION,  MUSMANNO - YES,Derry Township--11th Precinct,132,2,0,0,134,13123,388,11,0,13522
MUSMANNO RETENTION,  MUSMANNO - YES,Derry Township--12th Precinct,79,4,0,0,83,13123,388,11,0,13522
MUSMANNO RETENTION,  MUSMANNO - YES,Derry Township--13th Precinct,113,4,0,0,117,13123,388,11,0,13522
MUSMANNO RETENTION,  MUSMANNO - YES,Derry Township--14th Precinct,70,4,0,0,74,13123,388,11,0,13522
MUSMANNO RETENTION,  MUSMANNO - YES,Derry Township--15th Precinct,118,3,1,0,122,13123,388,11,0,13522
MUSMANNO RETENTION,  MUSMANNO - YES,East Hanover Township--1st Precinct,96,5,0,0,101,13123,388,11,0,13522
MUSMANNO RETENTION,  MUSMANNO - YES,East Hanover Township--2nd Precinct,119,2,0,0,121,13123,388,11,0,13522
MUSMANNO RETENTION,  MUSMANNO - YES,Halifax Twp--1st Precinct,86,2,0,0,88,13123,388,11,0,13522
MUSMANNO RETENTION,  MUSMANNO - YES,Halifax Twp--2nd Precinct,105,2,0,0,107,13123,388,11,0,13522
MUSMANNO RETENTION,  MUSMANNO - YES,Jackson Township,63,0,0,0,63,13123,388,11,0,13522
MUSMANNO RETENTION,  MUSMANNO - YES,Jefferson Township,13,0,0,0,13,13123,388,11,0,13522
MUSMANNO RETENTION,  MUSMANNO - YES,Londonderry Twp--1st Precinct,99,0,0,0,99,13123,388,11,0,13522
MUSMANNO RETENTION,  MUSMANNO - YES,Londonderry Twp--2nd Precinct,74,1,0,0,75,13123,388,11,0,13522
MUSMANNO RETENTION,  MUSMANNO - YES,Londonderry Twp--3rd Precinct,45,0,0,0,45,13123,388,11,0,13522
MUSMANNO RETENTION,  MUSMANNO - YES,Lower Paxton Twp--1st Precinct,92,2,0,0,94,13123,388,11,0,13522
MUSMANNO RETENTION,  MUSMANNO - YES,Lower Paxton Twp--2nd Precinct,85,6,0,0,91,13123,388,11,0,13522
MUSMANNO RETENTION,  MUSMANNO - YES,Lower Paxton Twp--3rd precinct,158,5,0,0,163,13123,388,11,0,13522
MUSMANNO RETENTION,  MUSMANNO - YES,Lower Paxton Twp--4th Precinct,118,0,0,0,118,13123,388,11,0,13522
MUSMANNO RETENTION,  MUSMANNO - YES,Lower Paxton Twp--5th Precinct,99,0,0,0,99,13123,388,11,0,13522
MUSMANNO RETENTION,  MUSMANNO - YES,Lower Paxton Twp--6th Precinct,88,5,0,0,93,13123,388,11,0,13522
MUSMANNO RETENTION,  MUSMANNO - YES,Lower Paxton Twp--7th Precinct,140,7,0,0,147,13123,388,11,0,13522
MUSMANNO RETENTION,  MUSMANNO - YES,Lower Paxton Twp--8th Precinct,72,2,0,0,74,13123,388,11,0,13522
MUSMANNO RETENTION,  MUSMANNO - YES,Lower Paxton Twp--9th Precinct,69,3,0,0,72,13123,388,11,0,13522
MUSMANNO RETENTION,  MUSMANNO - YES,Lower Paxton Twp--10th Precinct,73,4,0,0,77,13123,388,11,0,13522
MUSMANNO RETENTION,  MUSMANNO - YES,Lower Paxton Twp--11th Precinct,79,0,0,0,79,13123,388,11,0,13522
MUSMANNO RETENTION,  MUSMANNO - YES,Lower Paxton Twp--12th Precinct,141,3,0,0,144,13123,388,11,0,13522
MUSMANNO RETENTION,  MUSMANNO - YES,Lower Paxton Twp--13th Precinct,103,3,0,0,106,13123,388,11,0,13522
MUSMANNO RETENTION,  MUSMANNO - YES,Lower Paxton Twp--14th Precinct,81,1,3,0,85,13123,388,11,0,13522
MUSMANNO RETENTION,  MUSMANNO - YES,Lower Paxton Twp--15th Precinct,98,1,0,0,99,13123,388,11,0,13522
MUSMANNO RETENTION,  MUSMANNO - YES,Lower Paxton Twp--16th Precinct,181,7,0,0,188,13123,388,11,0,13522
MUSMANNO RETENTION,  MUSMANNO - YES,Lower Paxton Twp--17th Precinct,93,5,0,0,98,13123,388,11,0,13522
MUSMANNO RETENTION,  MUSMANNO - YES,Lower Paxton Twp--18th Precinct,88,1,0,0,89,13123,388,11,0,13522
MUSMANNO RETENTION,  MUSMANNO - YES,Lower Paxton Twp--19th Precinct,178,11,0,0,189,13123,388,11,0,13522
MUSMANNO RETENTION,  MUSMANNO - YES,Lower Paxton Twp--20th Precinct,113,2,0,0,115,13123,388,11,0,13522
MUSMANNO RETENTION,  MUSMANNO - YES,Lower Paxton Twp--21st Precinct,150,6,0,0,156,13123,388,11,0,13522
MUSMANNO RETENTION,  MUSMANNO - YES,Lower Paxton Twp--22nd Precinct,114,2,0,0,116,13123,388,11,0,13522
MUSMANNO RETENTION,  MUSMANNO - YES,Lower Paxton Twp--23rd Precinct,121,1,0,0,122,13123,388,11,0,13522
MUSMANNO RETENTION,  MUSMANNO - YES,Lower Paxton Twp--24th Precinct,116,2,0,0,118,13123,388,11,0,13522
MUSMANNO RETENTION,  MUSMANNO - YES,Lower Paxton Twp--25th Precinct,85,3,0,0,88,13123,388,11,0,13522
MUSMANNO RETENTION,  MUSMANNO - YES,Lower Paxton Twp--26th Precinct,122,2,0,0,124,13123,388,11,0,13522
MUSMANNO RETENTION,  MUSMANNO - YES,Lower Paxton Twp--27th Precinct,108,1,0,0,109,13123,388,11,0,13522
MUSMANNO RETENTION,  MUSMANNO - YES,Lower Swatara Twp--1st Precinct,136,3,0,0,139,13123,388,11,0,13522
MUSMANNO RETENTION,  MUSMANNO - YES,Lower Swatara Twp--2nd Precinct,120,3,0,0,123,13123,388,11,0,13522
MUSMANNO RETENTION,  MUSMANNO - YES,Lower Swatara Twp--3rd Precinct,112,16,0,0,128,13123,388,11,0,13522
MUSMANNO RETENTION,  MUSMANNO - YES,Lower Swatara Twp--4th Precinct,68,1,0,0,69,13123,388,11,0,13522
MUSMANNO RETENTION,  MUSMANNO - YES,Lykens Township,30,0,0,0,30,13123,388,11,0,13522
MUSMANNO RETENTION,  MUSMANNO - YES,Middle Paxton Twp--1st Precinct,68,0,0,0,68,13123,388,11,0,13522
MUSMANNO RETENTION,  MUSMANNO - YES,Middle Paxton Twp--2nd Precinct,93,0,0,0,93,13123,388,11,0,13522
MUSMANNO RETENTION,  MUSMANNO - YES,Middle Paxton Twp--3rd Precinct,81,2,0,0,83,13123,388,11,0,13522
MUSMANNO RETENTION,  MUSMANNO - YES,Mifflin Township,26,0,0,0,26,13123,388,11,0,13522
MUSMANNO RETENTION,  MUSMANNO - YES,Reed Township,15,0,0,0,15,13123,388,11,0,13522
MUSMANNO RETENTION,  MUSMANNO - YES,Rush Township,18,0,0,0,18,13123,388,11,0,13522
MUSMANNO RETENTION,  MUSMANNO - YES,South Hanover Twp--1st Precinct,90,2,0,0,92,13123,388,11,0,13522
MUSMANNO RETENTION,  MUSMANNO - YES,South Hanover Twp--2nd Precinct,151,4,0,0,155,13123,388,11,0,13522
MUSMANNO RETENTION,  MUSMANNO - YES,South Hanover Twp--3rd Precinct,77,0,0,0,77,13123,388,11,0,13522
MUSMANNO RETENTION,  MUSMANNO - YES,Susquehanna Twp--1st Ward,196,10,0,0,206,13123,388,11,0,13522
MUSMANNO RETENTION,  MUSMANNO - YES,Susquehanna Twp--2nd Ward,287,15,0,0,302,13123,388,11,0,13522
MUSMANNO RETENTION,  MUSMANNO - YES,Susquehanna Twp--3rd Ward,108,3,0,0,111,13123,388,11,0,13522
MUSMANNO RETENTION,  MUSMANNO - YES,Susquehanna Twp--4th Ward,112,0,0,0,112,13123,388,11,0,13522
MUSMANNO RETENTION,  MUSMANNO - YES,Susquehanna Twp--5th Ward,145,1,0,0,146,13123,388,11,0,13522
MUSMANNO RETENTION,  MUSMANNO - YES,Susquehanna Twp--6th Ward,141,3,0,0,144,13123,388,11,0,13522
MUSMANNO RETENTION,  MUSMANNO - YES,Susquehanna Twp--7th Ward,91,0,0,0,91,13123,388,11,0,13522
MUSMANNO RETENTION,  MUSMANNO - YES,Susquehanna Twp--8th Ward,246,8,0,0,254,13123,388,11,0,13522
MUSMANNO RETENTION,  MUSMANNO - YES,Susquehanna Twp--9th Ward,162,1,0,0,163,13123,388,11,0,13522
MUSMANNO RETENTION,  MUSMANNO - YES,Swatara Township--1st Ward,128,1,0,0,129,13123,388,11,0,13522
MUSMANNO RETENTION,  MUSMANNO - YES,Swatara Township--2nd Ward,81,19,0,0,100,13123,388,11,0,13522
MUSMANNO RETENTION,  MUSMANNO - YES,Swatara Township--3rd Ward,101,5,0,0,106,13123,388,11,0,13522
MUSMANNO RETENTION,  MUSMANNO - YES,Swatara Township--4th Ward,130,1,0,0,131,13123,388,11,0,13522
MUSMANNO RETENTION,  MUSMANNO - YES,Swatara Township--5th Ward,166,2,0,0,168,13123,388,11,0,13522
MUSMANNO RETENTION,  MUSMANNO - YES,Swatara Township--6th Ward,129,3,1,0,133,13123,388,11,0,13522
MUSMANNO RETENTION,  MUSMANNO - YES,Swatara Township--7th Ward,149,7,0,0,156,13123,388,11,0,13522
MUSMANNO RETENTION,  MUSMANNO - YES,Swatara Township--8th Ward,165,3,0,0,168,13123,388,11,0,13522
MUSMANNO RETENTION,  MUSMANNO - YES,Swatara Township--9th Ward,89,7,0,0,96,13123,388,11,0,13522
MUSMANNO RETENTION,  MUSMANNO - YES,Upper Paxton Twp--1st Precinct,109,1,0,0,110,13123,388,11,0,13522
MUSMANNO RETENTION,  MUSMANNO - YES,Upper Paxton Twp--2nd Precinct,51,2,0,0,53,13123,388,11,0,13522
MUSMANNO RETENTION,  MUSMANNO - YES,Washington Township,99,3,0,0,102,13123,388,11,0,13522
MUSMANNO RETENTION,  MUSMANNO - YES,Wayne Township,70,0,1,0,71,13123,388,11,0,13522
MUSMANNO RETENTION,  MUSMANNO - YES,West Hanover Twp--1st Precinct,88,2,0,0,90,13123,388,11,0,13522
MUSMANNO RETENTION,  MUSMANNO - YES,West Hanover Twp--2nd Precinct,98,2,0,0,100,13123,388,11,0,13522
MUSMANNO RETENTION,  MUSMANNO - YES,West Hanover Twp--3rd Precinct,212,8,0,0,220,13123,388,11,0,13522
MUSMANNO RETENTION,  MUSMANNO - YES,West Hanover Twp--4th Precinct,127,1,0,0,128,13123,388,11,0,13522
MUSMANNO RETENTION,  MUSMANNO - YES,Wiconisco Twp--1st Precinct,31,1,0,0,32,13123,388,11,0,13522
MUSMANNO RETENTION,  MUSMANNO - YES,Wiconisco Twp--2nd Precinct,26,0,0,0,26,13123,388,11,0,13522
MUSMANNO RETENTION,  MUSMANNO - YES,Williams Twp,63,0,0,0,63,13123,388,11,0,13522
NO VOTE,No Vote,"City--1st Ward, 1st Precinct",0,0,0,0,0,14,0,0,0,14
NO VOTE,No Vote,"City--1st Ward, 2nd Precinct",0,0,0,0,0,14,0,0,0,14
NO VOTE,No Vote,"City--1st Ward, 3rd Precinct",0,0,0,0,0,14,0,0,0,14
NO VOTE,No Vote,"City--2nd Ward, 1st Precinct",0,0,0,0,0,14,0,0,0,14
NO VOTE,No Vote,"City--2nd Ward, 2nd Precinct",0,0,0,0,0,14,0,0,0,14
NO VOTE,No Vote,City--3rd Ward,0,0,0,0,0,14,0,0,0,14
NO VOTE,No Vote,City--4th Ward,0,0,0,0,0,14,0,0,0,14
NO VOTE,No Vote,City--5th Ward,0,0,0,0,0,14,0,0,0,14
NO VOTE,No Vote,City--6th Ward,0,0,0,0,0,14,0,0,0,14
NO VOTE,No Vote,"City--7th Ward, 1st Precinct",0,0,0,0,0,14,0,0,0,14
NO VOTE,No Vote,"City--7th Ward, 2nd Precinct",0,0,0,0,0,14,0,0,0,14
NO VOTE,No Vote,City--8th Ward,0,0,0,0,0,14,0,0,0,14
NO VOTE,No Vote,"City--9th Ward, 1st Precinct",0,0,0,0,0,14,0,0,0,14
NO VOTE,No Vote,"City--9th Ward, 2nd Precinct",1,0,0,0,1,14,0,0,0,14
NO VOTE,No Vote,"City--9th Ward, 3rd Precinct",0,0,0,0,0,14,0,0,0,14
NO VOTE,No Vote,"City--9th Ward, 4th Precinct",0,0,0,0,0,14,0,0,0,14
NO VOTE,No Vote,"City--9th Ward, 5th Precinct",0,0,0,0,0,14,0,0,0,14
NO VOTE,No Vote,"City--10th Ward, 1st Precinct",0,0,0,0,0,14,0,0,0,14
NO VOTE,No Vote,"City--10th Ward, 2nd Precinct",0,0,0,0,0,14,0,0,0,14
NO VOTE,No Vote,"City--10th Ward, 3rd Precinct",0,0,0,0,0,14,0,0,0,14
NO VOTE,No Vote,"City--10th Ward, 4th Precinct",0,0,0,0,0,14,0,0,0,14
NO VOTE,No Vote,City--11th Ward,0,0,0,0,0,14,0,0,0,14
NO VOTE,No Vote,City--12th Ward,0,0,0,0,0,14,0,0,0,14
NO VOTE,No Vote,"City--13th Ward, 1st Precinct",0,0,0,0,0,14,0,0,0,14
NO VOTE,No Vote,"City--13th Ward, 2nd Precinct",0,0,0,0,0,14,0,0,0,14
NO VOTE,No Vote,"City--13th Ward, 3rd Precinct",0,0,0,0,0,14,0,0,0,14
NO VOTE,No Vote,City--14th Ward,0,0,0,0,0,14,0,0,0,14
NO VOTE,No Vote,City--15th Ward,0,0,0,0,0,14,0,0,0,14
NO VOTE,No Vote,Berrysburg Borough,0,0,0,0,0,14,0,0,0,14
NO VOTE,No Vote,Dauphin Borough,0,0,0,0,0,14,0,0,0,14
NO VOTE,No Vote,Elizabethville Borough,0,0,0,0,0,14,0,0,0,14
NO VOTE,No Vote,Gratz Borough,0,0,0,0,0,14,0,0,0,14
NO VOTE,No Vote,Halifax Borough,0,0,0,0,0,14,0,0,0,14
NO VOTE,No Vote,Highspire--1st Precinct,0,0,0,0,0,14,0,0,0,14
NO VOTE,No Vote,Highspire--2nd Precinct,0,0,0,0,0,14,0,0,0,14
NO VOTE,No Vote,Hummelstown--1st Precinct,0,0,0,0,0,14,0,0,0,14
NO VOTE,No Vote,Hummelstown--2nd Precinct,0,0,0,0,0,14,0,0,0,14
NO VOTE,No Vote,Lykens Borough--1st Ward,0,0,0,0,0,14,0,0,0,14
NO VOTE,No Vote,Lykens Borough--2nd Ward,0,0,0,0,0,14,0,0,0,14
NO VOTE,No Vote,"Middletown--1st Ward, 1st Precinct",0,0,0,0,0,14,0,0,0,14
NO VOTE,No Vote,"Middletown--1st Ward, 2nd Precinct",0,0,0,0,0,14,0,0,0,14
NO VOTE,No Vote,"Middletown--2nd Ward, 1st Precinct",0,0,0,0,0,14,0,0,0,14
NO VOTE,No Vote,"Middletown--2nd Ward, 2nd Precinct",0,0,0,0,0,14,0,0,0,14
NO VOTE,No Vote,"Middletown--3rd Ward, 1st Precinct",1,0,0,0,1,14,0,0,0,14
NO VOTE,No Vote,"Middletown--3rd Ward, 2nd Precinct",0,0,0,0,0,14,0,0,0,14
NO VOTE,No Vote,Millersburg--1st Ward,0,0,0,0,0,14,0,0,0,14
NO VOTE,No Vote,Millersburg--2nd Ward,0,0,0,0,0,14,0,0,0,14
NO VOTE,No Vote,Paxtang Borough,0,0,0,0,0,14,0,0,0,14
NO VOTE,No Vote,Penbrook Borough--1st Ward,0,0,0,0,0,14,0,0,0,14
NO VOTE,No Vote,Penbrook Borough--2nd Ward,0,0,0,0,0,14,0,0,0,14
NO VOTE,No Vote,Penbrook Borough--3rd Ward,0,0,0,0,0,14,0,0,0,14
NO VOTE,No Vote,Penbrook Borough--4th Ward,0,0,0,0,0,14,0,0,0,14
NO VOTE,No Vote,Royalton Borough--1st Ward,0,0,0,0,0,14,0,0,0,14
NO VOTE,No Vote,Royalton Borough--2nd Ward,0,0,0,0,0,14,0,0,0,14
NO VOTE,No Vote,Steelton--1st Ward,1,0,0,0,1,14,0,0,0,14
NO VOTE,No Vote,"Steelton--2nd Ward, 1st Precinct",0,0,0,0,0,14,0,0,0,14
NO VOTE,No Vote,"Steelton--2nd Ward, 2nd Precinct",0,0,0,0,0,14,0,0,0,14
NO VOTE,No Vote,"Steelton--3rd Ward, 1st Precinct",0,0,0,0,0,14,0,0,0,14
NO VOTE,No Vote,"Steelton--3rd Ward, 2nd Precinct",0,0,0,0,0,14,0,0,0,14
NO VOTE,No Vote,Steelton--4th Ward,0,0,0,0,0,14,0,0,0,14
NO VOTE,No Vote,Pillow Borough,0,0,0,0,0,14,0,0,0,14
NO VOTE,No Vote,Williamstown--1st Ward,0,0,0,0,0,14,0,0,0,14
NO VOTE,No Vote,Williamstown--2nd Ward,0,0,0,0,0,14,0,0,0,14
NO VOTE,No Vote,Conewago Twp--1st Precinct,0,0,0,0,0,14,0,0,0,14
NO VOTE,No Vote,Conewago Twp--2nd Precinct,2,0,0,0,2,14,0,0,0,14
NO VOTE,No Vote,Derry Township--1st Precinct,0,0,0,0,0,14,0,0,0,14
NO VOTE,No Vote,Derry Township--2nd Precinct,0,0,0,0,0,14,0,0,0,14
NO VOTE,No Vote,Derry Township--3rd Precinct,0,0,0,0,0,14,0,0,0,14
NO VOTE,No Vote,Derry Township--4th Precinct,0,0,0,0,0,14,0,0,0,14
NO VOTE,No Vote,Derry Township--5th Precinct,0,0,0,0,0,14,0,0,0,14
NO VOTE,No Vote,Derry Township--6th Precinct,0,0,0,0,0,14,0,0,0,14
NO VOTE,No Vote,Derry Township--7th Precinct,0,0,0,0,0,14,0,0,0,14
NO VOTE,No Vote,Derry Township--8th Precinct,0,0,0,0,0,14,0,0,0,14
NO VOTE,No Vote,Derry Township--9th Precinct,0,0,0,0,0,14,0,0,0,14
NO VOTE,No Vote,Derry Township--10th Precinct,0,0,0,0,0,14,0,0,0,14
NO VOTE,No Vote,Derry Township--11th Precinct,0,0,0,0,0,14,0,0,0,14
NO VOTE,No Vote,Derry Township--12th Precinct,0,0,0,0,0,14,0,0,0,14
NO VOTE,No Vote,Derry Township--13th Precinct,0,0,0,0,0,14,0,0,0,14
NO VOTE,No Vote,Derry Township--14th Precinct,0,0,0,0,0,14,0,0,0,14
NO VOTE,No Vote,Derry Township--15th Precinct,0,0,0,0,0,14,0,0,0,14
NO VOTE,No Vote,East Hanover Township--1st Precinct,0,0,0,0,0,14,0,0,0,14
NO VOTE,No Vote,East Hanover Township--2nd Precinct,0,0,0,0,0,14,0,0,0,14
NO VOTE,No Vote,Halifax Twp--1st Precinct,0,0,0,0,0,14,0,0,0,14
NO VOTE,No Vote,Halifax Twp--2nd Precinct,0,0,0,0,0,14,0,0,0,14
NO VOTE,No Vote,Jackson Township,0,0,0,0,0,14,0,0,0,14
NO VOTE,No Vote,Jefferson Township,0,0,0,0,0,14,0,0,0,14
NO VOTE,No Vote,Londonderry Twp--1st Precinct,0,0,0,0,0,14,0,0,0,14
NO VOTE,No Vote,Londonderry Twp--2nd Precinct,0,0,0,0,0,14,0,0,0,14
NO VOTE,No Vote,Londonderry Twp--3rd Precinct,0,0,0,0,0,14,0,0,0,14
NO VOTE,No Vote,Lower Paxton Twp--1st Precinct,0,0,0,0,0,14,0,0,0,14
NO VOTE,No Vote,Lower Paxton Twp--2nd Precinct,0,0,0,0,0,14,0,0,0,14
NO VOTE,No Vote,Lower Paxton Twp--3rd precinct,2,0,0,0,2,14,0,0,0,14
NO VOTE,No Vote,Lower Paxton Twp--4th Precinct,2,0,0,0,2,14,0,0,0,14
NO VOTE,No Vote,Lower Paxton Twp--5th Precinct,0,0,0,0,0,14,0,0,0,14
NO VOTE,No Vote,Lower Paxton Twp--6th Precinct,0,0,0,0,0,14,0,0,0,14
NO VOTE,No Vote,Lower Paxton Twp--7th Precinct,0,0,0,0,0,14,0,0,0,14
NO VOTE,No Vote,Lower Paxton Twp--8th Precinct,0,0,0,0,0,14,0,0,0,14
NO VOTE,No Vote,Lower Paxton Twp--9th Precinct,0,0,0,0,0,14,0,0,0,14
NO VOTE,No Vote,Lower Paxton Twp--10th Precinct,0,0,0,0,0,14,0,0,0,14
NO VOTE,No Vote,Lower Paxton Twp--11th Precinct,0,0,0,0,0,14,0,0,0,14
NO VOTE,No Vote,Lower Paxton Twp--12th Precinct,0,0,0,0,0,14,0,0,0,14
NO VOTE,No Vote,Lower Paxton Twp--13th Precinct,0,0,0,0,0,14,0,0,0,14
NO VOTE,No Vote,Lower Paxton Twp--14th Precinct,0,0,0,0,0,14,0,0,0,14
NO VOTE,No Vote,Lower Paxton Twp--15th Precinct,0,0,0,0,0,14,0,0,0,14
NO VOTE,No Vote,Lower Paxton Twp--16th Precinct,0,0,0,0,0,14,0,0,0,14
NO VOTE,No Vote,Lower Paxton Twp--17th Precinct,0,0,0,0,0,14,0,0,0,14
NO VOTE,No Vote,Lower Paxton Twp--18th Precinct,0,0,0,0,0,14,0,0,0,14
NO VOTE,No Vote,Lower Paxton Twp--19th Precinct,0,0,0,0,0,14,0,0,0,14
NO VOTE,No Vote,Lower Paxton Twp--20th Precinct,0,0,0,0,0,14,0,0,0,14
NO VOTE,No Vote,Lower Paxton Twp--21st Precinct,0,0,0,0,0,14,0,0,0,14
NO VOTE,No Vote,Lower Paxton Twp--22nd Precinct,0,0,0,0,0,14,0,0,0,14
NO VOTE,No Vote,Lower Paxton Twp--23rd Precinct,0,0,0,0,0,14,0,0,0,14
NO VOTE,No Vote,Lower Paxton Twp--24th Precinct,0,0,0,0,0,14,0,0,0,14
NO VOTE,No Vote,Lower Paxton Twp--25th Precinct,0,0,0,0,0,14,0,0,0,14
NO VOTE,No Vote,Lower Paxton Twp--26th Precinct,0,0,0,0,0,14,0,0,0,14
NO VOTE,No Vote,Lower Paxton Twp--27th Precinct,0,0,0,0,0,14,0,0,0,14
NO VOTE,No Vote,Lower Swatara Twp--1st Precinct,0,0,0,0,0,14,0,0,0,14
NO VOTE,No Vote,Lower Swatara Twp--2nd Precinct,0,0,0,0,0,14,0,0,0,14
NO VOTE,No Vote,Lower Swatara Twp--3rd Precinct,0,0,0,0,0,14,0,0,0,14
NO VOTE,No Vote,Lower Swatara Twp--4th Precinct,0,0,0,0,0,14,0,0,0,14
NO VOTE,No Vote,Lykens Township,0,0,0,0,0,14,0,0,0,14
NO VOTE,No Vote,Middle Paxton Twp--1st Precinct,0,0,0,0,0,14,0,0,0,14
NO VOTE,No Vote,Middle Paxton Twp--2nd Precinct,0,0,0,0,0,14,0,0,0,14
NO VOTE,No Vote,Middle Paxton Twp--3rd Precinct,0,0,0,0,0,14,0,0,0,14
NO VOTE,No Vote,Mifflin Township,0,0,0,0,0,14,0,0,0,14
NO VOTE,No Vote,Reed Township,0,0,0,0,0,14,0,0,0,14
NO VOTE,No Vote,Rush Township,0,0,0,0,0,14,0,0,0,14
NO VOTE,No Vote,South Hanover Twp--1st Precinct,1,0,0,0,1,14,0,0,0,14
NO VOTE,No Vote,South Hanover Twp--2nd Precinct,0,0,0,0,0,14,0,0,0,14
NO VOTE,No Vote,South Hanover Twp--3rd Precinct,0,0,0,0,0,14,0,0,0,14
NO VOTE,No Vote,Susquehanna Twp--1st Ward,0,0,0,0,0,14,0,0,0,14
NO VOTE,No Vote,Susquehanna Twp--2nd Ward,0,0,0,0,0,14,0,0,0,14
NO VOTE,No Vote,Susquehanna Twp--3rd Ward,0,0,0,0,0,14,0,0,0,14
NO VOTE,No Vote,Susquehanna Twp--4th Ward,0,0,0,0,0,14,0,0,0,14
NO VOTE,No Vote,Susquehanna Twp--5th Ward,1,0,0,0,1,14,0,0,0,14
NO VOTE,No Vote,Susquehanna Twp--6th Ward,0,0,0,0,0,14,0,0,0,14
NO VOTE,No Vote,Susquehanna Twp--7th Ward,0,0,0,0,0,14,0,0,0,14
NO VOTE,No Vote,Susquehanna Twp--8th Ward,0,0,0,0,0,14,0,0,0,14
NO VOTE,No Vote,Susquehanna Twp--9th Ward,0,0,0,0,0,14,0,0,0,14
NO VOTE,No Vote,Swatara Township--1st Ward,0,0,0,0,0,14,0,0,0,14
NO VOTE,No Vote,Swatara Township--2nd Ward,0,0,0,0,0,14,0,0,0,14
NO VOTE,No Vote,Swatara Township--3rd Ward,0,0,0,0,0,14,0,0,0,14
NO VOTE,No Vote,Swatara Township--4th Ward,0,0,0,0,0,14,0,0,0,14
NO VOTE,No Vote,Swatara Township--5th Ward,1,0,0,0,1,14,0,0,0,14
NO VOTE,No Vote,Swatara Township--6th Ward,0,0,0,0,0,14,0,0,0,14
NO VOTE,No Vote,Swatara Township--7th Ward,0,0,0,0,0,14,0,0,0,14
NO VOTE,No Vote,Swatara Township--8th Ward,1,0,0,0,1,14,0,0,0,14
NO VOTE,No Vote,Swatara Township--9th Ward,0,0,0,0,0,14,0,0,0,14
NO VOTE,No Vote,Upper Paxton Twp--1st Precinct,0,0,0,0,0,14,0,0,0,14
NO VOTE,No Vote,Upper Paxton Twp--2nd Precinct,0,0,0,0,0,14,0,0,0,14
NO VOTE,No Vote,Washington Township,0,0,0,0,0,14,0,0,0,14
NO VOTE,No Vote,Wayne Township,0,0,0,0,0,14,0,0,0,14
NO VOTE,No Vote,West Hanover Twp--1st Precinct,1,0,0,0,1,14,0,0,0,14
NO VOTE,No Vote,West Hanover Twp--2nd Precinct,0,0,0,0,0,14,0,0,0,14
NO VOTE,No Vote,West Hanover Twp--3rd Precinct,0,0,0,0,0,14,0,0,0,14
NO VOTE,No Vote,West Hanover Twp--4th Precinct,0,0,0,0,0,14,0,0,0,14
NO VOTE,No Vote,Wiconisco Twp--1st Precinct,0,0,0,0,0,14,0,0,0,14
NO VOTE,No Vote,Wiconisco Twp--2nd Precinct,0,0,0,0,0,14,0,0,0,14
NO VOTE,No Vote,Williams Twp,0,0,0,0,0,14,0,0,0,14
RECORDER OF DEEDS,James M. ZUGAY,"City--1st Ward, 1st Precinct",57,2,0,0,59,30317,650,18,0,30985
RECORDER OF DEEDS,James M. ZUGAY,"City--1st Ward, 2nd Precinct",105,1,1,0,107,30317,650,18,0,30985
RECORDER OF DEEDS,James M. ZUGAY,"City--1st Ward, 3rd Precinct",25,0,0,0,25,30317,650,18,0,30985
RECORDER OF DEEDS,James M. ZUGAY,"City--2nd Ward, 1st Precinct",31,0,0,0,31,30317,650,18,0,30985
RECORDER OF DEEDS,James M. ZUGAY,"City--2nd Ward, 2nd Precinct",42,1,0,0,43,30317,650,18,0,30985
RECORDER OF DEEDS,James M. ZUGAY,City--3rd Ward,62,1,0,0,63,30317,650,18,0,30985
RECORDER OF DEEDS,James M. ZUGAY,City--4th Ward,94,4,0,0,98,30317,650,18,0,30985
RECORDER OF DEEDS,James M. ZUGAY,City--5th Ward,175,8,0,0,183,30317,650,18,0,30985
RECORDER OF DEEDS,James M. ZUGAY,City--6th Ward,103,1,2,0,106,30317,650,18,0,30985
RECORDER OF DEEDS,James M. ZUGAY,"City--7th Ward, 1st Precinct",33,2,0,0,35,30317,650,18,0,30985
RECORDER OF DEEDS,James M. ZUGAY,"City--7th Ward, 2nd Precinct",57,2,0,0,59,30317,650,18,0,30985
RECORDER OF DEEDS,James M. ZUGAY,City--8th Ward,46,1,0,0,47,30317,650,18,0,30985
RECORDER OF DEEDS,James M. ZUGAY,"City--9th Ward, 1st Precinct",26,2,0,0,28,30317,650,18,0,30985
RECORDER OF DEEDS,James M. ZUGAY,"City--9th Ward, 2nd Precinct",31,1,0,0,32,30317,650,18,0,30985
RECORDER OF DEEDS,James M. ZUGAY,"City--9th Ward, 3rd Precinct",74,2,0,0,76,30317,650,18,0,30985
RECORDER OF DEEDS,James M. ZUGAY,"City--9th Ward, 4th Precinct",130,3,0,0,133,30317,650,18,0,30985
RECORDER OF DEEDS,James M. ZUGAY,"City--9th Ward, 5th Precinct",80,5,0,0,85,30317,650,18,0,30985
RECORDER OF DEEDS,James M. ZUGAY,"City--10th Ward, 1st Precinct",125,5,0,0,130,30317,650,18,0,30985
RECORDER OF DEEDS,James M. ZUGAY,"City--10th Ward, 2nd Precinct",37,0,0,0,37,30317,650,18,0,30985
RECORDER OF DEEDS,James M. ZUGAY,"City--10th Ward, 3rd Precinct",75,1,0,0,76,30317,650,18,0,30985
RECORDER OF DEEDS,James M. ZUGAY,"City--10th Ward, 4th Precinct",47,0,0,0,47,30317,650,18,0,30985
RECORDER OF DEEDS,James M. ZUGAY,City--11th Ward,47,30,0,0,77,30317,650,18,0,30985
RECORDER OF DEEDS,James M. ZUGAY,City--12th Ward,140,6,0,0,146,30317,650,18,0,30985
RECORDER OF DEEDS,James M. ZUGAY,"City--13th Ward, 1st Precinct",88,0,0,0,88,30317,650,18,0,30985
RECORDER OF DEEDS,James M. ZUGAY,"City--13th Ward, 2nd Precinct",123,4,0,0,127,30317,650,18,0,30985
RECORDER OF DEEDS,James M. ZUGAY,"City--13th Ward, 3rd Precinct",130,2,0,0,132,30317,650,18,0,30985
RECORDER OF DEEDS,James M. ZUGAY,City--14th Ward,228,3,0,0,231,30317,650,18,0,30985
RECORDER OF DEEDS,James M. ZUGAY,City--15th Ward,38,0,0,0,38,30317,650,18,0,30985
RECORDER OF DEEDS,James M. ZUGAY,Berrysburg Borough,53,0,0,0,53,30317,650,18,0,30985
RECORDER OF DEEDS,James M. ZUGAY,Dauphin Borough,141,1,0,0,142,30317,650,18,0,30985
RECORDER OF DEEDS,James M. ZUGAY,Elizabethville Borough,161,1,0,0,162,30317,650,18,0,30985
RECORDER OF DEEDS,James M. ZUGAY,Gratz Borough,76,2,0,0,78,30317,650,18,0,30985
RECORDER OF DEEDS,James M. ZUGAY,Halifax Borough,75,3,0,0,78,30317,650,18,0,30985
RECORDER OF DEEDS,James M. ZUGAY,Highspire--1st Precinct,121,2,0,0,123,30317,650,18,0,30985
RECORDER OF DEEDS,James M. ZUGAY,Highspire--2nd Precinct,138,1,0,0,139,30317,650,18,0,30985
RECORDER OF DEEDS,James M. ZUGAY,Hummelstown--1st Precinct,176,4,0,0,180,30317,650,18,0,30985
RECORDER OF DEEDS,James M. ZUGAY,Hummelstown--2nd Precinct,384,4,0,0,388,30317,650,18,0,30985
RECORDER OF DEEDS,James M. ZUGAY,Lykens Borough--1st Ward,80,1,0,0,81,30317,650,18,0,30985
RECORDER OF DEEDS,James M. ZUGAY,Lykens Borough--2nd Ward,117,4,0,0,121,30317,650,18,0,30985
RECORDER OF DEEDS,James M. ZUGAY,"Middletown--1st Ward, 1st Precinct",82,0,0,0,82,30317,650,18,0,30985
RECORDER OF DEEDS,James M. ZUGAY,"Middletown--1st Ward, 2nd Precinct",131,8,1,0,140,30317,650,18,0,30985
RECORDER OF DEEDS,James M. ZUGAY,"Middletown--2nd Ward, 1st Precinct",149,3,0,0,152,30317,650,18,0,30985
RECORDER OF DEEDS,James M. ZUGAY,"Middletown--2nd Ward, 2nd Precinct",151,4,0,0,155,30317,650,18,0,30985
RECORDER OF DEEDS,James M. ZUGAY,"Middletown--3rd Ward, 1st Precinct",119,1,0,0,120,30317,650,18,0,30985
RECORDER OF DEEDS,James M. ZUGAY,"Middletown--3rd Ward, 2nd Precinct",193,0,0,0,193,30317,650,18,0,30985
RECORDER OF DEEDS,James M. ZUGAY,Millersburg--1st Ward,129,4,0,0,133,30317,650,18,0,30985
RECORDER OF DEEDS,James M. ZUGAY,Millersburg--2nd Ward,169,4,0,0,173,30317,650,18,0,30985
RECORDER OF DEEDS,James M. ZUGAY,Paxtang Borough,231,3,0,0,234,30317,650,18,0,30985
RECORDER OF DEEDS,James M. ZUGAY,Penbrook Borough--1st Ward,53,1,0,0,54,30317,650,18,0,30985
RECORDER OF DEEDS,James M. ZUGAY,Penbrook Borough--2nd Ward,65,1,0,0,66,30317,650,18,0,30985
RECORDER OF DEEDS,James M. ZUGAY,Penbrook Borough--3rd Ward,73,0,0,0,73,30317,650,18,0,30985
RECORDER OF DEEDS,James M. ZUGAY,Penbrook Borough--4th Ward,79,1,0,0,80,30317,650,18,0,30985
RECORDER OF DEEDS,James M. ZUGAY,Royalton Borough--1st Ward,38,0,0,0,38,30317,650,18,0,30985
RECORDER OF DEEDS,James M. ZUGAY,Royalton Borough--2nd Ward,75,0,0,0,75,30317,650,18,0,30985
RECORDER OF DEEDS,James M. ZUGAY,Steelton--1st Ward,126,6,0,0,132,30317,650,18,0,30985
RECORDER OF DEEDS,James M. ZUGAY,"Steelton--2nd Ward, 1st Precinct",76,2,0,0,78,30317,650,18,0,30985
RECORDER OF DEEDS,James M. ZUGAY,"Steelton--2nd Ward, 2nd Precinct",79,1,0,0,80,30317,650,18,0,30985
RECORDER OF DEEDS,James M. ZUGAY,"Steelton--3rd Ward, 1st Precinct",41,0,0,0,41,30317,650,18,0,30985
RECORDER OF DEEDS,James M. ZUGAY,"Steelton--3rd Ward, 2nd Precinct",69,0,0,0,69,30317,650,18,0,30985
RECORDER OF DEEDS,James M. ZUGAY,Steelton--4th Ward,71,1,1,0,73,30317,650,18,0,30985
RECORDER OF DEEDS,James M. ZUGAY,Pillow Borough,45,0,0,0,45,30317,650,18,0,30985
RECORDER OF DEEDS,James M. ZUGAY,Williamstown--1st Ward,84,1,0,0,85,30317,650,18,0,30985
RECORDER OF DEEDS,James M. ZUGAY,Williamstown--2nd Ward,59,0,0,0,59,30317,650,18,0,30985
RECORDER OF DEEDS,James M. ZUGAY,Conewago Twp--1st Precinct,261,1,0,0,262,30317,650,18,0,30985
RECORDER OF DEEDS,James M. ZUGAY,Conewago Twp--2nd Precinct,195,7,0,0,202,30317,650,18,0,30985
RECORDER OF DEEDS,James M. ZUGAY,Derry Township--1st Precinct,307,4,0,0,311,30317,650,18,0,30985
RECORDER OF DEEDS,James M. ZUGAY,Derry Township--2nd Precinct,251,7,0,0,258,30317,650,18,0,30985
RECORDER OF DEEDS,James M. ZUGAY,Derry Township--3rd Precinct,186,6,0,0,192,30317,650,18,0,30985
RECORDER OF DEEDS,James M. ZUGAY,Derry Township--4th Precinct,164,6,0,0,170,30317,650,18,0,30985
RECORDER OF DEEDS,James M. ZUGAY,Derry Township--5th Precinct,146,3,0,0,149,30317,650,18,0,30985
RECORDER OF DEEDS,James M. ZUGAY,Derry Township--6th Precinct,160,1,1,0,162,30317,650,18,0,30985
RECORDER OF DEEDS,James M. ZUGAY,Derry Township--7th Precinct,351,16,0,0,367,30317,650,18,0,30985
RECORDER OF DEEDS,James M. ZUGAY,Derry Township--8th Precinct,170,0,0,0,170,30317,650,18,0,30985
RECORDER OF DEEDS,James M. ZUGAY,Derry Township--9th Precinct,101,1,0,0,102,30317,650,18,0,30985
RECORDER OF DEEDS,James M. ZUGAY,Derry Township--10th Precinct,241,3,0,0,244,30317,650,18,0,30985
RECORDER OF DEEDS,James M. ZUGAY,Derry Township--11th Precinct,300,7,0,0,307,30317,650,18,0,30985
RECORDER OF DEEDS,James M. ZUGAY,Derry Township--12th Precinct,170,2,0,0,172,30317,650,18,0,30985
RECORDER OF DEEDS,James M. ZUGAY,Derry Township--13th Precinct,241,7,0,0,248,30317,650,18,0,30985
RECORDER OF DEEDS,James M. ZUGAY,Derry Township--14th Precinct,164,5,0,0,169,30317,650,18,0,30985
RECORDER OF DEEDS,James M. ZUGAY,Derry Township--15th Precinct,310,5,1,0,316,30317,650,18,0,30985
RECORDER OF DEEDS,James M. ZUGAY,East Hanover Township--1st Precinct,330,9,0,0,339,30317,650,18,0,30985
RECORDER OF DEEDS,James M. ZUGAY,East Hanover Township--2nd Precinct,369,6,0,0,375,30317,650,18,0,30985
RECORDER OF DEEDS,James M. ZUGAY,Halifax Twp--1st Precinct,260,3,0,0,263,30317,650,18,0,30985
RECORDER OF DEEDS,James M. ZUGAY,Halifax Twp--2nd Precinct,298,12,0,0,310,30317,650,18,0,30985
RECORDER OF DEEDS,James M. ZUGAY,Jackson Township,215,1,0,0,216,30317,650,18,0,30985
RECORDER OF DEEDS,James M. ZUGAY,Jefferson Township,59,0,0,0,59,30317,650,18,0,30985
RECORDER OF DEEDS,James M. ZUGAY,Londonderry Twp--1st Precinct,286,0,0,0,286,30317,650,18,0,30985
RECORDER OF DEEDS,James M. ZUGAY,Londonderry Twp--2nd Precinct,259,3,0,0,262,30317,650,18,0,30985
RECORDER OF DEEDS,James M. ZUGAY,Londonderry Twp--3rd Precinct,114,1,0,0,115,30317,650,18,0,30985
RECORDER OF DEEDS,James M. ZUGAY,Lower Paxton Twp--1st Precinct,202,2,0,0,204,30317,650,18,0,30985
RECORDER OF DEEDS,James M. ZUGAY,Lower Paxton Twp--2nd Precinct,205,8,0,0,213,30317,650,18,0,30985
RECORDER OF DEEDS,James M. ZUGAY,Lower Paxton Twp--3rd precinct,400,11,0,0,411,30317,650,18,0,30985
RECORDER OF DEEDS,James M. ZUGAY,Lower Paxton Twp--4th Precinct,290,4,0,0,294,30317,650,18,0,30985
RECORDER OF DEEDS,James M. ZUGAY,Lower Paxton Twp--5th Precinct,241,4,1,0,246,30317,650,18,0,30985
RECORDER OF DEEDS,James M. ZUGAY,Lower Paxton Twp--6th Precinct,178,4,0,0,182,30317,650,18,0,30985
RECORDER OF DEEDS,James M. ZUGAY,Lower Paxton Twp--7th Precinct,347,7,0,0,354,30317,650,18,0,30985
RECORDER OF DEEDS,James M. ZUGAY,Lower Paxton Twp--8th Precinct,146,3,0,0,149,30317,650,18,0,30985
RECORDER OF DEEDS,James M. ZUGAY,Lower Paxton Twp--9th Precinct,207,4,0,0,211,30317,650,18,0,30985
RECORDER OF DEEDS,James M. ZUGAY,Lower Paxton Twp--10th Precinct,114,3,0,0,117,30317,650,18,0,30985
RECORDER OF DEEDS,James M. ZUGAY,Lower Paxton Twp--11th Precinct,197,2,1,0,200,30317,650,18,0,30985
RECORDER OF DEEDS,James M. ZUGAY,Lower Paxton Twp--12th Precinct,297,8,1,0,306,30317,650,18,0,30985
RECORDER OF DEEDS,James M. ZUGAY,Lower Paxton Twp--13th Precinct,273,6,0,0,279,30317,650,18,0,30985
RECORDER OF DEEDS,James M. ZUGAY,Lower Paxton Twp--14th Precinct,152,4,3,0,159,30317,650,18,0,30985
RECORDER OF DEEDS,James M. ZUGAY,Lower Paxton Twp--15th Precinct,251,4,0,0,255,30317,650,18,0,30985
RECORDER OF DEEDS,James M. ZUGAY,Lower Paxton Twp--16th Precinct,426,10,0,0,436,30317,650,18,0,30985
RECORDER OF DEEDS,James M. ZUGAY,Lower Paxton Twp--17th Precinct,191,7,0,0,198,30317,650,18,0,30985
RECORDER OF DEEDS,James M. ZUGAY,Lower Paxton Twp--18th Precinct,179,2,0,0,181,30317,650,18,0,30985
RECORDER OF DEEDS,James M. ZUGAY,Lower Paxton Twp--19th Precinct,337,15,0,0,352,30317,650,18,0,30985
RECORDER OF DEEDS,James M. ZUGAY,Lower Paxton Twp--20th Precinct,265,5,0,0,270,30317,650,18,0,30985
RECORDER OF DEEDS,James M. ZUGAY,Lower Paxton Twp--21st Precinct,323,8,0,0,331,30317,650,18,0,30985
RECORDER OF DEEDS,James M. ZUGAY,Lower Paxton Twp--22nd Precinct,287,5,0,0,292,30317,650,18,0,30985
RECORDER OF DEEDS,James M. ZUGAY,Lower Paxton Twp--23rd Precinct,270,3,0,0,273,30317,650,18,0,30985
RECORDER OF DEEDS,James M. ZUGAY,Lower Paxton Twp--24th Precinct,263,6,0,0,269,30317,650,18,0,30985
RECORDER OF DEEDS,James M. ZUGAY,Lower Paxton Twp--25th Precinct,157,4,0,0,161,30317,650,18,0,30985
RECORDER OF DEEDS,James M. ZUGAY,Lower Paxton Twp--26th Precinct,256,7,0,0,263,30317,650,18,0,30985
RECORDER OF DEEDS,James M. ZUGAY,Lower Paxton Twp--27th Precinct,224,2,0,0,226,30317,650,18,0,30985
RECORDER OF DEEDS,James M. ZUGAY,Lower Swatara Twp--1st Precinct,350,4,0,0,354,30317,650,18,0,30985
RECORDER OF DEEDS,James M. ZUGAY,Lower Swatara Twp--2nd Precinct,288,8,0,0,296,30317,650,18,0,30985
RECORDER OF DEEDS,James M. ZUGAY,Lower Swatara Twp--3rd Precinct,252,26,0,0,278,30317,650,18,0,30985
RECORDER OF DEEDS,James M. ZUGAY,Lower Swatara Twp--4th Precinct,242,1,0,0,243,30317,650,18,0,30985
RECORDER OF DEEDS,James M. ZUGAY,Lykens Township,93,0,0,0,93,30317,650,18,0,30985
RECORDER OF DEEDS,James M. ZUGAY,Middle Paxton Twp--1st Precinct,317,1,0,0,318,30317,650,18,0,30985
RECORDER OF DEEDS,James M. ZUGAY,Middle Paxton Twp--2nd Precinct,250,1,0,0,251,30317,650,18,0,30985
RECORDER OF DEEDS,James M. ZUGAY,Middle Paxton Twp--3rd Precinct,344,2,0,0,346,30317,650,18,0,30985
RECORDER OF DEEDS,James M. ZUGAY,Mifflin Township,81,0,0,0,81,30317,650,18,0,30985
RECORDER OF DEEDS,James M. ZUGAY,Reed Township,44,0,0,0,44,30317,650,18,0,30985
RECORDER OF DEEDS,James M. ZUGAY,Rush Township,35,0,0,0,35,30317,650,18,0,30985
RECORDER OF DEEDS,James M. ZUGAY,South Hanover Twp--1st Precinct,272,5,0,0,277,30317,650,18,0,30985
RECORDER OF DEEDS,James M. ZUGAY,South Hanover Twp--2nd Precinct,362,8,0,0,370,30317,650,18,0,30985
RECORDER OF DEEDS,James M. ZUGAY,South Hanover Twp--3rd Precinct,221,1,0,0,222,30317,650,18,0,30985
RECORDER OF DEEDS,James M. ZUGAY,Susquehanna Twp--1st Ward,354,16,0,0,370,30317,650,18,0,30985
RECORDER OF DEEDS,James M. ZUGAY,Susquehanna Twp--2nd Ward,557,21,0,0,578,30317,650,18,0,30985
RECORDER OF DEEDS,James M. ZUGAY,Susquehanna Twp--3rd Ward,214,0,0,0,214,30317,650,18,0,30985
RECORDER OF DEEDS,James M. ZUGAY,Susquehanna Twp--4th Ward,245,5,0,0,250,30317,650,18,0,30985
RECORDER OF DEEDS,James M. ZUGAY,Susquehanna Twp--5th Ward,302,6,0,0,308,30317,650,18,0,30985
RECORDER OF DEEDS,James M. ZUGAY,Susquehanna Twp--6th Ward,357,9,0,0,366,30317,650,18,0,30985
RECORDER OF DEEDS,James M. ZUGAY,Susquehanna Twp--7th Ward,164,0,0,0,164,30317,650,18,0,30985
RECORDER OF DEEDS,James M. ZUGAY,Susquehanna Twp--8th Ward,432,16,0,0,448,30317,650,18,0,30985
RECORDER OF DEEDS,James M. ZUGAY,Susquehanna Twp--9th Ward,297,4,0,0,301,30317,650,18,0,30985
RECORDER OF DEEDS,James M. ZUGAY,Swatara Township--1st Ward,283,3,0,0,286,30317,650,18,0,30985
RECORDER OF DEEDS,James M. ZUGAY,Swatara Township--2nd Ward,166,12,0,0,178,30317,650,18,0,30985
RECORDER OF DEEDS,James M. ZUGAY,Swatara Township--3rd Ward,203,6,0,0,209,30317,650,18,0,30985
RECORDER OF DEEDS,James M. ZUGAY,Swatara Township--4th Ward,303,9,0,0,312,30317,650,18,0,30985
RECORDER OF DEEDS,James M. ZUGAY,Swatara Township--5th Ward,420,3,0,0,423,30317,650,18,0,30985
RECORDER OF DEEDS,James M. ZUGAY,Swatara Township--6th Ward,383,2,1,0,386,30317,650,18,0,30985
RECORDER OF DEEDS,James M. ZUGAY,Swatara Township--7th Ward,367,11,0,0,378,30317,650,18,0,30985
RECORDER OF DEEDS,James M. ZUGAY,Swatara Township--8th Ward,453,5,1,0,459,30317,650,18,0,30985
RECORDER OF DEEDS,James M. ZUGAY,Swatara Township--9th Ward,171,9,0,0,180,30317,650,18,0,30985
RECORDER OF DEEDS,James M. ZUGAY,Upper Paxton Twp--1st Precinct,282,2,0,0,284,30317,650,18,0,30985
RECORDER OF DEEDS,James M. ZUGAY,Upper Paxton Twp--2nd Precinct,170,2,0,0,172,30317,650,18,0,30985
RECORDER OF DEEDS,James M. ZUGAY,Washington Township,256,7,0,0,263,30317,650,18,0,30985
RECORDER OF DEEDS,James M. ZUGAY,Wayne Township,244,0,1,0,245,30317,650,18,0,30985
RECORDER OF DEEDS,James M. ZUGAY,West Hanover Twp--1st Precinct,288,5,0,0,293,30317,650,18,0,30985
RECORDER OF DEEDS,James M. ZUGAY,West Hanover Twp--2nd Precinct,268,7,1,0,276,30317,650,18,0,30985
RECORDER OF DEEDS,James M. ZUGAY,West Hanover Twp--3rd Precinct,622,15,1,0,638,30317,650,18,0,30985
RECORDER OF DEEDS,James M. ZUGAY,West Hanover Twp--4th Precinct,364,1,0,0,365,30317,650,18,0,30985
RECORDER OF DEEDS,James M. ZUGAY,Wiconisco Twp--1st Precinct,72,1,0,0,73,30317,650,18,0,30985
RECORDER OF DEEDS,James M. ZUGAY,Wiconisco Twp--2nd Precinct,55,1,0,0,56,30317,650,18,0,30985
RECORDER OF DEEDS,James M. ZUGAY,Williams Twp,130,0,0,0,130,30317,650,18,0,30985
RECORDER OF DEEDS,Write In  ,"City--1st Ward, 1st Precinct",0,0,0,0,0,39,0,0,0,39
RECORDER OF DEEDS,Write In  ,"City--1st Ward, 2nd Precinct",0,0,0,0,0,39,0,0,0,39
RECORDER OF DEEDS,Write In  ,"City--1st Ward, 3rd Precinct",0,0,0,0,0,39,0,0,0,39
RECORDER OF DEEDS,Write In  ,"City--2nd Ward, 1st Precinct",0,0,0,0,0,39,0,0,0,39
RECORDER OF DEEDS,Write In  ,"City--2nd Ward, 2nd Precinct",0,0,0,0,0,39,0,0,0,39
RECORDER OF DEEDS,Write In  ,City--3rd Ward,0,0,0,0,0,39,0,0,0,39
RECORDER OF DEEDS,Write In  ,City--4th Ward,0,0,0,0,0,39,0,0,0,39
RECORDER OF DEEDS,Write In  ,City--5th Ward,1,0,0,0,1,39,0,0,0,39
RECORDER OF DEEDS,Write In  ,City--6th Ward,1,0,0,0,1,39,0,0,0,39
RECORDER OF DEEDS,Write In  ,"City--7th Ward, 1st Precinct",0,0,0,0,0,39,0,0,0,39
RECORDER OF DEEDS,Write In  ,"City--7th Ward, 2nd Precinct",0,0,0,0,0,39,0,0,0,39
RECORDER OF DEEDS,Write In  ,City--8th Ward,1,0,0,0,1,39,0,0,0,39
RECORDER OF DEEDS,Write In  ,"City--9th Ward, 1st Precinct",0,0,0,0,0,39,0,0,0,39
RECORDER OF DEEDS,Write In  ,"City--9th Ward, 2nd Precinct",1,0,0,0,1,39,0,0,0,39
RECORDER OF DEEDS,Write In  ,"City--9th Ward, 3rd Precinct",0,0,0,0,0,39,0,0,0,39
RECORDER OF DEEDS,Write In  ,"City--9th Ward, 4th Precinct",0,0,0,0,0,39,0,0,0,39
RECORDER OF DEEDS,Write In  ,"City--9th Ward, 5th Precinct",0,0,0,0,0,39,0,0,0,39
RECORDER OF DEEDS,Write In  ,"City--10th Ward, 1st Precinct",0,0,0,0,0,39,0,0,0,39
RECORDER OF DEEDS,Write In  ,"City--10th Ward, 2nd Precinct",2,0,0,0,2,39,0,0,0,39
RECORDER OF DEEDS,Write In  ,"City--10th Ward, 3rd Precinct",1,0,0,0,1,39,0,0,0,39
RECORDER OF DEEDS,Write In  ,"City--10th Ward, 4th Precinct",1,0,0,0,1,39,0,0,0,39
RECORDER OF DEEDS,Write In  ,City--11th Ward,0,0,0,0,0,39,0,0,0,39
RECORDER OF DEEDS,Write In  ,City--12th Ward,0,0,0,0,0,39,0,0,0,39
RECORDER OF DEEDS,Write In  ,"City--13th Ward, 1st Precinct",0,0,0,0,0,39,0,0,0,39
RECORDER OF DEEDS,Write In  ,"City--13th Ward, 2nd Precinct",0,0,0,0,0,39,0,0,0,39
RECORDER OF DEEDS,Write In  ,"City--13th Ward, 3rd Precinct",0,0,0,0,0,39,0,0,0,39
RECORDER OF DEEDS,Write In  ,City--14th Ward,0,0,0,0,0,39,0,0,0,39
RECORDER OF DEEDS,Write In  ,City--15th Ward,0,0,0,0,0,39,0,0,0,39
RECORDER OF DEEDS,Write In  ,Berrysburg Borough,0,0,0,0,0,39,0,0,0,39
RECORDER OF DEEDS,Write In  ,Dauphin Borough,0,0,0,0,0,39,0,0,0,39
RECORDER OF DEEDS,Write In  ,Elizabethville Borough,0,0,0,0,0,39,0,0,0,39
RECORDER OF DEEDS,Write In  ,Gratz Borough,0,0,0,0,0,39,0,0,0,39
RECORDER OF DEEDS,Write In  ,Halifax Borough,1,0,0,0,1,39,0,0,0,39
RECORDER OF DEEDS,Write In  ,Highspire--1st Precinct,0,0,0,0,0,39,0,0,0,39
RECORDER OF DEEDS,Write In  ,Highspire--2nd Precinct,0,0,0,0,0,39,0,0,0,39
RECORDER OF DEEDS,Write In  ,Hummelstown--1st Precinct,0,0,0,0,0,39,0,0,0,39
RECORDER OF DEEDS,Write In  ,Hummelstown--2nd Precinct,1,0,0,0,1,39,0,0,0,39
RECORDER OF DEEDS,Write In  ,Lykens Borough--1st Ward,0,0,0,0,0,39,0,0,0,39
RECORDER OF DEEDS,Write In  ,Lykens Borough--2nd Ward,1,0,0,0,1,39,0,0,0,39
RECORDER OF DEEDS,Write In  ,"Middletown--1st Ward, 1st Precinct",0,0,0,0,0,39,0,0,0,39
RECORDER OF DEEDS,Write In  ,"Middletown--1st Ward, 2nd Precinct",0,0,0,0,0,39,0,0,0,39
RECORDER OF DEEDS,Write In  ,"Middletown--2nd Ward, 1st Precinct",0,0,0,0,0,39,0,0,0,39
RECORDER OF DEEDS,Write In  ,"Middletown--2nd Ward, 2nd Precinct",0,0,0,0,0,39,0,0,0,39
RECORDER OF DEEDS,Write In  ,"Middletown--3rd Ward, 1st Precinct",0,0,0,0,0,39,0,0,0,39
RECORDER OF DEEDS,Write In  ,"Middletown--3rd Ward, 2nd Precinct",0,0,0,0,0,39,0,0,0,39
RECORDER OF DEEDS,Write In  ,Millersburg--1st Ward,0,0,0,0,0,39,0,0,0,39
RECORDER OF DEEDS,Write In  ,Millersburg--2nd Ward,0,0,0,0,0,39,0,0,0,39
RECORDER OF DEEDS,Write In  ,Paxtang Borough,0,0,0,0,0,39,0,0,0,39
RECORDER OF DEEDS,Write In  ,Penbrook Borough--1st Ward,0,0,0,0,0,39,0,0,0,39
RECORDER OF DEEDS,Write In  ,Penbrook Borough--2nd Ward,0,0,0,0,0,39,0,0,0,39
RECORDER OF DEEDS,Write In  ,Penbrook Borough--3rd Ward,0,0,0,0,0,39,0,0,0,39
RECORDER OF DEEDS,Write In  ,Penbrook Borough--4th Ward,0,0,0,0,0,39,0,0,0,39
RECORDER OF DEEDS,Write In  ,Royalton Borough--1st Ward,0,0,0,0,0,39,0,0,0,39
RECORDER OF DEEDS,Write In  ,Royalton Borough--2nd Ward,0,0,0,0,0,39,0,0,0,39
RECORDER OF DEEDS,Write In  ,Steelton--1st Ward,0,0,0,0,0,39,0,0,0,39
RECORDER OF DEEDS,Write In  ,"Steelton--2nd Ward, 1st Precinct",0,0,0,0,0,39,0,0,0,39
RECORDER OF DEEDS,Write In  ,"Steelton--2nd Ward, 2nd Precinct",0,0,0,0,0,39,0,0,0,39
RECORDER OF DEEDS,Write In  ,"Steelton--3rd Ward, 1st Precinct",0,0,0,0,0,39,0,0,0,39
RECORDER OF DEEDS,Write In  ,"Steelton--3rd Ward, 2nd Precinct",2,0,0,0,2,39,0,0,0,39
RECORDER OF DEEDS,Write In  ,Steelton--4th Ward,0,0,0,0,0,39,0,0,0,39
RECORDER OF DEEDS,Write In  ,Pillow Borough,0,0,0,0,0,39,0,0,0,39
RECORDER OF DEEDS,Write In  ,Williamstown--1st Ward,0,0,0,0,0,39,0,0,0,39
RECORDER OF DEEDS,Write In  ,Williamstown--2nd Ward,0,0,0,0,0,39,0,0,0,39
RECORDER OF DEEDS,Write In  ,Conewago Twp--1st Precinct,0,0,0,0,0,39,0,0,0,39
RECORDER OF DEEDS,Write In  ,Conewago Twp--2nd Precinct,1,0,0,0,1,39,0,0,0,39
RECORDER OF DEEDS,Write In  ,Derry Township--1st Precinct,0,0,0,0,0,39,0,0,0,39
RECORDER OF DEEDS,Write In  ,Derry Township--2nd Precinct,0,0,0,0,0,39,0,0,0,39
RECORDER OF DEEDS,Write In  ,Derry Township--3rd Precinct,0,0,0,0,0,39,0,0,0,39
RECORDER OF DEEDS,Write In  ,Derry Township--4th Precinct,1,0,0,0,1,39,0,0,0,39
RECORDER OF DEEDS,Write In  ,Derry Township--5th Precinct,0,0,0,0,0,39,0,0,0,39
RECORDER OF DEEDS,Write In  ,Derry Township--6th Precinct,0,0,0,0,0,39,0,0,0,39
RECORDER OF DEEDS,Write In  ,Derry Township--7th Precinct,0,0,0,0,0,39,0,0,0,39
RECORDER OF DEEDS,Write In  ,Derry Township--8th Precinct,0,0,0,0,0,39,0,0,0,39
RECORDER OF DEEDS,Write In  ,Derry Township--9th Precinct,0,0,0,0,0,39,0,0,0,39
RECORDER OF DEEDS,Write In  ,Derry Township--10th Precinct,0,0,0,0,0,39,0,0,0,39
RECORDER OF DEEDS,Write In  ,Derry Township--11th Precinct,0,0,0,0,0,39,0,0,0,39
RECORDER OF DEEDS,Write In  ,Derry Township--12th Precinct,0,0,0,0,0,39,0,0,0,39
RECORDER OF DEEDS,Write In  ,Derry Township--13th Precinct,0,0,0,0,0,39,0,0,0,39
RECORDER OF DEEDS,Write In  ,Derry Township--14th Precinct,0,0,0,0,0,39,0,0,0,39
RECORDER OF DEEDS,Write In  ,Derry Township--15th Precinct,1,0,0,0,1,39,0,0,0,39
RECORDER OF DEEDS,Write In  ,East Hanover Township--1st Precinct,0,0,0,0,0,39,0,0,0,39
RECORDER OF DEEDS,Write In  ,East Hanover Township--2nd Precinct,0,0,0,0,0,39,0,0,0,39
RECORDER OF DEEDS,Write In  ,Halifax Twp--1st Precinct,0,0,0,0,0,39,0,0,0,39
RECORDER OF DEEDS,Write In  ,Halifax Twp--2nd Precinct,0,0,0,0,0,39,0,0,0,39
RECORDER OF DEEDS,Write In  ,Jackson Township,0,0,0,0,0,39,0,0,0,39
RECORDER OF DEEDS,Write In  ,Jefferson Township,0,0,0,0,0,39,0,0,0,39
RECORDER OF DEEDS,Write In  ,Londonderry Twp--1st Precinct,0,0,0,0,0,39,0,0,0,39
RECORDER OF DEEDS,Write In  ,Londonderry Twp--2nd Precinct,1,0,0,0,1,39,0,0,0,39
RECORDER OF DEEDS,Write In  ,Londonderry Twp--3rd Precinct,0,0,0,0,0,39,0,0,0,39
RECORDER OF DEEDS,Write In  ,Lower Paxton Twp--1st Precinct,0,0,0,0,0,39,0,0,0,39
RECORDER OF DEEDS,Write In  ,Lower Paxton Twp--2nd Precinct,1,0,0,0,1,39,0,0,0,39
RECORDER OF DEEDS,Write In  ,Lower Paxton Twp--3rd precinct,0,0,0,0,0,39,0,0,0,39
RECORDER OF DEEDS,Write In  ,Lower Paxton Twp--4th Precinct,0,0,0,0,0,39,0,0,0,39
RECORDER OF DEEDS,Write In  ,Lower Paxton Twp--5th Precinct,0,0,0,0,0,39,0,0,0,39
RECORDER OF DEEDS,Write In  ,Lower Paxton Twp--6th Precinct,1,0,0,0,1,39,0,0,0,39
RECORDER OF DEEDS,Write In  ,Lower Paxton Twp--7th Precinct,1,0,0,0,1,39,0,0,0,39
RECORDER OF DEEDS,Write In  ,Lower Paxton Twp--8th Precinct,0,0,0,0,0,39,0,0,0,39
RECORDER OF DEEDS,Write In  ,Lower Paxton Twp--9th Precinct,0,0,0,0,0,39,0,0,0,39
RECORDER OF DEEDS,Write In  ,Lower Paxton Twp--10th Precinct,1,0,0,0,1,39,0,0,0,39
RECORDER OF DEEDS,Write In  ,Lower Paxton Twp--11th Precinct,0,0,0,0,0,39,0,0,0,39
RECORDER OF DEEDS,Write In  ,Lower Paxton Twp--12th Precinct,2,0,0,0,2,39,0,0,0,39
RECORDER OF DEEDS,Write In  ,Lower Paxton Twp--13th Precinct,0,0,0,0,0,39,0,0,0,39
RECORDER OF DEEDS,Write In  ,Lower Paxton Twp--14th Precinct,1,0,0,0,1,39,0,0,0,39
RECORDER OF DEEDS,Write In  ,Lower Paxton Twp--15th Precinct,0,0,0,0,0,39,0,0,0,39
RECORDER OF DEEDS,Write In  ,Lower Paxton Twp--16th Precinct,1,0,0,0,1,39,0,0,0,39
RECORDER OF DEEDS,Write In  ,Lower Paxton Twp--17th Precinct,0,0,0,0,0,39,0,0,0,39
RECORDER OF DEEDS,Write In  ,Lower Paxton Twp--18th Precinct,0,0,0,0,0,39,0,0,0,39
RECORDER OF DEEDS,Write In  ,Lower Paxton Twp--19th Precinct,0,0,0,0,0,39,0,0,0,39
RECORDER OF DEEDS,Write In  ,Lower Paxton Twp--20th Precinct,0,0,0,0,0,39,0,0,0,39
RECORDER OF DEEDS,Write In  ,Lower Paxton Twp--21st Precinct,0,0,0,0,0,39,0,0,0,39
RECORDER OF DEEDS,Write In  ,Lower Paxton Twp--22nd Precinct,1,0,0,0,1,39,0,0,0,39
RECORDER OF DEEDS,Write In  ,Lower Paxton Twp--23rd Precinct,0,0,0,0,0,39,0,0,0,39
RECORDER OF DEEDS,Write In  ,Lower Paxton Twp--24th Precinct,0,0,0,0,0,39,0,0,0,39
RECORDER OF DEEDS,Write In  ,Lower Paxton Twp--25th Precinct,0,0,0,0,0,39,0,0,0,39
RECORDER OF DEEDS,Write In  ,Lower Paxton Twp--26th Precinct,0,0,0,0,0,39,0,0,0,39
RECORDER OF DEEDS,Write In  ,Lower Paxton Twp--27th Precinct,0,0,0,0,0,39,0,0,0,39
RECORDER OF DEEDS,Write In  ,Lower Swatara Twp--1st Precinct,1,0,0,0,1,39,0,0,0,39
RECORDER OF DEEDS,Write In  ,Lower Swatara Twp--2nd Precinct,1,0,0,0,1,39,0,0,0,39
RECORDER OF DEEDS,Write In  ,Lower Swatara Twp--3rd Precinct,0,0,0,0,0,39,0,0,0,39
RECORDER OF DEEDS,Write In  ,Lower Swatara Twp--4th Precinct,0,0,0,0,0,39,0,0,0,39
RECORDER OF DEEDS,Write In  ,Lykens Township,0,0,0,0,0,39,0,0,0,39
RECORDER OF DEEDS,Write In  ,Middle Paxton Twp--1st Precinct,0,0,0,0,0,39,0,0,0,39
RECORDER OF DEEDS,Write In  ,Middle Paxton Twp--2nd Precinct,0,0,0,0,0,39,0,0,0,39
RECORDER OF DEEDS,Write In  ,Middle Paxton Twp--3rd Precinct,0,0,0,0,0,39,0,0,0,39
RECORDER OF DEEDS,Write In  ,Mifflin Township,0,0,0,0,0,39,0,0,0,39
RECORDER OF DEEDS,Write In  ,Reed Township,0,0,0,0,0,39,0,0,0,39
RECORDER OF DEEDS,Write In  ,Rush Township,0,0,0,0,0,39,0,0,0,39
RECORDER OF DEEDS,Write In  ,South Hanover Twp--1st Precinct,0,0,0,0,0,39,0,0,0,39
RECORDER OF DEEDS,Write In  ,South Hanover Twp--2nd Precinct,0,0,0,0,0,39,0,0,0,39
RECORDER OF DEEDS,Write In  ,South Hanover Twp--3rd Precinct,0,0,0,0,0,39,0,0,0,39
RECORDER OF DEEDS,Write In  ,Susquehanna Twp--1st Ward,2,0,0,0,2,39,0,0,0,39
RECORDER OF DEEDS,Write In  ,Susquehanna Twp--2nd Ward,1,0,0,0,1,39,0,0,0,39
RECORDER OF DEEDS,Write In  ,Susquehanna Twp--3rd Ward,1,0,0,0,1,39,0,0,0,39
RECORDER OF DEEDS,Write In  ,Susquehanna Twp--4th Ward,1,0,0,0,1,39,0,0,0,39
RECORDER OF DEEDS,Write In  ,Susquehanna Twp--5th Ward,0,0,0,0,0,39,0,0,0,39
RECORDER OF DEEDS,Write In  ,Susquehanna Twp--6th Ward,0,0,0,0,0,39,0,0,0,39
RECORDER OF DEEDS,Write In  ,Susquehanna Twp--7th Ward,0,0,0,0,0,39,0,0,0,39
RECORDER OF DEEDS,Write In  ,Susquehanna Twp--8th Ward,1,0,0,0,1,39,0,0,0,39
RECORDER OF DEEDS,Write In  ,Susquehanna Twp--9th Ward,1,0,0,0,1,39,0,0,0,39
RECORDER OF DEEDS,Write In  ,Swatara Township--1st Ward,0,0,0,0,0,39,0,0,0,39
RECORDER OF DEEDS,Write In  ,Swatara Township--2nd Ward,1,0,0,0,1,39,0,0,0,39
RECORDER OF DEEDS,Write In  ,Swatara Township--3rd Ward,0,0,0,0,0,39,0,0,0,39
RECORDER OF DEEDS,Write In  ,Swatara Township--4th Ward,1,0,0,0,1,39,0,0,0,39
RECORDER OF DEEDS,Write In  ,Swatara Township--5th Ward,0,0,0,0,0,39,0,0,0,39
RECORDER OF DEEDS,Write In  ,Swatara Township--6th Ward,0,0,0,0,0,39,0,0,0,39
RECORDER OF DEEDS,Write In  ,Swatara Township--7th Ward,0,0,0,0,0,39,0,0,0,39
RECORDER OF DEEDS,Write In  ,Swatara Township--8th Ward,1,0,0,0,1,39,0,0,0,39
RECORDER OF DEEDS,Write In  ,Swatara Township--9th Ward,0,0,0,0,0,39,0,0,0,39
RECORDER OF DEEDS,Write In  ,Upper Paxton Twp--1st Precinct,0,0,0,0,0,39,0,0,0,39
RECORDER OF DEEDS,Write In  ,Upper Paxton Twp--2nd Precinct,0,0,0,0,0,39,0,0,0,39
RECORDER OF DEEDS,Write In  ,Washington Township,0,0,0,0,0,39,0,0,0,39
RECORDER OF DEEDS,Write In  ,Wayne Township,0,0,0,0,0,39,0,0,0,39
RECORDER OF DEEDS,Write In  ,West Hanover Twp--1st Precinct,0,0,0,0,0,39,0,0,0,39
RECORDER OF DEEDS,Write In  ,West Hanover Twp--2nd Precinct,0,0,0,0,0,39,0,0,0,39
RECORDER OF DEEDS,Write In  ,West Hanover Twp--3rd Precinct,1,0,0,0,1,39,0,0,0,39
RECORDER OF DEEDS,Write In  ,West Hanover Twp--4th Precinct,0,0,0,0,0,39,0,0,0,39
RECORDER OF DEEDS,Write In  ,Wiconisco Twp--1st Precinct,0,0,0,0,0,39,0,0,0,39
RECORDER OF DEEDS,Write In  ,Wiconisco Twp--2nd Precinct,0,0,0,0,0,39,0,0,0,39
RECORDER OF DEEDS,Write In  ,Williams Twp,0,0,0,0,0,39,0,0,0,39
REGISTER OF WILLS,Sandy  SNYDER,"City--1st Ward, 1st Precinct",60,3,0,0,63,30398,648,18,0,31064
REGISTER OF WILLS,Sandy  SNYDER,"City--1st Ward, 2nd Precinct",112,1,1,0,114,30398,648,18,0,31064
REGISTER OF WILLS,Sandy  SNYDER,"City--1st Ward, 3rd Precinct",29,0,0,0,29,30398,648,18,0,31064
REGISTER OF WILLS,Sandy  SNYDER,"City--2nd Ward, 1st Precinct",28,0,0,0,28,30398,648,18,0,31064
REGISTER OF WILLS,Sandy  SNYDER,"City--2nd Ward, 2nd Precinct",41,1,0,0,42,30398,648,18,0,31064
REGISTER OF WILLS,Sandy  SNYDER,City--3rd Ward,66,1,0,0,67,30398,648,18,0,31064
REGISTER OF WILLS,Sandy  SNYDER,City--4th Ward,96,4,0,0,100,30398,648,18,0,31064
REGISTER OF WILLS,Sandy  SNYDER,City--5th Ward,185,8,0,0,193,30398,648,18,0,31064
REGISTER OF WILLS,Sandy  SNYDER,City--6th Ward,107,1,2,0,110,30398,648,18,0,31064
REGISTER OF WILLS,Sandy  SNYDER,"City--7th Ward, 1st Precinct",33,2,0,0,35,30398,648,18,0,31064
REGISTER OF WILLS,Sandy  SNYDER,"City--7th Ward, 2nd Precinct",57,2,0,0,59,30398,648,18,0,31064
REGISTER OF WILLS,Sandy  SNYDER,City--8th Ward,49,2,0,0,51,30398,648,18,0,31064
REGISTER OF WILLS,Sandy  SNYDER,"City--9th Ward, 1st Precinct",30,2,0,0,32,30398,648,18,0,31064
REGISTER OF WILLS,Sandy  SNYDER,"City--9th Ward, 2nd Precinct",34,1,0,0,35,30398,648,18,0,31064
REGISTER OF WILLS,Sandy  SNYDER,"City--9th Ward, 3rd Precinct",76,1,0,0,77,30398,648,18,0,31064
REGISTER OF WILLS,Sandy  SNYDER,"City--9th Ward, 4th Precinct",132,3,0,0,135,30398,648,18,0,31064
REGISTER OF WILLS,Sandy  SNYDER,"City--9th Ward, 5th Precinct",82,5,0,0,87,30398,648,18,0,31064
REGISTER OF WILLS,Sandy  SNYDER,"City--10th Ward, 1st Precinct",129,6,0,0,135,30398,648,18,0,31064
REGISTER OF WILLS,Sandy  SNYDER,"City--10th Ward, 2nd Precinct",31,0,0,0,31,30398,648,18,0,31064
REGISTER OF WILLS,Sandy  SNYDER,"City--10th Ward, 3rd Precinct",77,1,0,0,78,30398,648,18,0,31064
REGISTER OF WILLS,Sandy  SNYDER,"City--10th Ward, 4th Precinct",49,0,0,0,49,30398,648,18,0,31064
REGISTER OF WILLS,Sandy  SNYDER,City--11th Ward,56,31,0,0,87,30398,648,18,0,31064
REGISTER OF WILLS,Sandy  SNYDER,City--12th Ward,153,6,0,0,159,30398,648,18,0,31064
REGISTER OF WILLS,Sandy  SNYDER,"City--13th Ward, 1st Precinct",85,0,0,0,85,30398,648,18,0,31064
REGISTER OF WILLS,Sandy  SNYDER,"City--13th Ward, 2nd Precinct",126,5,0,0,131,30398,648,18,0,31064
REGISTER OF WILLS,Sandy  SNYDER,"City--13th Ward, 3rd Precinct",134,2,0,0,136,30398,648,18,0,31064
REGISTER OF WILLS,Sandy  SNYDER,City--14th Ward,237,3,0,0,240,30398,648,18,0,31064
REGISTER OF WILLS,Sandy  SNYDER,City--15th Ward,38,0,0,0,38,30398,648,18,0,31064
REGISTER OF WILLS,Sandy  SNYDER,Berrysburg Borough,56,0,0,0,56,30398,648,18,0,31064
REGISTER OF WILLS,Sandy  SNYDER,Dauphin Borough,139,1,0,0,140,30398,648,18,0,31064
REGISTER OF WILLS,Sandy  SNYDER,Elizabethville Borough,163,1,0,0,164,30398,648,18,0,31064
REGISTER OF WILLS,Sandy  SNYDER,Gratz Borough,83,2,0,0,85,30398,648,18,0,31064
REGISTER OF WILLS,Sandy  SNYDER,Halifax Borough,75,3,0,0,78,30398,648,18,0,31064
REGISTER OF WILLS,Sandy  SNYDER,Highspire--1st Precinct,118,3,0,0,121,30398,648,18,0,31064
REGISTER OF WILLS,Sandy  SNYDER,Highspire--2nd Precinct,139,1,0,0,140,30398,648,18,0,31064
REGISTER OF WILLS,Sandy  SNYDER,Hummelstown--1st Precinct,182,4,0,0,186,30398,648,18,0,31064
REGISTER OF WILLS,Sandy  SNYDER,Hummelstown--2nd Precinct,385,4,0,0,389,30398,648,18,0,31064
REGISTER OF WILLS,Sandy  SNYDER,Lykens Borough--1st Ward,85,1,0,0,86,30398,648,18,0,31064
REGISTER OF WILLS,Sandy  SNYDER,Lykens Borough--2nd Ward,116,4,0,0,120,30398,648,18,0,31064
REGISTER OF WILLS,Sandy  SNYDER,"Middletown--1st Ward, 1st Precinct",88,0,0,0,88,30398,648,18,0,31064
REGISTER OF WILLS,Sandy  SNYDER,"Middletown--1st Ward, 2nd Precinct",133,8,1,0,142,30398,648,18,0,31064
REGISTER OF WILLS,Sandy  SNYDER,"Middletown--2nd Ward, 1st Precinct",143,2,0,0,145,30398,648,18,0,31064
REGISTER OF WILLS,Sandy  SNYDER,"Middletown--2nd Ward, 2nd Precinct",152,6,0,0,158,30398,648,18,0,31064
REGISTER OF WILLS,Sandy  SNYDER,"Middletown--3rd Ward, 1st Precinct",112,1,0,0,113,30398,648,18,0,31064
REGISTER OF WILLS,Sandy  SNYDER,"Middletown--3rd Ward, 2nd Precinct",183,0,0,0,183,30398,648,18,0,31064
REGISTER OF WILLS,Sandy  SNYDER,Millersburg--1st Ward,126,4,0,0,130,30398,648,18,0,31064
REGISTER OF WILLS,Sandy  SNYDER,Millersburg--2nd Ward,171,4,0,0,175,30398,648,18,0,31064
REGISTER OF WILLS,Sandy  SNYDER,Paxtang Borough,231,4,0,0,235,30398,648,18,0,31064
REGISTER OF WILLS,Sandy  SNYDER,Penbrook Borough--1st Ward,53,1,0,0,54,30398,648,18,0,31064
REGISTER OF WILLS,Sandy  SNYDER,Penbrook Borough--2nd Ward,63,1,0,0,64,30398,648,18,0,31064
REGISTER OF WILLS,Sandy  SNYDER,Penbrook Borough--3rd Ward,75,0,0,0,75,30398,648,18,0,31064
REGISTER OF WILLS,Sandy  SNYDER,Penbrook Borough--4th Ward,77,1,0,0,78,30398,648,18,0,31064
REGISTER OF WILLS,Sandy  SNYDER,Royalton Borough--1st Ward,33,0,0,0,33,30398,648,18,0,31064
REGISTER OF WILLS,Sandy  SNYDER,Royalton Borough--2nd Ward,76,0,0,0,76,30398,648,18,0,31064
REGISTER OF WILLS,Sandy  SNYDER,Steelton--1st Ward,120,4,0,0,124,30398,648,18,0,31064
REGISTER OF WILLS,Sandy  SNYDER,"Steelton--2nd Ward, 1st Precinct",80,2,0,0,82,30398,648,18,0,31064
REGISTER OF WILLS,Sandy  SNYDER,"Steelton--2nd Ward, 2nd Precinct",77,1,0,0,78,30398,648,18,0,31064
REGISTER OF WILLS,Sandy  SNYDER,"Steelton--3rd Ward, 1st Precinct",37,0,0,0,37,30398,648,18,0,31064
REGISTER OF WILLS,Sandy  SNYDER,"Steelton--3rd Ward, 2nd Precinct",68,0,0,0,68,30398,648,18,0,31064
REGISTER OF WILLS,Sandy  SNYDER,Steelton--4th Ward,68,2,1,0,71,30398,648,18,0,31064
REGISTER OF WILLS,Sandy  SNYDER,Pillow Borough,48,0,0,0,48,30398,648,18,0,31064
REGISTER OF WILLS,Sandy  SNYDER,Williamstown--1st Ward,83,1,0,0,84,30398,648,18,0,31064
REGISTER OF WILLS,Sandy  SNYDER,Williamstown--2nd Ward,63,0,0,0,63,30398,648,18,0,31064
REGISTER OF WILLS,Sandy  SNYDER,Conewago Twp--1st Precinct,259,1,0,0,260,30398,648,18,0,31064
REGISTER OF WILLS,Sandy  SNYDER,Conewago Twp--2nd Precinct,194,7,0,0,201,30398,648,18,0,31064
REGISTER OF WILLS,Sandy  SNYDER,Derry Township--1st Precinct,309,4,0,0,313,30398,648,18,0,31064
REGISTER OF WILLS,Sandy  SNYDER,Derry Township--2nd Precinct,243,7,0,0,250,30398,648,18,0,31064
REGISTER OF WILLS,Sandy  SNYDER,Derry Township--3rd Precinct,189,5,0,0,194,30398,648,18,0,31064
REGISTER OF WILLS,Sandy  SNYDER,Derry Township--4th Precinct,169,5,0,0,174,30398,648,18,0,31064
REGISTER OF WILLS,Sandy  SNYDER,Derry Township--5th Precinct,123,3,0,0,126,30398,648,18,0,31064
REGISTER OF WILLS,Sandy  SNYDER,Derry Township--6th Precinct,155,1,1,0,157,30398,648,18,0,31064
REGISTER OF WILLS,Sandy  SNYDER,Derry Township--7th Precinct,347,16,0,0,363,30398,648,18,0,31064
REGISTER OF WILLS,Sandy  SNYDER,Derry Township--8th Precinct,168,0,0,0,168,30398,648,18,0,31064
REGISTER OF WILLS,Sandy  SNYDER,Derry Township--9th Precinct,97,3,0,0,100,30398,648,18,0,31064
REGISTER OF WILLS,Sandy  SNYDER,Derry Township--10th Precinct,230,3,0,0,233,30398,648,18,0,31064
REGISTER OF WILLS,Sandy  SNYDER,Derry Township--11th Precinct,303,7,0,0,310,30398,648,18,0,31064
REGISTER OF WILLS,Sandy  SNYDER,Derry Township--12th Precinct,174,2,0,0,176,30398,648,18,0,31064
REGISTER OF WILLS,Sandy  SNYDER,Derry Township--13th Precinct,241,7,0,0,248,30398,648,18,0,31064
REGISTER OF WILLS,Sandy  SNYDER,Derry Township--14th Precinct,169,5,0,0,174,30398,648,18,0,31064
REGISTER OF WILLS,Sandy  SNYDER,Derry Township--15th Precinct,305,5,1,0,311,30398,648,18,0,31064
REGISTER OF WILLS,Sandy  SNYDER,East Hanover Township--1st Precinct,323,9,0,0,332,30398,648,18,0,31064
REGISTER OF WILLS,Sandy  SNYDER,East Hanover Township--2nd Precinct,367,5,0,0,372,30398,648,18,0,31064
REGISTER OF WILLS,Sandy  SNYDER,Halifax Twp--1st Precinct,254,3,0,0,257,30398,648,18,0,31064
REGISTER OF WILLS,Sandy  SNYDER,Halifax Twp--2nd Precinct,315,12,0,0,327,30398,648,18,0,31064
REGISTER OF WILLS,Sandy  SNYDER,Jackson Township,220,1,0,0,221,30398,648,18,0,31064
REGISTER OF WILLS,Sandy  SNYDER,Jefferson Township,60,0,0,0,60,30398,648,18,0,31064
REGISTER OF WILLS,Sandy  SNYDER,Londonderry Twp--1st Precinct,276,0,0,0,276,30398,648,18,0,31064
REGISTER OF WILLS,Sandy  SNYDER,Londonderry Twp--2nd Precinct,263,4,0,0,267,30398,648,18,0,31064
REGISTER OF WILLS,Sandy  SNYDER,Londonderry Twp--3rd Precinct,120,1,0,0,121,30398,648,18,0,31064
REGISTER OF WILLS,Sandy  SNYDER,Lower Paxton Twp--1st Precinct,201,2,0,0,203,30398,648,18,0,31064
REGISTER OF WILLS,Sandy  SNYDER,Lower Paxton Twp--2nd Precinct,209,8,0,0,217,30398,648,18,0,31064
REGISTER OF WILLS,Sandy  SNYDER,Lower Paxton Twp--3rd precinct,403,11,0,0,414,30398,648,18,0,31064
REGISTER OF WILLS,Sandy  SNYDER,Lower Paxton Twp--4th Precinct,292,4,0,0,296,30398,648,18,0,31064
REGISTER OF WILLS,Sandy  SNYDER,Lower Paxton Twp--5th Precinct,228,4,1,0,233,30398,648,18,0,31064
REGISTER OF WILLS,Sandy  SNYDER,Lower Paxton Twp--6th Precinct,165,4,0,0,169,30398,648,18,0,31064
REGISTER OF WILLS,Sandy  SNYDER,Lower Paxton Twp--7th Precinct,340,7,0,0,347,30398,648,18,0,31064
REGISTER OF WILLS,Sandy  SNYDER,Lower Paxton Twp--8th Precinct,155,2,0,0,157,30398,648,18,0,31064
REGISTER OF WILLS,Sandy  SNYDER,Lower Paxton Twp--9th Precinct,209,3,0,0,212,30398,648,18,0,31064
REGISTER OF WILLS,Sandy  SNYDER,Lower Paxton Twp--10th Precinct,115,3,0,0,118,30398,648,18,0,31064
REGISTER OF WILLS,Sandy  SNYDER,Lower Paxton Twp--11th Precinct,193,2,1,0,196,30398,648,18,0,31064
REGISTER OF WILLS,Sandy  SNYDER,Lower Paxton Twp--12th Precinct,302,8,1,0,311,30398,648,18,0,31064
REGISTER OF WILLS,Sandy  SNYDER,Lower Paxton Twp--13th Precinct,269,5,0,0,274,30398,648,18,0,31064
REGISTER OF WILLS,Sandy  SNYDER,Lower Paxton Twp--14th Precinct,154,3,3,0,160,30398,648,18,0,31064
REGISTER OF WILLS,Sandy  SNYDER,Lower Paxton Twp--15th Precinct,243,3,0,0,246,30398,648,18,0,31064
REGISTER OF WILLS,Sandy  SNYDER,Lower Paxton Twp--16th Precinct,438,10,0,0,448,30398,648,18,0,31064
REGISTER OF WILLS,Sandy  SNYDER,Lower Paxton Twp--17th Precinct,195,7,0,0,202,30398,648,18,0,31064
REGISTER OF WILLS,Sandy  SNYDER,Lower Paxton Twp--18th Precinct,166,2,0,0,168,30398,648,18,0,31064
REGISTER OF WILLS,Sandy  SNYDER,Lower Paxton Twp--19th Precinct,335,14,0,0,349,30398,648,18,0,31064
REGISTER OF WILLS,Sandy  SNYDER,Lower Paxton Twp--20th Precinct,268,5,0,0,273,30398,648,18,0,31064
REGISTER OF WILLS,Sandy  SNYDER,Lower Paxton Twp--21st Precinct,329,8,0,0,337,30398,648,18,0,31064
REGISTER OF WILLS,Sandy  SNYDER,Lower Paxton Twp--22nd Precinct,287,5,0,0,292,30398,648,18,0,31064
REGISTER OF WILLS,Sandy  SNYDER,Lower Paxton Twp--23rd Precinct,265,3,0,0,268,30398,648,18,0,31064
REGISTER OF WILLS,Sandy  SNYDER,Lower Paxton Twp--24th Precinct,264,6,0,0,270,30398,648,18,0,31064
REGISTER OF WILLS,Sandy  SNYDER,Lower Paxton Twp--25th Precinct,160,4,0,0,164,30398,648,18,0,31064
REGISTER OF WILLS,Sandy  SNYDER,Lower Paxton Twp--26th Precinct,264,7,0,0,271,30398,648,18,0,31064
REGISTER OF WILLS,Sandy  SNYDER,Lower Paxton Twp--27th Precinct,223,2,0,0,225,30398,648,18,0,31064
REGISTER OF WILLS,Sandy  SNYDER,Lower Swatara Twp--1st Precinct,334,2,0,0,336,30398,648,18,0,31064
REGISTER OF WILLS,Sandy  SNYDER,Lower Swatara Twp--2nd Precinct,277,8,0,0,285,30398,648,18,0,31064
REGISTER OF WILLS,Sandy  SNYDER,Lower Swatara Twp--3rd Precinct,242,26,0,0,268,30398,648,18,0,31064
REGISTER OF WILLS,Sandy  SNYDER,Lower Swatara Twp--4th Precinct,236,1,0,0,237,30398,648,18,0,31064
REGISTER OF WILLS,Sandy  SNYDER,Lykens Township,96,0,0,0,96,30398,648,18,0,31064
REGISTER OF WILLS,Sandy  SNYDER,Middle Paxton Twp--1st Precinct,322,0,0,0,322,30398,648,18,0,31064
REGISTER OF WILLS,Sandy  SNYDER,Middle Paxton Twp--2nd Precinct,253,1,0,0,254,30398,648,18,0,31064
REGISTER OF WILLS,Sandy  SNYDER,Middle Paxton Twp--3rd Precinct,359,2,0,0,361,30398,648,18,0,31064
REGISTER OF WILLS,Sandy  SNYDER,Mifflin Township,81,0,0,0,81,30398,648,18,0,31064
REGISTER OF WILLS,Sandy  SNYDER,Reed Township,43,0,0,0,43,30398,648,18,0,31064
REGISTER OF WILLS,Sandy  SNYDER,Rush Township,36,0,0,0,36,30398,648,18,0,31064
REGISTER OF WILLS,Sandy  SNYDER,South Hanover Twp--1st Precinct,268,5,0,0,273,30398,648,18,0,31064
REGISTER OF WILLS,Sandy  SNYDER,South Hanover Twp--2nd Precinct,361,8,0,0,369,30398,648,18,0,31064
REGISTER OF WILLS,Sandy  SNYDER,South Hanover Twp--3rd Precinct,223,2,0,0,225,30398,648,18,0,31064
REGISTER OF WILLS,Sandy  SNYDER,Susquehanna Twp--1st Ward,375,15,0,0,390,30398,648,18,0,31064
REGISTER OF WILLS,Sandy  SNYDER,Susquehanna Twp--2nd Ward,574,23,0,0,597,30398,648,18,0,31064
REGISTER OF WILLS,Sandy  SNYDER,Susquehanna Twp--3rd Ward,209,0,0,0,209,30398,648,18,0,31064
REGISTER OF WILLS,Sandy  SNYDER,Susquehanna Twp--4th Ward,256,5,0,0,261,30398,648,18,0,31064
REGISTER OF WILLS,Sandy  SNYDER,Susquehanna Twp--5th Ward,300,6,0,0,306,30398,648,18,0,31064
REGISTER OF WILLS,Sandy  SNYDER,Susquehanna Twp--6th Ward,352,8,0,0,360,30398,648,18,0,31064
REGISTER OF WILLS,Sandy  SNYDER,Susquehanna Twp--7th Ward,165,0,0,0,165,30398,648,18,0,31064
REGISTER OF WILLS,Sandy  SNYDER,Susquehanna Twp--8th Ward,456,17,0,0,473,30398,648,18,0,31064
REGISTER OF WILLS,Sandy  SNYDER,Susquehanna Twp--9th Ward,306,4,0,0,310,30398,648,18,0,31064
REGISTER OF WILLS,Sandy  SNYDER,Swatara Township--1st Ward,281,3,0,0,284,30398,648,18,0,31064
REGISTER OF WILLS,Sandy  SNYDER,Swatara Township--2nd Ward,159,12,0,0,171,30398,648,18,0,31064
REGISTER OF WILLS,Sandy  SNYDER,Swatara Township--3rd Ward,194,6,0,0,200,30398,648,18,0,31064
REGISTER OF WILLS,Sandy  SNYDER,Swatara Township--4th Ward,290,8,0,0,298,30398,648,18,0,31064
REGISTER OF WILLS,Sandy  SNYDER,Swatara Township--5th Ward,423,4,0,0,427,30398,648,18,0,31064
REGISTER OF WILLS,Sandy  SNYDER,Swatara Township--6th Ward,371,2,1,0,374,30398,648,18,0,31064
REGISTER OF WILLS,Sandy  SNYDER,Swatara Township--7th Ward,372,9,0,0,381,30398,648,18,0,31064
REGISTER OF WILLS,Sandy  SNYDER,Swatara Township--8th Ward,432,5,1,0,438,30398,648,18,0,31064
REGISTER OF WILLS,Sandy  SNYDER,Swatara Township--9th Ward,173,9,0,0,182,30398,648,18,0,31064
REGISTER OF WILLS,Sandy  SNYDER,Upper Paxton Twp--1st Precinct,285,3,0,0,288,30398,648,18,0,31064
REGISTER OF WILLS,Sandy  SNYDER,Upper Paxton Twp--2nd Precinct,175,2,0,0,177,30398,648,18,0,31064
REGISTER OF WILLS,Sandy  SNYDER,Washington Township,261,7,0,0,268,30398,648,18,0,31064
REGISTER OF WILLS,Sandy  SNYDER,Wayne Township,242,0,1,0,243,30398,648,18,0,31064
REGISTER OF WILLS,Sandy  SNYDER,West Hanover Twp--1st Precinct,294,4,0,0,298,30398,648,18,0,31064
REGISTER OF WILLS,Sandy  SNYDER,West Hanover Twp--2nd Precinct,276,7,1,0,284,30398,648,18,0,31064
REGISTER OF WILLS,Sandy  SNYDER,West Hanover Twp--3rd Precinct,633,15,1,0,649,30398,648,18,0,31064
REGISTER OF WILLS,Sandy  SNYDER,West Hanover Twp--4th Precinct,369,2,0,0,371,30398,648,18,0,31064
REGISTER OF WILLS,Sandy  SNYDER,Wiconisco Twp--1st Precinct,74,1,0,0,75,30398,648,18,0,31064
REGISTER OF WILLS,Sandy  SNYDER,Wiconisco Twp--2nd Precinct,56,1,0,0,57,30398,648,18,0,31064
REGISTER OF WILLS,Sandy  SNYDER,Williams Twp,136,0,0,0,136,30398,648,18,0,31064
REGISTER OF WILLS,Write In  ,"City--1st Ward, 1st Precinct",0,0,0,0,0,41,0,0,0,41
REGISTER OF WILLS,Write In  ,"City--1st Ward, 2nd Precinct",0,0,0,0,0,41,0,0,0,41
REGISTER OF WILLS,Write In  ,"City--1st Ward, 3rd Precinct",0,0,0,0,0,41,0,0,0,41
REGISTER OF WILLS,Write In  ,"City--2nd Ward, 1st Precinct",0,0,0,0,0,41,0,0,0,41
REGISTER OF WILLS,Write In  ,"City--2nd Ward, 2nd Precinct",0,0,0,0,0,41,0,0,0,41
REGISTER OF WILLS,Write In  ,City--3rd Ward,0,0,0,0,0,41,0,0,0,41
REGISTER OF WILLS,Write In  ,City--4th Ward,0,0,0,0,0,41,0,0,0,41
REGISTER OF WILLS,Write In  ,City--5th Ward,1,0,0,0,1,41,0,0,0,41
REGISTER OF WILLS,Write In  ,City--6th Ward,0,0,0,0,0,41,0,0,0,41
REGISTER OF WILLS,Write In  ,"City--7th Ward, 1st Precinct",0,0,0,0,0,41,0,0,0,41
REGISTER OF WILLS,Write In  ,"City--7th Ward, 2nd Precinct",0,0,0,0,0,41,0,0,0,41
REGISTER OF WILLS,Write In  ,City--8th Ward,1,0,0,0,1,41,0,0,0,41
REGISTER OF WILLS,Write In  ,"City--9th Ward, 1st Precinct",0,0,0,0,0,41,0,0,0,41
REGISTER OF WILLS,Write In  ,"City--9th Ward, 2nd Precinct",0,0,0,0,0,41,0,0,0,41
REGISTER OF WILLS,Write In  ,"City--9th Ward, 3rd Precinct",0,0,0,0,0,41,0,0,0,41
REGISTER OF WILLS,Write In  ,"City--9th Ward, 4th Precinct",0,0,0,0,0,41,0,0,0,41
REGISTER OF WILLS,Write In  ,"City--9th Ward, 5th Precinct",0,0,0,0,0,41,0,0,0,41
REGISTER OF WILLS,Write In  ,"City--10th Ward, 1st Precinct",0,0,0,0,0,41,0,0,0,41
REGISTER OF WILLS,Write In  ,"City--10th Ward, 2nd Precinct",0,0,0,0,0,41,0,0,0,41
REGISTER OF WILLS,Write In  ,"City--10th Ward, 3rd Precinct",1,0,0,0,1,41,0,0,0,41
REGISTER OF WILLS,Write In  ,"City--10th Ward, 4th Precinct",1,0,0,0,1,41,0,0,0,41
REGISTER OF WILLS,Write In  ,City--11th Ward,0,0,0,0,0,41,0,0,0,41
REGISTER OF WILLS,Write In  ,City--12th Ward,0,0,0,0,0,41,0,0,0,41
REGISTER OF WILLS,Write In  ,"City--13th Ward, 1st Precinct",2,0,0,0,2,41,0,0,0,41
REGISTER OF WILLS,Write In  ,"City--13th Ward, 2nd Precinct",0,0,0,0,0,41,0,0,0,41
REGISTER OF WILLS,Write In  ,"City--13th Ward, 3rd Precinct",0,0,0,0,0,41,0,0,0,41
REGISTER OF WILLS,Write In  ,City--14th Ward,0,0,0,0,0,41,0,0,0,41
REGISTER OF WILLS,Write In  ,City--15th Ward,0,0,0,0,0,41,0,0,0,41
REGISTER OF WILLS,Write In  ,Berrysburg Borough,0,0,0,0,0,41,0,0,0,41
REGISTER OF WILLS,Write In  ,Dauphin Borough,0,0,0,0,0,41,0,0,0,41
REGISTER OF WILLS,Write In  ,Elizabethville Borough,0,0,0,0,0,41,0,0,0,41
REGISTER OF WILLS,Write In  ,Gratz Borough,0,0,0,0,0,41,0,0,0,41
REGISTER OF WILLS,Write In  ,Halifax Borough,1,0,0,0,1,41,0,0,0,41
REGISTER OF WILLS,Write In  ,Highspire--1st Precinct,0,0,0,0,0,41,0,0,0,41
REGISTER OF WILLS,Write In  ,Highspire--2nd Precinct,0,0,0,0,0,41,0,0,0,41
REGISTER OF WILLS,Write In  ,Hummelstown--1st Precinct,0,0,0,0,0,41,0,0,0,41
REGISTER OF WILLS,Write In  ,Hummelstown--2nd Precinct,0,0,0,0,0,41,0,0,0,41
REGISTER OF WILLS,Write In  ,Lykens Borough--1st Ward,0,0,0,0,0,41,0,0,0,41
REGISTER OF WILLS,Write In  ,Lykens Borough--2nd Ward,0,0,0,0,0,41,0,0,0,41
REGISTER OF WILLS,Write In  ,"Middletown--1st Ward, 1st Precinct",0,0,0,0,0,41,0,0,0,41
REGISTER OF WILLS,Write In  ,"Middletown--1st Ward, 2nd Precinct",0,0,0,0,0,41,0,0,0,41
REGISTER OF WILLS,Write In  ,"Middletown--2nd Ward, 1st Precinct",0,0,0,0,0,41,0,0,0,41
REGISTER OF WILLS,Write In  ,"Middletown--2nd Ward, 2nd Precinct",0,0,0,0,0,41,0,0,0,41
REGISTER OF WILLS,Write In  ,"Middletown--3rd Ward, 1st Precinct",0,0,0,0,0,41,0,0,0,41
REGISTER OF WILLS,Write In  ,"Middletown--3rd Ward, 2nd Precinct",0,0,0,0,0,41,0,0,0,41
REGISTER OF WILLS,Write In  ,Millersburg--1st Ward,0,0,0,0,0,41,0,0,0,41
REGISTER OF WILLS,Write In  ,Millersburg--2nd Ward,1,0,0,0,1,41,0,0,0,41
REGISTER OF WILLS,Write In  ,Paxtang Borough,0,0,0,0,0,41,0,0,0,41
REGISTER OF WILLS,Write In  ,Penbrook Borough--1st Ward,0,0,0,0,0,41,0,0,0,41
REGISTER OF WILLS,Write In  ,Penbrook Borough--2nd Ward,0,0,0,0,0,41,0,0,0,41
REGISTER OF WILLS,Write In  ,Penbrook Borough--3rd Ward,0,0,0,0,0,41,0,0,0,41
REGISTER OF WILLS,Write In  ,Penbrook Borough--4th Ward,1,0,0,0,1,41,0,0,0,41
REGISTER OF WILLS,Write In  ,Royalton Borough--1st Ward,0,0,0,0,0,41,0,0,0,41
REGISTER OF WILLS,Write In  ,Royalton Borough--2nd Ward,0,0,0,0,0,41,0,0,0,41
REGISTER OF WILLS,Write In  ,Steelton--1st Ward,0,0,0,0,0,41,0,0,0,41
REGISTER OF WILLS,Write In  ,"Steelton--2nd Ward, 1st Precinct",0,0,0,0,0,41,0,0,0,41
REGISTER OF WILLS,Write In  ,"Steelton--2nd Ward, 2nd Precinct",0,0,0,0,0,41,0,0,0,41
REGISTER OF WILLS,Write In  ,"Steelton--3rd Ward, 1st Precinct",0,0,0,0,0,41,0,0,0,41
REGISTER OF WILLS,Write In  ,"Steelton--3rd Ward, 2nd Precinct",2,0,0,0,2,41,0,0,0,41
REGISTER OF WILLS,Write In  ,Steelton--4th Ward,0,0,0,0,0,41,0,0,0,41
REGISTER OF WILLS,Write In  ,Pillow Borough,0,0,0,0,0,41,0,0,0,41
REGISTER OF WILLS,Write In  ,Williamstown--1st Ward,0,0,0,0,0,41,0,0,0,41
REGISTER OF WILLS,Write In  ,Williamstown--2nd Ward,0,0,0,0,0,41,0,0,0,41
REGISTER OF WILLS,Write In  ,Conewago Twp--1st Precinct,0,0,0,0,0,41,0,0,0,41
REGISTER OF WILLS,Write In  ,Conewago Twp--2nd Precinct,1,0,0,0,1,41,0,0,0,41
REGISTER OF WILLS,Write In  ,Derry Township--1st Precinct,0,0,0,0,0,41,0,0,0,41
REGISTER OF WILLS,Write In  ,Derry Township--2nd Precinct,0,0,0,0,0,41,0,0,0,41
REGISTER OF WILLS,Write In  ,Derry Township--3rd Precinct,0,0,0,0,0,41,0,0,0,41
REGISTER OF WILLS,Write In  ,Derry Township--4th Precinct,1,0,0,0,1,41,0,0,0,41
REGISTER OF WILLS,Write In  ,Derry Township--5th Precinct,0,0,0,0,0,41,0,0,0,41
REGISTER OF WILLS,Write In  ,Derry Township--6th Precinct,0,0,0,0,0,41,0,0,0,41
REGISTER OF WILLS,Write In  ,Derry Township--7th Precinct,0,0,0,0,0,41,0,0,0,41
REGISTER OF WILLS,Write In  ,Derry Township--8th Precinct,0,0,0,0,0,41,0,0,0,41
REGISTER OF WILLS,Write In  ,Derry Township--9th Precinct,0,0,0,0,0,41,0,0,0,41
REGISTER OF WILLS,Write In  ,Derry Township--10th Precinct,0,0,0,0,0,41,0,0,0,41
REGISTER OF WILLS,Write In  ,Derry Township--11th Precinct,0,0,0,0,0,41,0,0,0,41
REGISTER OF WILLS,Write In  ,Derry Township--12th Precinct,0,0,0,0,0,41,0,0,0,41
REGISTER OF WILLS,Write In  ,Derry Township--13th Precinct,0,0,0,0,0,41,0,0,0,41
REGISTER OF WILLS,Write In  ,Derry Township--14th Precinct,0,0,0,0,0,41,0,0,0,41
REGISTER OF WILLS,Write In  ,Derry Township--15th Precinct,2,0,0,0,2,41,0,0,0,41
REGISTER OF WILLS,Write In  ,East Hanover Township--1st Precinct,0,0,0,0,0,41,0,0,0,41
REGISTER OF WILLS,Write In  ,East Hanover Township--2nd Precinct,0,0,0,0,0,41,0,0,0,41
REGISTER OF WILLS,Write In  ,Halifax Twp--1st Precinct,0,0,0,0,0,41,0,0,0,41
REGISTER OF WILLS,Write In  ,Halifax Twp--2nd Precinct,0,0,0,0,0,41,0,0,0,41
REGISTER OF WILLS,Write In  ,Jackson Township,0,0,0,0,0,41,0,0,0,41
REGISTER OF WILLS,Write In  ,Jefferson Township,0,0,0,0,0,41,0,0,0,41
REGISTER OF WILLS,Write In  ,Londonderry Twp--1st Precinct,0,0,0,0,0,41,0,0,0,41
REGISTER OF WILLS,Write In  ,Londonderry Twp--2nd Precinct,1,0,0,0,1,41,0,0,0,41
REGISTER OF WILLS,Write In  ,Londonderry Twp--3rd Precinct,0,0,0,0,0,41,0,0,0,41
REGISTER OF WILLS,Write In  ,Lower Paxton Twp--1st Precinct,0,0,0,0,0,41,0,0,0,41
REGISTER OF WILLS,Write In  ,Lower Paxton Twp--2nd Precinct,1,0,0,0,1,41,0,0,0,41
REGISTER OF WILLS,Write In  ,Lower Paxton Twp--3rd precinct,0,0,0,0,0,41,0,0,0,41
REGISTER OF WILLS,Write In  ,Lower Paxton Twp--4th Precinct,0,0,0,0,0,41,0,0,0,41
REGISTER OF WILLS,Write In  ,Lower Paxton Twp--5th Precinct,1,0,0,0,1,41,0,0,0,41
REGISTER OF WILLS,Write In  ,Lower Paxton Twp--6th Precinct,0,0,0,0,0,41,0,0,0,41
REGISTER OF WILLS,Write In  ,Lower Paxton Twp--7th Precinct,2,0,0,0,2,41,0,0,0,41
REGISTER OF WILLS,Write In  ,Lower Paxton Twp--8th Precinct,0,0,0,0,0,41,0,0,0,41
REGISTER OF WILLS,Write In  ,Lower Paxton Twp--9th Precinct,1,0,0,0,1,41,0,0,0,41
REGISTER OF WILLS,Write In  ,Lower Paxton Twp--10th Precinct,1,0,0,0,1,41,0,0,0,41
REGISTER OF WILLS,Write In  ,Lower Paxton Twp--11th Precinct,0,0,0,0,0,41,0,0,0,41
REGISTER OF WILLS,Write In  ,Lower Paxton Twp--12th Precinct,2,0,0,0,2,41,0,0,0,41
REGISTER OF WILLS,Write In  ,Lower Paxton Twp--13th Precinct,1,0,0,0,1,41,0,0,0,41
REGISTER OF WILLS,Write In  ,Lower Paxton Twp--14th Precinct,0,0,0,0,0,41,0,0,0,41
REGISTER OF WILLS,Write In  ,Lower Paxton Twp--15th Precinct,0,0,0,0,0,41,0,0,0,41
REGISTER OF WILLS,Write In  ,Lower Paxton Twp--16th Precinct,0,0,0,0,0,41,0,0,0,41
REGISTER OF WILLS,Write In  ,Lower Paxton Twp--17th Precinct,1,0,0,0,1,41,0,0,0,41
REGISTER OF WILLS,Write In  ,Lower Paxton Twp--18th Precinct,0,0,0,0,0,41,0,0,0,41
REGISTER OF WILLS,Write In  ,Lower Paxton Twp--19th Precinct,0,0,0,0,0,41,0,0,0,41
REGISTER OF WILLS,Write In  ,Lower Paxton Twp--20th Precinct,3,0,0,0,3,41,0,0,0,41
REGISTER OF WILLS,Write In  ,Lower Paxton Twp--21st Precinct,0,0,0,0,0,41,0,0,0,41
REGISTER OF WILLS,Write In  ,Lower Paxton Twp--22nd Precinct,1,0,0,0,1,41,0,0,0,41
REGISTER OF WILLS,Write In  ,Lower Paxton Twp--23rd Precinct,0,0,0,0,0,41,0,0,0,41
REGISTER OF WILLS,Write In  ,Lower Paxton Twp--24th Precinct,0,0,0,0,0,41,0,0,0,41
REGISTER OF WILLS,Write In  ,Lower Paxton Twp--25th Precinct,0,0,0,0,0,41,0,0,0,41
REGISTER OF WILLS,Write In  ,Lower Paxton Twp--26th Precinct,0,0,0,0,0,41,0,0,0,41
REGISTER OF WILLS,Write In  ,Lower Paxton Twp--27th Precinct,0,0,0,0,0,41,0,0,0,41
REGISTER OF WILLS,Write In  ,Lower Swatara Twp--1st Precinct,1,0,0,0,1,41,0,0,0,41
REGISTER OF WILLS,Write In  ,Lower Swatara Twp--2nd Precinct,1,0,0,0,1,41,0,0,0,41
REGISTER OF WILLS,Write In  ,Lower Swatara Twp--3rd Precinct,0,0,0,0,0,41,0,0,0,41
REGISTER OF WILLS,Write In  ,Lower Swatara Twp--4th Precinct,0,0,0,0,0,41,0,0,0,41
REGISTER OF WILLS,Write In  ,Lykens Township,0,0,0,0,0,41,0,0,0,41
REGISTER OF WILLS,Write In  ,Middle Paxton Twp--1st Precinct,1,0,0,0,1,41,0,0,0,41
REGISTER OF WILLS,Write In  ,Middle Paxton Twp--2nd Precinct,1,0,0,0,1,41,0,0,0,41
REGISTER OF WILLS,Write In  ,Middle Paxton Twp--3rd Precinct,0,0,0,0,0,41,0,0,0,41
REGISTER OF WILLS,Write In  ,Mifflin Township,0,0,0,0,0,41,0,0,0,41
REGISTER OF WILLS,Write In  ,Reed Township,0,0,0,0,0,41,0,0,0,41
REGISTER OF WILLS,Write In  ,Rush Township,0,0,0,0,0,41,0,0,0,41
REGISTER OF WILLS,Write In  ,South Hanover Twp--1st Precinct,0,0,0,0,0,41,0,0,0,41
REGISTER OF WILLS,Write In  ,South Hanover Twp--2nd Precinct,0,0,0,0,0,41,0,0,0,41
REGISTER OF WILLS,Write In  ,South Hanover Twp--3rd Precinct,0,0,0,0,0,41,0,0,0,41
REGISTER OF WILLS,Write In  ,Susquehanna Twp--1st Ward,1,0,0,0,1,41,0,0,0,41
REGISTER OF WILLS,Write In  ,Susquehanna Twp--2nd Ward,1,0,0,0,1,41,0,0,0,41
REGISTER OF WILLS,Write In  ,Susquehanna Twp--3rd Ward,1,0,0,0,1,41,0,0,0,41
REGISTER OF WILLS,Write In  ,Susquehanna Twp--4th Ward,1,0,0,0,1,41,0,0,0,41
REGISTER OF WILLS,Write In  ,Susquehanna Twp--5th Ward,0,0,0,0,0,41,0,0,0,41
REGISTER OF WILLS,Write In  ,Susquehanna Twp--6th Ward,0,0,0,0,0,41,0,0,0,41
REGISTER OF WILLS,Write In  ,Susquehanna Twp--7th Ward,0,0,0,0,0,41,0,0,0,41
REGISTER OF WILLS,Write In  ,Susquehanna Twp--8th Ward,0,0,0,0,0,41,0,0,0,41
REGISTER OF WILLS,Write In  ,Susquehanna Twp--9th Ward,1,0,0,0,1,41,0,0,0,41
REGISTER OF WILLS,Write In  ,Swatara Township--1st Ward,0,0,0,0,0,41,0,0,0,41
REGISTER OF WILLS,Write In  ,Swatara Township--2nd Ward,1,0,0,0,1,41,0,0,0,41
REGISTER OF WILLS,Write In  ,Swatara Township--3rd Ward,0,0,0,0,0,41,0,0,0,41
REGISTER OF WILLS,Write In  ,Swatara Township--4th Ward,1,0,0,0,1,41,0,0,0,41
REGISTER OF WILLS,Write In  ,Swatara Township--5th Ward,0,0,0,0,0,41,0,0,0,41
REGISTER OF WILLS,Write In  ,Swatara Township--6th Ward,0,0,0,0,0,41,0,0,0,41
REGISTER OF WILLS,Write In  ,Swatara Township--7th Ward,0,0,0,0,0,41,0,0,0,41
REGISTER OF WILLS,Write In  ,Swatara Township--8th Ward,0,0,0,0,0,41,0,0,0,41
REGISTER OF WILLS,Write In  ,Swatara Township--9th Ward,0,0,0,0,0,41,0,0,0,41
REGISTER OF WILLS,Write In  ,Upper Paxton Twp--1st Precinct,0,0,0,0,0,41,0,0,0,41
REGISTER OF WILLS,Write In  ,Upper Paxton Twp--2nd Precinct,0,0,0,0,0,41,0,0,0,41
REGISTER OF WILLS,Write In  ,Washington Township,0,0,0,0,0,41,0,0,0,41
REGISTER OF WILLS,Write In  ,Wayne Township,0,0,0,0,0,41,0,0,0,41
REGISTER OF WILLS,Write In  ,West Hanover Twp--1st Precinct,0,0,0,0,0,41,0,0,0,41
REGISTER OF WILLS,Write In  ,West Hanover Twp--2nd Precinct,0,0,0,0,0,41,0,0,0,41
REGISTER OF WILLS,Write In  ,West Hanover Twp--3rd Precinct,0,0,0,0,0,41,0,0,0,41
REGISTER OF WILLS,Write In  ,West Hanover Twp--4th Precinct,0,0,0,0,0,41,0,0,0,41
REGISTER OF WILLS,Write In  ,Wiconisco Twp--1st Precinct,0,0,0,0,0,41,0,0,0,41
REGISTER OF WILLS,Write In  ,Wiconisco Twp--2nd Precinct,0,0,0,0,0,41,0,0,0,41
REGISTER OF WILLS,Write In  ,Williams Twp,0,0,0,0,0,41,0,0,0,41
SAYLOR RETENTION,  SAYLOR - NO,"City--1st Ward, 1st Precinct",47,2,0,0,49,19202,292,7,0,19501
SAYLOR RETENTION,  SAYLOR - NO,"City--1st Ward, 2nd Precinct",68,0,0,0,68,19202,292,7,0,19501
SAYLOR RETENTION,  SAYLOR - NO,"City--1st Ward, 3rd Precinct",30,0,0,0,30,19202,292,7,0,19501
SAYLOR RETENTION,  SAYLOR - NO,"City--2nd Ward, 1st Precinct",23,0,0,0,23,19202,292,7,0,19501
SAYLOR RETENTION,  SAYLOR - NO,"City--2nd Ward, 2nd Precinct",28,0,0,0,28,19202,292,7,0,19501
SAYLOR RETENTION,  SAYLOR - NO,City--3rd Ward,26,0,0,0,26,19202,292,7,0,19501
SAYLOR RETENTION,  SAYLOR - NO,City--4th Ward,78,1,0,0,79,19202,292,7,0,19501
SAYLOR RETENTION,  SAYLOR - NO,City--5th Ward,158,4,0,0,162,19202,292,7,0,19501
SAYLOR RETENTION,  SAYLOR - NO,City--6th Ward,90,1,0,0,91,19202,292,7,0,19501
SAYLOR RETENTION,  SAYLOR - NO,"City--7th Ward, 1st Precinct",29,1,0,0,30,19202,292,7,0,19501
SAYLOR RETENTION,  SAYLOR - NO,"City--7th Ward, 2nd Precinct",59,2,0,0,61,19202,292,7,0,19501
SAYLOR RETENTION,  SAYLOR - NO,City--8th Ward,60,1,0,0,61,19202,292,7,0,19501
SAYLOR RETENTION,  SAYLOR - NO,"City--9th Ward, 1st Precinct",26,1,0,0,27,19202,292,7,0,19501
SAYLOR RETENTION,  SAYLOR - NO,"City--9th Ward, 2nd Precinct",31,0,0,0,31,19202,292,7,0,19501
SAYLOR RETENTION,  SAYLOR - NO,"City--9th Ward, 3rd Precinct",94,0,0,0,94,19202,292,7,0,19501
SAYLOR RETENTION,  SAYLOR - NO,"City--9th Ward, 4th Precinct",108,3,0,0,111,19202,292,7,0,19501
SAYLOR RETENTION,  SAYLOR - NO,"City--9th Ward, 5th Precinct",55,3,0,0,58,19202,292,7,0,19501
SAYLOR RETENTION,  SAYLOR - NO,"City--10th Ward, 1st Precinct",130,0,0,0,130,19202,292,7,0,19501
SAYLOR RETENTION,  SAYLOR - NO,"City--10th Ward, 2nd Precinct",42,0,0,0,42,19202,292,7,0,19501
SAYLOR RETENTION,  SAYLOR - NO,"City--10th Ward, 3rd Precinct",53,0,0,0,53,19202,292,7,0,19501
SAYLOR RETENTION,  SAYLOR - NO,"City--10th Ward, 4th Precinct",89,1,0,0,90,19202,292,7,0,19501
SAYLOR RETENTION,  SAYLOR - NO,City--11th Ward,53,1,0,0,54,19202,292,7,0,19501
SAYLOR RETENTION,  SAYLOR - NO,City--12th Ward,130,5,0,0,135,19202,292,7,0,19501
SAYLOR RETENTION,  SAYLOR - NO,"City--13th Ward, 1st Precinct",69,0,0,0,69,19202,292,7,0,19501
SAYLOR RETENTION,  SAYLOR - NO,"City--13th Ward, 2nd Precinct",84,3,0,0,87,19202,292,7,0,19501
SAYLOR RETENTION,  SAYLOR - NO,"City--13th Ward, 3rd Precinct",93,2,0,0,95,19202,292,7,0,19501
SAYLOR RETENTION,  SAYLOR - NO,City--14th Ward,168,2,0,0,170,19202,292,7,0,19501
SAYLOR RETENTION,  SAYLOR - NO,City--15th Ward,38,1,0,0,39,19202,292,7,0,19501
SAYLOR RETENTION,  SAYLOR - NO,Berrysburg Borough,37,0,0,0,37,19202,292,7,0,19501
SAYLOR RETENTION,  SAYLOR - NO,Dauphin Borough,113,0,0,0,113,19202,292,7,0,19501
SAYLOR RETENTION,  SAYLOR - NO,Elizabethville Borough,105,2,0,0,107,19202,292,7,0,19501
SAYLOR RETENTION,  SAYLOR - NO,Gratz Borough,36,0,0,0,36,19202,292,7,0,19501
SAYLOR RETENTION,  SAYLOR - NO,Halifax Borough,56,0,0,0,56,19202,292,7,0,19501
SAYLOR RETENTION,  SAYLOR - NO,Highspire--1st Precinct,83,2,0,0,85,19202,292,7,0,19501
SAYLOR RETENTION,  SAYLOR - NO,Highspire--2nd Precinct,93,0,0,0,93,19202,292,7,0,19501
SAYLOR RETENTION,  SAYLOR - NO,Hummelstown--1st Precinct,113,5,0,0,118,19202,292,7,0,19501
SAYLOR RETENTION,  SAYLOR - NO,Hummelstown--2nd Precinct,212,3,0,0,215,19202,292,7,0,19501
SAYLOR RETENTION,  SAYLOR - NO,Lykens Borough--1st Ward,40,0,0,0,40,19202,292,7,0,19501
SAYLOR RETENTION,  SAYLOR - NO,Lykens Borough--2nd Ward,69,2,0,0,71,19202,292,7,0,19501
SAYLOR RETENTION,  SAYLOR - NO,"Middletown--1st Ward, 1st Precinct",48,0,0,0,48,19202,292,7,0,19501
SAYLOR RETENTION,  SAYLOR - NO,"Middletown--1st Ward, 2nd Precinct",85,1,0,0,86,19202,292,7,0,19501
SAYLOR RETENTION,  SAYLOR - NO,"Middletown--2nd Ward, 1st Precinct",101,2,0,0,103,19202,292,7,0,19501
SAYLOR RETENTION,  SAYLOR - NO,"Middletown--2nd Ward, 2nd Precinct",84,3,0,0,87,19202,292,7,0,19501
SAYLOR RETENTION,  SAYLOR - NO,"Middletown--3rd Ward, 1st Precinct",78,1,0,0,79,19202,292,7,0,19501
SAYLOR RETENTION,  SAYLOR - NO,"Middletown--3rd Ward, 2nd Precinct",124,0,0,0,124,19202,292,7,0,19501
SAYLOR RETENTION,  SAYLOR - NO,Millersburg--1st Ward,67,0,0,0,67,19202,292,7,0,19501
SAYLOR RETENTION,  SAYLOR - NO,Millersburg--2nd Ward,96,0,0,0,96,19202,292,7,0,19501
SAYLOR RETENTION,  SAYLOR - NO,Paxtang Borough,123,1,0,0,124,19202,292,7,0,19501
SAYLOR RETENTION,  SAYLOR - NO,Penbrook Borough--1st Ward,35,0,0,0,35,19202,292,7,0,19501
SAYLOR RETENTION,  SAYLOR - NO,Penbrook Borough--2nd Ward,31,0,0,0,31,19202,292,7,0,19501
SAYLOR RETENTION,  SAYLOR - NO,Penbrook Borough--3rd Ward,50,0,0,0,50,19202,292,7,0,19501
SAYLOR RETENTION,  SAYLOR - NO,Penbrook Borough--4th Ward,69,2,0,0,71,19202,292,7,0,19501
SAYLOR RETENTION,  SAYLOR - NO,Royalton Borough--1st Ward,24,0,0,0,24,19202,292,7,0,19501
SAYLOR RETENTION,  SAYLOR - NO,Royalton Borough--2nd Ward,36,0,0,0,36,19202,292,7,0,19501
SAYLOR RETENTION,  SAYLOR - NO,Steelton--1st Ward,81,3,0,0,84,19202,292,7,0,19501
SAYLOR RETENTION,  SAYLOR - NO,"Steelton--2nd Ward, 1st Precinct",53,0,0,0,53,19202,292,7,0,19501
SAYLOR RETENTION,  SAYLOR - NO,"Steelton--2nd Ward, 2nd Precinct",49,1,0,0,50,19202,292,7,0,19501
SAYLOR RETENTION,  SAYLOR - NO,"Steelton--3rd Ward, 1st Precinct",22,0,0,0,22,19202,292,7,0,19501
SAYLOR RETENTION,  SAYLOR - NO,"Steelton--3rd Ward, 2nd Precinct",46,0,0,0,46,19202,292,7,0,19501
SAYLOR RETENTION,  SAYLOR - NO,Steelton--4th Ward,48,0,0,0,48,19202,292,7,0,19501
SAYLOR RETENTION,  SAYLOR - NO,Pillow Borough,26,0,0,0,26,19202,292,7,0,19501
SAYLOR RETENTION,  SAYLOR - NO,Williamstown--1st Ward,46,1,0,0,47,19202,292,7,0,19501
SAYLOR RETENTION,  SAYLOR - NO,Williamstown--2nd Ward,41,0,0,0,41,19202,292,7,0,19501
SAYLOR RETENTION,  SAYLOR - NO,Conewago Twp--1st Precinct,131,0,0,0,131,19202,292,7,0,19501
SAYLOR RETENTION,  SAYLOR - NO,Conewago Twp--2nd Precinct,109,4,0,0,113,19202,292,7,0,19501
SAYLOR RETENTION,  SAYLOR - NO,Derry Township--1st Precinct,180,1,0,0,181,19202,292,7,0,19501
SAYLOR RETENTION,  SAYLOR - NO,Derry Township--2nd Precinct,128,3,0,0,131,19202,292,7,0,19501
SAYLOR RETENTION,  SAYLOR - NO,Derry Township--3rd Precinct,127,2,1,0,130,19202,292,7,0,19501
SAYLOR RETENTION,  SAYLOR - NO,Derry Township--4th Precinct,91,3,1,0,95,19202,292,7,0,19501
SAYLOR RETENTION,  SAYLOR - NO,Derry Township--5th Precinct,79,3,0,0,82,19202,292,7,0,19501
SAYLOR RETENTION,  SAYLOR - NO,Derry Township--6th Precinct,100,0,1,0,101,19202,292,7,0,19501
SAYLOR RETENTION,  SAYLOR - NO,Derry Township--7th Precinct,187,2,0,0,189,19202,292,7,0,19501
SAYLOR RETENTION,  SAYLOR - NO,Derry Township--8th Precinct,96,0,0,0,96,19202,292,7,0,19501
SAYLOR RETENTION,  SAYLOR - NO,Derry Township--9th Precinct,62,3,0,0,65,19202,292,7,0,19501
SAYLOR RETENTION,  SAYLOR - NO,Derry Township--10th Precinct,138,2,0,0,140,19202,292,7,0,19501
SAYLOR RETENTION,  SAYLOR - NO,Derry Township--11th Precinct,166,5,0,0,171,19202,292,7,0,19501
SAYLOR RETENTION,  SAYLOR - NO,Derry Township--12th Precinct,104,3,0,0,107,19202,292,7,0,19501
SAYLOR RETENTION,  SAYLOR - NO,Derry Township--13th Precinct,132,1,0,0,133,19202,292,7,0,19501
SAYLOR RETENTION,  SAYLOR - NO,Derry Township--14th Precinct,92,2,0,0,94,19202,292,7,0,19501
SAYLOR RETENTION,  SAYLOR - NO,Derry Township--15th Precinct,190,4,0,0,194,19202,292,7,0,19501
SAYLOR RETENTION,  SAYLOR - NO,East Hanover Township--1st Precinct,209,3,0,0,212,19202,292,7,0,19501
SAYLOR RETENTION,  SAYLOR - NO,East Hanover Township--2nd Precinct,218,2,0,0,220,19202,292,7,0,19501
SAYLOR RETENTION,  SAYLOR - NO,Halifax Twp--1st Precinct,171,1,0,0,172,19202,292,7,0,19501
SAYLOR RETENTION,  SAYLOR - NO,Halifax Twp--2nd Precinct,160,11,0,0,171,19202,292,7,0,19501
SAYLOR RETENTION,  SAYLOR - NO,Jackson Township,148,0,0,0,148,19202,292,7,0,19501
SAYLOR RETENTION,  SAYLOR - NO,Jefferson Township,43,0,0,0,43,19202,292,7,0,19501
SAYLOR RETENTION,  SAYLOR - NO,Londonderry Twp--1st Precinct,164,0,0,0,164,19202,292,7,0,19501
SAYLOR RETENTION,  SAYLOR - NO,Londonderry Twp--2nd Precinct,163,1,0,0,164,19202,292,7,0,19501
SAYLOR RETENTION,  SAYLOR - NO,Londonderry Twp--3rd Precinct,57,0,0,0,57,19202,292,7,0,19501
SAYLOR RETENTION,  SAYLOR - NO,Lower Paxton Twp--1st Precinct,102,1,0,0,103,19202,292,7,0,19501
SAYLOR RETENTION,  SAYLOR - NO,Lower Paxton Twp--2nd Precinct,128,4,0,0,132,19202,292,7,0,19501
SAYLOR RETENTION,  SAYLOR - NO,Lower Paxton Twp--3rd precinct,220,6,0,0,226,19202,292,7,0,19501
SAYLOR RETENTION,  SAYLOR - NO,Lower Paxton Twp--4th Precinct,180,1,0,0,181,19202,292,7,0,19501
SAYLOR RETENTION,  SAYLOR - NO,Lower Paxton Twp--5th Precinct,160,4,1,0,165,19202,292,7,0,19501
SAYLOR RETENTION,  SAYLOR - NO,Lower Paxton Twp--6th Precinct,118,1,0,0,119,19202,292,7,0,19501
SAYLOR RETENTION,  SAYLOR - NO,Lower Paxton Twp--7th Precinct,181,1,0,0,182,19202,292,7,0,19501
SAYLOR RETENTION,  SAYLOR - NO,Lower Paxton Twp--8th Precinct,96,1,0,0,97,19202,292,7,0,19501
SAYLOR RETENTION,  SAYLOR - NO,Lower Paxton Twp--9th Precinct,126,3,0,0,129,19202,292,7,0,19501
SAYLOR RETENTION,  SAYLOR - NO,Lower Paxton Twp--10th Precinct,75,1,0,0,76,19202,292,7,0,19501
SAYLOR RETENTION,  SAYLOR - NO,Lower Paxton Twp--11th Precinct,118,2,0,0,120,19202,292,7,0,19501
SAYLOR RETENTION,  SAYLOR - NO,Lower Paxton Twp--12th Precinct,156,2,0,0,158,19202,292,7,0,19501
SAYLOR RETENTION,  SAYLOR - NO,Lower Paxton Twp--13th Precinct,171,3,0,0,174,19202,292,7,0,19501
SAYLOR RETENTION,  SAYLOR - NO,Lower Paxton Twp--14th Precinct,89,1,0,0,90,19202,292,7,0,19501
SAYLOR RETENTION,  SAYLOR - NO,Lower Paxton Twp--15th Precinct,146,3,0,0,149,19202,292,7,0,19501
SAYLOR RETENTION,  SAYLOR - NO,Lower Paxton Twp--16th Precinct,239,3,0,0,242,19202,292,7,0,19501
SAYLOR RETENTION,  SAYLOR - NO,Lower Paxton Twp--17th Precinct,121,2,0,0,123,19202,292,7,0,19501
SAYLOR RETENTION,  SAYLOR - NO,Lower Paxton Twp--18th Precinct,114,1,0,0,115,19202,292,7,0,19501
SAYLOR RETENTION,  SAYLOR - NO,Lower Paxton Twp--19th Precinct,202,9,0,0,211,19202,292,7,0,19501
SAYLOR RETENTION,  SAYLOR - NO,Lower Paxton Twp--20th Precinct,151,4,0,0,155,19202,292,7,0,19501
SAYLOR RETENTION,  SAYLOR - NO,Lower Paxton Twp--21st Precinct,190,7,0,0,197,19202,292,7,0,19501
SAYLOR RETENTION,  SAYLOR - NO,Lower Paxton Twp--22nd Precinct,150,5,0,0,155,19202,292,7,0,19501
SAYLOR RETENTION,  SAYLOR - NO,Lower Paxton Twp--23rd Precinct,118,1,0,0,119,19202,292,7,0,19501
SAYLOR RETENTION,  SAYLOR - NO,Lower Paxton Twp--24th Precinct,151,5,0,0,156,19202,292,7,0,19501
SAYLOR RETENTION,  SAYLOR - NO,Lower Paxton Twp--25th Precinct,119,1,0,0,120,19202,292,7,0,19501
SAYLOR RETENTION,  SAYLOR - NO,Lower Paxton Twp--26th Precinct,150,6,0,0,156,19202,292,7,0,19501
SAYLOR RETENTION,  SAYLOR - NO,Lower Paxton Twp--27th Precinct,125,0,0,0,125,19202,292,7,0,19501
SAYLOR RETENTION,  SAYLOR - NO,Lower Swatara Twp--1st Precinct,197,2,0,0,199,19202,292,7,0,19501
SAYLOR RETENTION,  SAYLOR - NO,Lower Swatara Twp--2nd Precinct,152,5,0,0,157,19202,292,7,0,19501
SAYLOR RETENTION,  SAYLOR - NO,Lower Swatara Twp--3rd Precinct,137,4,0,0,141,19202,292,7,0,19501
SAYLOR RETENTION,  SAYLOR - NO,Lower Swatara Twp--4th Precinct,157,0,0,0,157,19202,292,7,0,19501
SAYLOR RETENTION,  SAYLOR - NO,Lykens Township,58,0,0,0,58,19202,292,7,0,19501
SAYLOR RETENTION,  SAYLOR - NO,Middle Paxton Twp--1st Precinct,241,2,0,0,243,19202,292,7,0,19501
SAYLOR RETENTION,  SAYLOR - NO,Middle Paxton Twp--2nd Precinct,175,1,0,0,176,19202,292,7,0,19501
SAYLOR RETENTION,  SAYLOR - NO,Middle Paxton Twp--3rd Precinct,255,0,0,0,255,19202,292,7,0,19501
SAYLOR RETENTION,  SAYLOR - NO,Mifflin Township,49,0,0,0,49,19202,292,7,0,19501
SAYLOR RETENTION,  SAYLOR - NO,Reed Township,27,0,0,0,27,19202,292,7,0,19501
SAYLOR RETENTION,  SAYLOR - NO,Rush Township,16,0,0,0,16,19202,292,7,0,19501
SAYLOR RETENTION,  SAYLOR - NO,South Hanover Twp--1st Precinct,165,2,0,0,167,19202,292,7,0,19501
SAYLOR RETENTION,  SAYLOR - NO,South Hanover Twp--2nd Precinct,207,5,0,0,212,19202,292,7,0,19501
SAYLOR RETENTION,  SAYLOR - NO,South Hanover Twp--3rd Precinct,138,0,0,0,138,19202,292,7,0,19501
SAYLOR RETENTION,  SAYLOR - NO,Susquehanna Twp--1st Ward,258,5,0,0,263,19202,292,7,0,19501
SAYLOR RETENTION,  SAYLOR - NO,Susquehanna Twp--2nd Ward,378,11,0,0,389,19202,292,7,0,19501
SAYLOR RETENTION,  SAYLOR - NO,Susquehanna Twp--3rd Ward,179,0,0,0,179,19202,292,7,0,19501
SAYLOR RETENTION,  SAYLOR - NO,Susquehanna Twp--4th Ward,186,1,0,0,187,19202,292,7,0,19501
SAYLOR RETENTION,  SAYLOR - NO,Susquehanna Twp--5th Ward,190,3,0,0,193,19202,292,7,0,19501
SAYLOR RETENTION,  SAYLOR - NO,Susquehanna Twp--6th Ward,208,5,0,0,213,19202,292,7,0,19501
SAYLOR RETENTION,  SAYLOR - NO,Susquehanna Twp--7th Ward,130,0,0,0,130,19202,292,7,0,19501
SAYLOR RETENTION,  SAYLOR - NO,Susquehanna Twp--8th Ward,296,9,0,0,305,19202,292,7,0,19501
SAYLOR RETENTION,  SAYLOR - NO,Susquehanna Twp--9th Ward,226,1,0,0,227,19202,292,7,0,19501
SAYLOR RETENTION,  SAYLOR - NO,Swatara Township--1st Ward,176,0,0,0,176,19202,292,7,0,19501
SAYLOR RETENTION,  SAYLOR - NO,Swatara Township--2nd Ward,120,1,0,0,121,19202,292,7,0,19501
SAYLOR RETENTION,  SAYLOR - NO,Swatara Township--3rd Ward,123,2,0,0,125,19202,292,7,0,19501
SAYLOR RETENTION,  SAYLOR - NO,Swatara Township--4th Ward,196,6,0,0,202,19202,292,7,0,19501
SAYLOR RETENTION,  SAYLOR - NO,Swatara Township--5th Ward,238,2,0,0,240,19202,292,7,0,19501
SAYLOR RETENTION,  SAYLOR - NO,Swatara Township--6th Ward,249,0,0,0,249,19202,292,7,0,19501
SAYLOR RETENTION,  SAYLOR - NO,Swatara Township--7th Ward,284,2,0,0,286,19202,292,7,0,19501
SAYLOR RETENTION,  SAYLOR - NO,Swatara Township--8th Ward,254,3,1,0,258,19202,292,7,0,19501
SAYLOR RETENTION,  SAYLOR - NO,Swatara Township--9th Ward,104,2,0,0,106,19202,292,7,0,19501
SAYLOR RETENTION,  SAYLOR - NO,Upper Paxton Twp--1st Precinct,143,2,0,0,145,19202,292,7,0,19501
SAYLOR RETENTION,  SAYLOR - NO,Upper Paxton Twp--2nd Precinct,101,0,0,0,101,19202,292,7,0,19501
SAYLOR RETENTION,  SAYLOR - NO,Washington Township,150,4,0,0,154,19202,292,7,0,19501
SAYLOR RETENTION,  SAYLOR - NO,Wayne Township,155,1,0,0,156,19202,292,7,0,19501
SAYLOR RETENTION,  SAYLOR - NO,West Hanover Twp--1st Precinct,200,3,0,0,203,19202,292,7,0,19501
SAYLOR RETENTION,  SAYLOR - NO,West Hanover Twp--2nd Precinct,169,1,0,0,170,19202,292,7,0,19501
SAYLOR RETENTION,  SAYLOR - NO,West Hanover Twp--3rd Precinct,413,7,2,0,422,19202,292,7,0,19501
SAYLOR RETENTION,  SAYLOR - NO,West Hanover Twp--4th Precinct,233,1,0,0,234,19202,292,7,0,19501
SAYLOR RETENTION,  SAYLOR - NO,Wiconisco Twp--1st Precinct,50,0,0,0,50,19202,292,7,0,19501
SAYLOR RETENTION,  SAYLOR - NO,Wiconisco Twp--2nd Precinct,29,1,0,0,30,19202,292,7,0,19501
SAYLOR RETENTION,  SAYLOR - NO,Williams Twp,70,1,0,0,71,19202,292,7,0,19501
SAYLOR RETENTION,  SAYLOR - YES,"City--1st Ward, 1st Precinct",57,2,0,0,59,18892,447,14,0,19353
SAYLOR RETENTION,  SAYLOR - YES,"City--1st Ward, 2nd Precinct",102,2,1,0,105,18892,447,14,0,19353
SAYLOR RETENTION,  SAYLOR - YES,"City--1st Ward, 3rd Precinct",35,1,0,0,36,18892,447,14,0,19353
SAYLOR RETENTION,  SAYLOR - YES,"City--2nd Ward, 1st Precinct",14,0,0,0,14,18892,447,14,0,19353
SAYLOR RETENTION,  SAYLOR - YES,"City--2nd Ward, 2nd Precinct",41,1,0,0,42,18892,447,14,0,19353
SAYLOR RETENTION,  SAYLOR - YES,City--3rd Ward,56,1,0,0,57,18892,447,14,0,19353
SAYLOR RETENTION,  SAYLOR - YES,City--4th Ward,86,4,0,0,90,18892,447,14,0,19353
SAYLOR RETENTION,  SAYLOR - YES,City--5th Ward,170,7,0,0,177,18892,447,14,0,19353
SAYLOR RETENTION,  SAYLOR - YES,City--6th Ward,76,1,3,0,80,18892,447,14,0,19353
SAYLOR RETENTION,  SAYLOR - YES,"City--7th Ward, 1st Precinct",32,0,0,0,32,18892,447,14,0,19353
SAYLOR RETENTION,  SAYLOR - YES,"City--7th Ward, 2nd Precinct",75,0,0,0,75,18892,447,14,0,19353
SAYLOR RETENTION,  SAYLOR - YES,City--8th Ward,59,0,0,0,59,18892,447,14,0,19353
SAYLOR RETENTION,  SAYLOR - YES,"City--9th Ward, 1st Precinct",24,1,0,0,25,18892,447,14,0,19353
SAYLOR RETENTION,  SAYLOR - YES,"City--9th Ward, 2nd Precinct",34,2,0,0,36,18892,447,14,0,19353
SAYLOR RETENTION,  SAYLOR - YES,"City--9th Ward, 3rd Precinct",77,1,0,0,78,18892,447,14,0,19353
SAYLOR RETENTION,  SAYLOR - YES,"City--9th Ward, 4th Precinct",101,3,0,0,104,18892,447,14,0,19353
SAYLOR RETENTION,  SAYLOR - YES,"City--9th Ward, 5th Precinct",70,2,0,0,72,18892,447,14,0,19353
SAYLOR RETENTION,  SAYLOR - YES,"City--10th Ward, 1st Precinct",100,6,0,0,106,18892,447,14,0,19353
SAYLOR RETENTION,  SAYLOR - YES,"City--10th Ward, 2nd Precinct",33,0,0,0,33,18892,447,14,0,19353
SAYLOR RETENTION,  SAYLOR - YES,"City--10th Ward, 3rd Precinct",63,1,0,0,64,18892,447,14,0,19353
SAYLOR RETENTION,  SAYLOR - YES,"City--10th Ward, 4th Precinct",37,0,0,0,37,18892,447,14,0,19353
SAYLOR RETENTION,  SAYLOR - YES,City--11th Ward,43,32,0,0,75,18892,447,14,0,19353
SAYLOR RETENTION,  SAYLOR - YES,City--12th Ward,136,4,0,0,140,18892,447,14,0,19353
SAYLOR RETENTION,  SAYLOR - YES,"City--13th Ward, 1st Precinct",57,0,0,0,57,18892,447,14,0,19353
SAYLOR RETENTION,  SAYLOR - YES,"City--13th Ward, 2nd Precinct",96,3,0,0,99,18892,447,14,0,19353
SAYLOR RETENTION,  SAYLOR - YES,"City--13th Ward, 3rd Precinct",115,0,0,0,115,18892,447,14,0,19353
SAYLOR RETENTION,  SAYLOR - YES,City--14th Ward,195,5,0,0,200,18892,447,14,0,19353
SAYLOR RETENTION,  SAYLOR - YES,City--15th Ward,39,0,0,0,39,18892,447,14,0,19353
SAYLOR RETENTION,  SAYLOR - YES,Berrysburg Borough,25,0,0,0,25,18892,447,14,0,19353
SAYLOR RETENTION,  SAYLOR - YES,Dauphin Borough,67,1,0,0,68,18892,447,14,0,19353
SAYLOR RETENTION,  SAYLOR - YES,Elizabethville Borough,75,1,0,0,76,18892,447,14,0,19353
SAYLOR RETENTION,  SAYLOR - YES,Gratz Borough,42,1,0,0,43,18892,447,14,0,19353
SAYLOR RETENTION,  SAYLOR - YES,Halifax Borough,41,3,0,0,44,18892,447,14,0,19353
SAYLOR RETENTION,  SAYLOR - YES,Highspire--1st Precinct,75,0,0,0,75,18892,447,14,0,19353
SAYLOR RETENTION,  SAYLOR - YES,Highspire--2nd Precinct,80,1,0,0,81,18892,447,14,0,19353
SAYLOR RETENTION,  SAYLOR - YES,Hummelstown--1st Precinct,97,1,0,0,98,18892,447,14,0,19353
SAYLOR RETENTION,  SAYLOR - YES,Hummelstown--2nd Precinct,221,4,0,0,225,18892,447,14,0,19353
SAYLOR RETENTION,  SAYLOR - YES,Lykens Borough--1st Ward,57,1,0,0,58,18892,447,14,0,19353
SAYLOR RETENTION,  SAYLOR - YES,Lykens Borough--2nd Ward,60,2,0,0,62,18892,447,14,0,19353
SAYLOR RETENTION,  SAYLOR - YES,"Middletown--1st Ward, 1st Precinct",53,0,0,0,53,18892,447,14,0,19353
SAYLOR RETENTION,  SAYLOR - YES,"Middletown--1st Ward, 2nd Precinct",82,6,1,0,89,18892,447,14,0,19353
SAYLOR RETENTION,  SAYLOR - YES,"Middletown--2nd Ward, 1st Precinct",76,0,0,0,76,18892,447,14,0,19353
SAYLOR RETENTION,  SAYLOR - YES,"Middletown--2nd Ward, 2nd Precinct",91,3,0,0,94,18892,447,14,0,19353
SAYLOR RETENTION,  SAYLOR - YES,"Middletown--3rd Ward, 1st Precinct",59,0,0,0,59,18892,447,14,0,19353
SAYLOR RETENTION,  SAYLOR - YES,"Middletown--3rd Ward, 2nd Precinct",113,0,0,0,113,18892,447,14,0,19353
SAYLOR RETENTION,  SAYLOR - YES,Millersburg--1st Ward,78,3,0,0,81,18892,447,14,0,19353
SAYLOR RETENTION,  SAYLOR - YES,Millersburg--2nd Ward,89,3,0,0,92,18892,447,14,0,19353
SAYLOR RETENTION,  SAYLOR - YES,Paxtang Borough,155,2,0,0,157,18892,447,14,0,19353
SAYLOR RETENTION,  SAYLOR - YES,Penbrook Borough--1st Ward,36,1,0,0,37,18892,447,14,0,19353
SAYLOR RETENTION,  SAYLOR - YES,Penbrook Borough--2nd Ward,50,1,0,0,51,18892,447,14,0,19353
SAYLOR RETENTION,  SAYLOR - YES,Penbrook Borough--3rd Ward,36,0,0,0,36,18892,447,14,0,19353
SAYLOR RETENTION,  SAYLOR - YES,Penbrook Borough--4th Ward,36,0,0,0,36,18892,447,14,0,19353
SAYLOR RETENTION,  SAYLOR - YES,Royalton Borough--1st Ward,26,0,0,0,26,18892,447,14,0,19353
SAYLOR RETENTION,  SAYLOR - YES,Royalton Borough--2nd Ward,43,0,0,0,43,18892,447,14,0,19353
SAYLOR RETENTION,  SAYLOR - YES,Steelton--1st Ward,73,3,0,0,76,18892,447,14,0,19353
SAYLOR RETENTION,  SAYLOR - YES,"Steelton--2nd Ward, 1st Precinct",54,1,0,0,55,18892,447,14,0,19353
SAYLOR RETENTION,  SAYLOR - YES,"Steelton--2nd Ward, 2nd Precinct",42,0,0,0,42,18892,447,14,0,19353
SAYLOR RETENTION,  SAYLOR - YES,"Steelton--3rd Ward, 1st Precinct",30,0,0,0,30,18892,447,14,0,19353
SAYLOR RETENTION,  SAYLOR - YES,"Steelton--3rd Ward, 2nd Precinct",49,0,0,0,49,18892,447,14,0,19353
SAYLOR RETENTION,  SAYLOR - YES,Steelton--4th Ward,47,0,1,0,48,18892,447,14,0,19353
SAYLOR RETENTION,  SAYLOR - YES,Pillow Borough,30,0,0,0,30,18892,447,14,0,19353
SAYLOR RETENTION,  SAYLOR - YES,Williamstown--1st Ward,59,0,0,0,59,18892,447,14,0,19353
SAYLOR RETENTION,  SAYLOR - YES,Williamstown--2nd Ward,27,0,0,0,27,18892,447,14,0,19353
SAYLOR RETENTION,  SAYLOR - YES,Conewago Twp--1st Precinct,127,1,0,0,128,18892,447,14,0,19353
SAYLOR RETENTION,  SAYLOR - YES,Conewago Twp--2nd Precinct,108,1,0,0,109,18892,447,14,0,19353
SAYLOR RETENTION,  SAYLOR - YES,Derry Township--1st Precinct,207,5,0,0,212,18892,447,14,0,19353
SAYLOR RETENTION,  SAYLOR - YES,Derry Township--2nd Precinct,155,2,0,0,157,18892,447,14,0,19353
SAYLOR RETENTION,  SAYLOR - YES,Derry Township--3rd Precinct,105,5,0,0,110,18892,447,14,0,19353
SAYLOR RETENTION,  SAYLOR - YES,Derry Township--4th Precinct,108,2,0,0,110,18892,447,14,0,19353
SAYLOR RETENTION,  SAYLOR - YES,Derry Township--5th Precinct,85,0,0,0,85,18892,447,14,0,19353
SAYLOR RETENTION,  SAYLOR - YES,Derry Township--6th Precinct,101,2,0,0,103,18892,447,14,0,19353
SAYLOR RETENTION,  SAYLOR - YES,Derry Township--7th Precinct,218,13,0,0,231,18892,447,14,0,19353
SAYLOR RETENTION,  SAYLOR - YES,Derry Township--8th Precinct,115,0,0,0,115,18892,447,14,0,19353
SAYLOR RETENTION,  SAYLOR - YES,Derry Township--9th Precinct,68,2,0,0,70,18892,447,14,0,19353
SAYLOR RETENTION,  SAYLOR - YES,Derry Township--10th Precinct,142,4,0,0,146,18892,447,14,0,19353
SAYLOR RETENTION,  SAYLOR - YES,Derry Township--11th Precinct,198,4,0,0,202,18892,447,14,0,19353
SAYLOR RETENTION,  SAYLOR - YES,Derry Township--12th Precinct,117,2,0,0,119,18892,447,14,0,19353
SAYLOR RETENTION,  SAYLOR - YES,Derry Township--13th Precinct,154,4,0,0,158,18892,447,14,0,19353
SAYLOR RETENTION,  SAYLOR - YES,Derry Township--14th Precinct,103,5,0,0,108,18892,447,14,0,19353
SAYLOR RETENTION,  SAYLOR - YES,Derry Township--15th Precinct,184,3,1,0,188,18892,447,14,0,19353
SAYLOR RETENTION,  SAYLOR - YES,East Hanover Township--1st Precinct,162,6,0,0,168,18892,447,14,0,19353
SAYLOR RETENTION,  SAYLOR - YES,East Hanover Township--2nd Precinct,197,3,0,0,200,18892,447,14,0,19353
SAYLOR RETENTION,  SAYLOR - YES,Halifax Twp--1st Precinct,156,3,0,0,159,18892,447,14,0,19353
SAYLOR RETENTION,  SAYLOR - YES,Halifax Twp--2nd Precinct,189,1,0,0,190,18892,447,14,0,19353
SAYLOR RETENTION,  SAYLOR - YES,Jackson Township,110,0,0,0,110,18892,447,14,0,19353
SAYLOR RETENTION,  SAYLOR - YES,Jefferson Township,31,0,0,0,31,18892,447,14,0,19353
SAYLOR RETENTION,  SAYLOR - YES,Londonderry Twp--1st Precinct,152,0,0,0,152,18892,447,14,0,19353
SAYLOR RETENTION,  SAYLOR - YES,Londonderry Twp--2nd Precinct,140,1,0,0,141,18892,447,14,0,19353
SAYLOR RETENTION,  SAYLOR - YES,Londonderry Twp--3rd Precinct,83,1,0,0,84,18892,447,14,0,19353
SAYLOR RETENTION,  SAYLOR - YES,Lower Paxton Twp--1st Precinct,130,2,0,0,132,18892,447,14,0,19353
SAYLOR RETENTION,  SAYLOR - YES,Lower Paxton Twp--2nd Precinct,127,7,0,0,134,18892,447,14,0,19353
SAYLOR RETENTION,  SAYLOR - YES,Lower Paxton Twp--3rd precinct,250,6,0,0,256,18892,447,14,0,19353
SAYLOR RETENTION,  SAYLOR - YES,Lower Paxton Twp--4th Precinct,166,2,0,0,168,18892,447,14,0,19353
SAYLOR RETENTION,  SAYLOR - YES,Lower Paxton Twp--5th Precinct,145,0,0,0,145,18892,447,14,0,19353
SAYLOR RETENTION,  SAYLOR - YES,Lower Paxton Twp--6th Precinct,110,4,0,0,114,18892,447,14,0,19353
SAYLOR RETENTION,  SAYLOR - YES,Lower Paxton Twp--7th Precinct,209,6,0,0,215,18892,447,14,0,19353
SAYLOR RETENTION,  SAYLOR - YES,Lower Paxton Twp--8th Precinct,103,1,0,0,104,18892,447,14,0,19353
SAYLOR RETENTION,  SAYLOR - YES,Lower Paxton Twp--9th Precinct,118,3,0,0,121,18892,447,14,0,19353
SAYLOR RETENTION,  SAYLOR - YES,Lower Paxton Twp--10th Precinct,92,4,0,0,96,18892,447,14,0,19353
SAYLOR RETENTION,  SAYLOR - YES,Lower Paxton Twp--11th Precinct,121,0,0,0,121,18892,447,14,0,19353
SAYLOR RETENTION,  SAYLOR - YES,Lower Paxton Twp--12th Precinct,198,5,1,0,204,18892,447,14,0,19353
SAYLOR RETENTION,  SAYLOR - YES,Lower Paxton Twp--13th Precinct,157,3,0,0,160,18892,447,14,0,19353
SAYLOR RETENTION,  SAYLOR - YES,Lower Paxton Twp--14th Precinct,109,1,3,0,113,18892,447,14,0,19353
SAYLOR RETENTION,  SAYLOR - YES,Lower Paxton Twp--15th Precinct,153,3,0,0,156,18892,447,14,0,19353
SAYLOR RETENTION,  SAYLOR - YES,Lower Paxton Twp--16th Precinct,255,6,0,0,261,18892,447,14,0,19353
SAYLOR RETENTION,  SAYLOR - YES,Lower Paxton Twp--17th Precinct,118,5,0,0,123,18892,447,14,0,19353
SAYLOR RETENTION,  SAYLOR - YES,Lower Paxton Twp--18th Precinct,120,1,0,0,121,18892,447,14,0,19353
SAYLOR RETENTION,  SAYLOR - YES,Lower Paxton Twp--19th Precinct,217,10,0,0,227,18892,447,14,0,19353
SAYLOR RETENTION,  SAYLOR - YES,Lower Paxton Twp--20th Precinct,152,2,0,0,154,18892,447,14,0,19353
SAYLOR RETENTION,  SAYLOR - YES,Lower Paxton Twp--21st Precinct,213,7,0,0,220,18892,447,14,0,19353
SAYLOR RETENTION,  SAYLOR - YES,Lower Paxton Twp--22nd Precinct,179,1,0,0,180,18892,447,14,0,19353
SAYLOR RETENTION,  SAYLOR - YES,Lower Paxton Twp--23rd Precinct,179,4,0,0,183,18892,447,14,0,19353
SAYLOR RETENTION,  SAYLOR - YES,Lower Paxton Twp--24th Precinct,163,2,0,0,165,18892,447,14,0,19353
SAYLOR RETENTION,  SAYLOR - YES,Lower Paxton Twp--25th Precinct,96,3,0,0,99,18892,447,14,0,19353
SAYLOR RETENTION,  SAYLOR - YES,Lower Paxton Twp--26th Precinct,165,2,0,0,167,18892,447,14,0,19353
SAYLOR RETENTION,  SAYLOR - YES,Lower Paxton Twp--27th Precinct,149,1,0,0,150,18892,447,14,0,19353
SAYLOR RETENTION,  SAYLOR - YES,Lower Swatara Twp--1st Precinct,208,3,0,0,211,18892,447,14,0,19353
SAYLOR RETENTION,  SAYLOR - YES,Lower Swatara Twp--2nd Precinct,186,3,0,0,189,18892,447,14,0,19353
SAYLOR RETENTION,  SAYLOR - YES,Lower Swatara Twp--3rd Precinct,157,16,0,0,173,18892,447,14,0,19353
SAYLOR RETENTION,  SAYLOR - YES,Lower Swatara Twp--4th Precinct,130,1,0,0,131,18892,447,14,0,19353
SAYLOR RETENTION,  SAYLOR - YES,Lykens Township,39,0,0,0,39,18892,447,14,0,19353
SAYLOR RETENTION,  SAYLOR - YES,Middle Paxton Twp--1st Precinct,149,0,0,0,149,18892,447,14,0,19353
SAYLOR RETENTION,  SAYLOR - YES,Middle Paxton Twp--2nd Precinct,139,1,0,0,140,18892,447,14,0,19353
SAYLOR RETENTION,  SAYLOR - YES,Middle Paxton Twp--3rd Precinct,152,2,0,0,154,18892,447,14,0,19353
SAYLOR RETENTION,  SAYLOR - YES,Mifflin Township,40,0,0,0,40,18892,447,14,0,19353
SAYLOR RETENTION,  SAYLOR - YES,Reed Township,22,0,0,0,22,18892,447,14,0,19353
SAYLOR RETENTION,  SAYLOR - YES,Rush Township,23,0,0,0,23,18892,447,14,0,19353
SAYLOR RETENTION,  SAYLOR - YES,South Hanover Twp--1st Precinct,145,3,0,0,148,18892,447,14,0,19353
SAYLOR RETENTION,  SAYLOR - YES,South Hanover Twp--2nd Precinct,219,5,0,0,224,18892,447,14,0,19353
SAYLOR RETENTION,  SAYLOR - YES,South Hanover Twp--3rd Precinct,119,0,0,0,119,18892,447,14,0,19353
SAYLOR RETENTION,  SAYLOR - YES,Susquehanna Twp--1st Ward,245,11,0,0,256,18892,447,14,0,19353
SAYLOR RETENTION,  SAYLOR - YES,Susquehanna Twp--2nd Ward,374,16,0,0,390,18892,447,14,0,19353
SAYLOR RETENTION,  SAYLOR - YES,Susquehanna Twp--3rd Ward,142,3,0,0,145,18892,447,14,0,19353
SAYLOR RETENTION,  SAYLOR - YES,Susquehanna Twp--4th Ward,173,2,0,0,175,18892,447,14,0,19353
SAYLOR RETENTION,  SAYLOR - YES,Susquehanna Twp--5th Ward,188,3,0,0,191,18892,447,14,0,19353
SAYLOR RETENTION,  SAYLOR - YES,Susquehanna Twp--6th Ward,227,5,0,0,232,18892,447,14,0,19353
SAYLOR RETENTION,  SAYLOR - YES,Susquehanna Twp--7th Ward,117,0,0,0,117,18892,447,14,0,19353
SAYLOR RETENTION,  SAYLOR - YES,Susquehanna Twp--8th Ward,309,13,0,0,322,18892,447,14,0,19353
SAYLOR RETENTION,  SAYLOR - YES,Susquehanna Twp--9th Ward,203,4,0,0,207,18892,447,14,0,19353
SAYLOR RETENTION,  SAYLOR - YES,Swatara Township--1st Ward,177,1,0,0,178,18892,447,14,0,19353
SAYLOR RETENTION,  SAYLOR - YES,Swatara Township--2nd Ward,97,18,0,0,115,18892,447,14,0,19353
SAYLOR RETENTION,  SAYLOR - YES,Swatara Township--3rd Ward,121,6,0,0,127,18892,447,14,0,19353
SAYLOR RETENTION,  SAYLOR - YES,Swatara Township--4th Ward,191,2,0,0,193,18892,447,14,0,19353
SAYLOR RETENTION,  SAYLOR - YES,Swatara Township--5th Ward,245,3,0,0,248,18892,447,14,0,19353
SAYLOR RETENTION,  SAYLOR - YES,Swatara Township--6th Ward,212,3,1,0,216,18892,447,14,0,19353
SAYLOR RETENTION,  SAYLOR - YES,Swatara Township--7th Ward,211,6,0,0,217,18892,447,14,0,19353
SAYLOR RETENTION,  SAYLOR - YES,Swatara Township--8th Ward,286,4,0,0,290,18892,447,14,0,19353
SAYLOR RETENTION,  SAYLOR - YES,Swatara Township--9th Ward,119,6,0,0,125,18892,447,14,0,19353
SAYLOR RETENTION,  SAYLOR - YES,Upper Paxton Twp--1st Precinct,169,1,0,0,170,18892,447,14,0,19353
SAYLOR RETENTION,  SAYLOR - YES,Upper Paxton Twp--2nd Precinct,100,3,0,0,103,18892,447,14,0,19353
SAYLOR RETENTION,  SAYLOR - YES,Washington Township,145,3,0,0,148,18892,447,14,0,19353
SAYLOR RETENTION,  SAYLOR - YES,Wayne Township,125,0,1,0,126,18892,447,14,0,19353
SAYLOR RETENTION,  SAYLOR - YES,West Hanover Twp--1st Precinct,139,3,0,0,142,18892,447,14,0,19353
SAYLOR RETENTION,  SAYLOR - YES,West Hanover Twp--2nd Precinct,155,4,1,0,160,18892,447,14,0,19353
SAYLOR RETENTION,  SAYLOR - YES,West Hanover Twp--3rd Precinct,332,12,0,0,344,18892,447,14,0,19353
SAYLOR RETENTION,  SAYLOR - YES,West Hanover Twp--4th Precinct,197,2,0,0,199,18892,447,14,0,19353
SAYLOR RETENTION,  SAYLOR - YES,Wiconisco Twp--1st Precinct,38,1,0,0,39,18892,447,14,0,19353
SAYLOR RETENTION,  SAYLOR - YES,Wiconisco Twp--2nd Precinct,36,0,0,0,36,18892,447,14,0,19353
SAYLOR RETENTION,  SAYLOR - YES,Williams Twp,85,0,0,0,85,18892,447,14,0,19353
SCHOOL DIR  HALIFAX,Patrick  Von KEYSERLING,Halifax Borough,54,1,0,0,55,785,10,0,0,795
SCHOOL DIR  HALIFAX,Patrick  Von KEYSERLING,Halifax Twp--1st Precinct,167,2,0,0,169,785,10,0,0,795
SCHOOL DIR  HALIFAX,Patrick  Von KEYSERLING,Halifax Twp--2nd Precinct,226,6,0,0,232,785,10,0,0,795
SCHOOL DIR  HALIFAX,Patrick  Von KEYSERLING,Jackson Township,158,1,0,0,159,785,10,0,0,795
SCHOOL DIR  HALIFAX,Patrick  Von KEYSERLING,Wayne Township,180,0,0,0,180,785,10,0,0,795
SCHOOL DIR  HALIFAX,Todd F. HOOVER,Halifax Borough,87,3,0,0,90,1190,17,0,0,1207
SCHOOL DIR  HALIFAX,Todd F. HOOVER,Halifax Twp--1st Precinct,304,4,0,0,308,1190,17,0,0,1207
SCHOOL DIR  HALIFAX,Todd F. HOOVER,Halifax Twp--2nd Precinct,318,8,0,0,326,1190,17,0,0,1207
SCHOOL DIR  HALIFAX,Todd F. HOOVER,Jackson Township,232,1,0,0,233,1190,17,0,0,1207
SCHOOL DIR  HALIFAX,Todd F. HOOVER,Wayne Township,249,1,0,0,250,1190,17,0,0,1207
SCHOOL DIR  HALIFAX,Write In  ,Halifax Borough,5,0,0,0,5,110,0,0,0,110
SCHOOL DIR  HALIFAX,Write In  ,Halifax Twp--1st Precinct,47,0,0,0,47,110,0,0,0,110
SCHOOL DIR  HALIFAX,Write In  ,Halifax Twp--2nd Precinct,23,0,0,0,23,110,0,0,0,110
SCHOOL DIR  HALIFAX,Write In  ,Jackson Township,15,0,0,0,15,110,0,0,0,110
SCHOOL DIR  HALIFAX,Write In  ,Wayne Township,20,0,0,0,20,110,0,0,0,110
SCHOOL DIR  LD REG 2,Marcela D. MYERS,Hummelstown--1st Precinct,210,4,0,0,214,1378,21,0,0,1399
SCHOOL DIR  LD REG 2,Marcela D. MYERS,Hummelstown--2nd Precinct,426,5,0,0,431,1378,21,0,0,1399
SCHOOL DIR  LD REG 2,Marcela D. MYERS,South Hanover Twp--1st Precinct,313,5,0,0,318,1378,21,0,0,1399
SCHOOL DIR  LD REG 2,Marcela D. MYERS,South Hanover Twp--2nd Precinct,429,7,0,0,436,1378,21,0,0,1399
SCHOOL DIR  LD REG 2,Write In  ,Hummelstown--1st Precinct,0,0,0,0,0,2,0,0,0,2
SCHOOL DIR  LD REG 2,Write In  ,Hummelstown--2nd Precinct,0,0,0,0,0,2,0,0,0,2
SCHOOL DIR  LD REG 2,Write In  ,South Hanover Twp--1st Precinct,1,0,0,0,1,2,0,0,0,2
SCHOOL DIR  LD REG 2,Write In  ,South Hanover Twp--2nd Precinct,1,0,0,0,1,2,0,0,0,2
SCHOOL DIR  LD REG 3,Keith E. OELLIG,East Hanover Township--1st Precinct,328,9,0,0,337,890,16,0,0,906
SCHOOL DIR  LD REG 3,Keith E. OELLIG,East Hanover Township--2nd Precinct,353,6,0,0,359,890,16,0,0,906
SCHOOL DIR  LD REG 3,Keith E. OELLIG,South Hanover Twp--3rd Precinct,209,1,0,0,210,890,16,0,0,906
SCHOOL DIR  LD REG 3,Laurie N. REICHERT,East Hanover Township--1st Precinct,309,9,0,0,318,849,15,0,0,864
SCHOOL DIR  LD REG 3,Laurie N. REICHERT,East Hanover Township--2nd Precinct,349,5,0,0,354,849,15,0,0,864
SCHOOL DIR  LD REG 3,Laurie N. REICHERT,South Hanover Twp--3rd Precinct,191,1,0,0,192,849,15,0,0,864
SCHOOL DIR  LD REG 3,Write In  ,East Hanover Township--1st Precinct,2,0,0,0,2,3,0,0,0,3
SCHOOL DIR  LD REG 3,Write In  ,East Hanover Township--2nd Precinct,1,0,0,0,1,3,0,0,0,3
SCHOOL DIR  LD REG 3,Write In  ,South Hanover Twp--3rd Precinct,0,0,0,0,0,3,0,0,0,3
SCHOOL DIR 2YR DERRY,Alan R. MALKOFF,Derry Township--1st Precinct,264,4,0,0,268,2691,66,2,0,2759
SCHOOL DIR 2YR DERRY,Alan R. MALKOFF,Derry Township--2nd Precinct,205,6,0,0,211,2691,66,2,0,2759
SCHOOL DIR 2YR DERRY,Alan R. MALKOFF,Derry Township--3rd Precinct,150,4,0,0,154,2691,66,2,0,2759
SCHOOL DIR 2YR DERRY,Alan R. MALKOFF,Derry Township--4th Precinct,139,5,0,0,144,2691,66,2,0,2759
SCHOOL DIR 2YR DERRY,Alan R. MALKOFF,Derry Township--5th Precinct,108,2,0,0,110,2691,66,2,0,2759
SCHOOL DIR 2YR DERRY,Alan R. MALKOFF,Derry Township--6th Precinct,123,1,1,0,125,2691,66,2,0,2759
SCHOOL DIR 2YR DERRY,Alan R. MALKOFF,Derry Township--7th Precinct,294,12,0,0,306,2691,66,2,0,2759
SCHOOL DIR 2YR DERRY,Alan R. MALKOFF,Derry Township--8th Precinct,134,0,0,0,134,2691,66,2,0,2759
SCHOOL DIR 2YR DERRY,Alan R. MALKOFF,Derry Township--9th Precinct,94,3,0,0,97,2691,66,2,0,2759
SCHOOL DIR 2YR DERRY,Alan R. MALKOFF,Derry Township--10th Precinct,211,3,0,0,214,2691,66,2,0,2759
SCHOOL DIR 2YR DERRY,Alan R. MALKOFF,Derry Township--11th Precinct,247,6,0,0,253,2691,66,2,0,2759
SCHOOL DIR 2YR DERRY,Alan R. MALKOFF,Derry Township--12th Precinct,132,1,0,0,133,2691,66,2,0,2759
SCHOOL DIR 2YR DERRY,Alan R. MALKOFF,Derry Township--13th Precinct,204,9,0,0,213,2691,66,2,0,2759
SCHOOL DIR 2YR DERRY,Alan R. MALKOFF,Derry Township--14th Precinct,139,5,0,0,144,2691,66,2,0,2759
SCHOOL DIR 2YR DERRY,Alan R. MALKOFF,Derry Township--15th Precinct,247,5,1,0,253,2691,66,2,0,2759
SCHOOL DIR 2YR DERRY,Selma D. SANDERS-WEST,Derry Township--1st Precinct,142,1,0,0,143,1384,26,0,0,1410
SCHOOL DIR 2YR DERRY,Selma D. SANDERS-WEST,Derry Township--2nd Precinct,110,1,0,0,111,1384,26,0,0,1410
SCHOOL DIR 2YR DERRY,Selma D. SANDERS-WEST,Derry Township--3rd Precinct,112,3,0,0,115,1384,26,0,0,1410
SCHOOL DIR 2YR DERRY,Selma D. SANDERS-WEST,Derry Township--4th Precinct,69,0,0,0,69,1384,26,0,0,1410
SCHOOL DIR 2YR DERRY,Selma D. SANDERS-WEST,Derry Township--5th Precinct,49,1,0,0,50,1384,26,0,0,1410
SCHOOL DIR 2YR DERRY,Selma D. SANDERS-WEST,Derry Township--6th Precinct,72,0,0,0,72,1384,26,0,0,1410
SCHOOL DIR 2YR DERRY,Selma D. SANDERS-WEST,Derry Township--7th Precinct,131,5,0,0,136,1384,26,0,0,1410
SCHOOL DIR 2YR DERRY,Selma D. SANDERS-WEST,Derry Township--8th Precinct,76,0,0,0,76,1384,26,0,0,1410
SCHOOL DIR 2YR DERRY,Selma D. SANDERS-WEST,Derry Township--9th Precinct,49,2,0,0,51,1384,26,0,0,1410
SCHOOL DIR 2YR DERRY,Selma D. SANDERS-WEST,Derry Township--10th Precinct,76,2,0,0,78,1384,26,0,0,1410
SCHOOL DIR 2YR DERRY,Selma D. SANDERS-WEST,Derry Township--11th Precinct,128,3,0,0,131,1384,26,0,0,1410
SCHOOL DIR 2YR DERRY,Selma D. SANDERS-WEST,Derry Township--12th Precinct,70,3,0,0,73,1384,26,0,0,1410
SCHOOL DIR 2YR DERRY,Selma D. SANDERS-WEST,Derry Township--13th Precinct,105,1,0,0,106,1384,26,0,0,1410
SCHOOL DIR 2YR DERRY,Selma D. SANDERS-WEST,Derry Township--14th Precinct,62,2,0,0,64,1384,26,0,0,1410
SCHOOL DIR 2YR DERRY,Selma D. SANDERS-WEST,Derry Township--15th Precinct,133,2,0,0,135,1384,26,0,0,1410
SCHOOL DIR 2YR DERRY,Write In  ,Derry Township--1st Precinct,3,0,0,0,3,27,0,0,0,27
SCHOOL DIR 2YR DERRY,Write In  ,Derry Township--2nd Precinct,1,0,0,0,1,27,0,0,0,27
SCHOOL DIR 2YR DERRY,Write In  ,Derry Township--3rd Precinct,1,0,0,0,1,27,0,0,0,27
SCHOOL DIR 2YR DERRY,Write In  ,Derry Township--4th Precinct,0,0,0,0,0,27,0,0,0,27
SCHOOL DIR 2YR DERRY,Write In  ,Derry Township--5th Precinct,4,0,0,0,4,27,0,0,0,27
SCHOOL DIR 2YR DERRY,Write In  ,Derry Township--6th Precinct,0,0,0,0,0,27,0,0,0,27
SCHOOL DIR 2YR DERRY,Write In  ,Derry Township--7th Precinct,1,0,0,0,1,27,0,0,0,27
SCHOOL DIR 2YR DERRY,Write In  ,Derry Township--8th Precinct,1,0,0,0,1,27,0,0,0,27
SCHOOL DIR 2YR DERRY,Write In  ,Derry Township--9th Precinct,0,0,0,0,0,27,0,0,0,27
SCHOOL DIR 2YR DERRY,Write In  ,Derry Township--10th Precinct,3,0,0,0,3,27,0,0,0,27
SCHOOL DIR 2YR DERRY,Write In  ,Derry Township--11th Precinct,1,0,0,0,1,27,0,0,0,27
SCHOOL DIR 2YR DERRY,Write In  ,Derry Township--12th Precinct,9,0,0,0,9,27,0,0,0,27
SCHOOL DIR 2YR DERRY,Write In  ,Derry Township--13th Precinct,2,0,0,0,2,27,0,0,0,27
SCHOOL DIR 2YR DERRY,Write In  ,Derry Township--14th Precinct,0,0,0,0,0,27,0,0,0,27
SCHOOL DIR 2YR DERRY,Write In  ,Derry Township--15th Precinct,1,0,0,0,1,27,0,0,0,27
SCHOOL DIR 2YR HBG,"Oscar L. DOUGLAS, JR.","City--1st Ward, 1st Precinct",66,3,0,0,69,3368,68,3,0,3439
SCHOOL DIR 2YR HBG,"Oscar L. DOUGLAS, JR.","City--1st Ward, 2nd Precinct",129,2,1,0,132,3368,68,3,0,3439
SCHOOL DIR 2YR HBG,"Oscar L. DOUGLAS, JR.","City--1st Ward, 3rd Precinct",59,1,0,0,60,3368,68,3,0,3439
SCHOOL DIR 2YR HBG,"Oscar L. DOUGLAS, JR.","City--2nd Ward, 1st Precinct",35,0,0,0,35,3368,68,3,0,3439
SCHOOL DIR 2YR HBG,"Oscar L. DOUGLAS, JR.","City--2nd Ward, 2nd Precinct",77,1,0,0,78,3368,68,3,0,3439
SCHOOL DIR 2YR HBG,"Oscar L. DOUGLAS, JR.",City--3rd Ward,94,1,0,0,95,3368,68,3,0,3439
SCHOOL DIR 2YR HBG,"Oscar L. DOUGLAS, JR.",City--4th Ward,120,4,0,0,124,3368,68,3,0,3439
SCHOOL DIR 2YR HBG,"Oscar L. DOUGLAS, JR.",City--5th Ward,255,7,0,0,262,3368,68,3,0,3439
SCHOOL DIR 2YR HBG,"Oscar L. DOUGLAS, JR.",City--6th Ward,128,1,2,0,131,3368,68,3,0,3439
SCHOOL DIR 2YR HBG,"Oscar L. DOUGLAS, JR.","City--7th Ward, 1st Precinct",44,1,0,0,45,3368,68,3,0,3439
SCHOOL DIR 2YR HBG,"Oscar L. DOUGLAS, JR.","City--7th Ward, 2nd Precinct",145,1,0,0,146,3368,68,3,0,3439
SCHOOL DIR 2YR HBG,"Oscar L. DOUGLAS, JR.",City--8th Ward,146,2,0,0,148,3368,68,3,0,3439
SCHOOL DIR 2YR HBG,"Oscar L. DOUGLAS, JR.","City--9th Ward, 1st Precinct",53,2,0,0,55,3368,68,3,0,3439
SCHOOL DIR 2YR HBG,"Oscar L. DOUGLAS, JR.","City--9th Ward, 2nd Precinct",81,1,0,0,82,3368,68,3,0,3439
SCHOOL DIR 2YR HBG,"Oscar L. DOUGLAS, JR.","City--9th Ward, 3rd Precinct",175,2,0,0,177,3368,68,3,0,3439
SCHOOL DIR 2YR HBG,"Oscar L. DOUGLAS, JR.","City--9th Ward, 4th Precinct",142,2,0,0,144,3368,68,3,0,3439
SCHOOL DIR 2YR HBG,"Oscar L. DOUGLAS, JR.","City--9th Ward, 5th Precinct",109,4,0,0,113,3368,68,3,0,3439
SCHOOL DIR 2YR HBG,"Oscar L. DOUGLAS, JR.","City--10th Ward, 1st Precinct",193,3,0,0,196,3368,68,3,0,3439
SCHOOL DIR 2YR HBG,"Oscar L. DOUGLAS, JR.","City--10th Ward, 2nd Precinct",82,0,0,0,82,3368,68,3,0,3439
SCHOOL DIR 2YR HBG,"Oscar L. DOUGLAS, JR.","City--10th Ward, 3rd Precinct",62,0,0,0,62,3368,68,3,0,3439
SCHOOL DIR 2YR HBG,"Oscar L. DOUGLAS, JR.","City--10th Ward, 4th Precinct",110,0,0,0,110,3368,68,3,0,3439
SCHOOL DIR 2YR HBG,"Oscar L. DOUGLAS, JR.",City--11th Ward,87,15,0,0,102,3368,68,3,0,3439
SCHOOL DIR 2YR HBG,"Oscar L. DOUGLAS, JR.",City--12th Ward,183,5,0,0,188,3368,68,3,0,3439
SCHOOL DIR 2YR HBG,"Oscar L. DOUGLAS, JR.","City--13th Ward, 1st Precinct",100,0,0,0,100,3368,68,3,0,3439
SCHOOL DIR 2YR HBG,"Oscar L. DOUGLAS, JR.","City--13th Ward, 2nd Precinct",133,1,0,0,134,3368,68,3,0,3439
SCHOOL DIR 2YR HBG,"Oscar L. DOUGLAS, JR.","City--13th Ward, 3rd Precinct",174,2,0,0,176,3368,68,3,0,3439
SCHOOL DIR 2YR HBG,"Oscar L. DOUGLAS, JR.",City--14th Ward,301,6,0,0,307,3368,68,3,0,3439
SCHOOL DIR 2YR HBG,"Oscar L. DOUGLAS, JR.",City--15th Ward,85,1,0,0,86,3368,68,3,0,3439
SCHOOL DIR 2YR HBG,Randy K. KING,"City--1st Ward, 1st Precinct",73,2,0,0,75,3041,65,3,0,3109
SCHOOL DIR 2YR HBG,Randy K. KING,"City--1st Ward, 2nd Precinct",136,2,1,0,139,3041,65,3,0,3109
SCHOOL DIR 2YR HBG,Randy K. KING,"City--1st Ward, 3rd Precinct",64,0,0,0,64,3041,65,3,0,3109
SCHOOL DIR 2YR HBG,Randy K. KING,"City--2nd Ward, 1st Precinct",28,0,0,0,28,3041,65,3,0,3109
SCHOOL DIR 2YR HBG,Randy K. KING,"City--2nd Ward, 2nd Precinct",66,1,0,0,67,3041,65,3,0,3109
SCHOOL DIR 2YR HBG,Randy K. KING,City--3rd Ward,92,1,0,0,93,3041,65,3,0,3109
SCHOOL DIR 2YR HBG,Randy K. KING,City--4th Ward,116,3,0,0,119,3041,65,3,0,3109
SCHOOL DIR 2YR HBG,Randy K. KING,City--5th Ward,236,7,0,0,243,3041,65,3,0,3109
SCHOOL DIR 2YR HBG,Randy K. KING,City--6th Ward,126,2,2,0,130,3041,65,3,0,3109
SCHOOL DIR 2YR HBG,Randy K. KING,"City--7th Ward, 1st Precinct",38,1,0,0,39,3041,65,3,0,3109
SCHOOL DIR 2YR HBG,Randy K. KING,"City--7th Ward, 2nd Precinct",104,1,0,0,105,3041,65,3,0,3109
SCHOOL DIR 2YR HBG,Randy K. KING,City--8th Ward,105,0,0,0,105,3041,65,3,0,3109
SCHOOL DIR 2YR HBG,Randy K. KING,"City--9th Ward, 1st Precinct",43,2,0,0,45,3041,65,3,0,3109
SCHOOL DIR 2YR HBG,Randy K. KING,"City--9th Ward, 2nd Precinct",77,1,0,0,78,3041,65,3,0,3109
SCHOOL DIR 2YR HBG,Randy K. KING,"City--9th Ward, 3rd Precinct",126,2,0,0,128,3041,65,3,0,3109
SCHOOL DIR 2YR HBG,Randy K. KING,"City--9th Ward, 4th Precinct",139,2,0,0,141,3041,65,3,0,3109
SCHOOL DIR 2YR HBG,Randy K. KING,"City--9th Ward, 5th Precinct",95,4,0,0,99,3041,65,3,0,3109
SCHOOL DIR 2YR HBG,Randy K. KING,"City--10th Ward, 1st Precinct",181,2,0,0,183,3041,65,3,0,3109
SCHOOL DIR 2YR HBG,Randy K. KING,"City--10th Ward, 2nd Precinct",68,0,0,0,68,3041,65,3,0,3109
SCHOOL DIR 2YR HBG,Randy K. KING,"City--10th Ward, 3rd Precinct",68,1,0,0,69,3041,65,3,0,3109
SCHOOL DIR 2YR HBG,Randy K. KING,"City--10th Ward, 4th Precinct",96,0,0,0,96,3041,65,3,0,3109
SCHOOL DIR 2YR HBG,Randy K. KING,City--11th Ward,76,14,0,0,90,3041,65,3,0,3109
SCHOOL DIR 2YR HBG,Randy K. KING,City--12th Ward,172,7,0,0,179,3041,65,3,0,3109
SCHOOL DIR 2YR HBG,Randy K. KING,"City--13th Ward, 1st Precinct",89,0,0,0,89,3041,65,3,0,3109
SCHOOL DIR 2YR HBG,Randy K. KING,"City--13th Ward, 2nd Precinct",116,2,0,0,118,3041,65,3,0,3109
SCHOOL DIR 2YR HBG,Randy K. KING,"City--13th Ward, 3rd Precinct",147,2,0,0,149,3041,65,3,0,3109
SCHOOL DIR 2YR HBG,Randy K. KING,City--14th Ward,291,5,0,0,296,3041,65,3,0,3109
SCHOOL DIR 2YR HBG,Randy K. KING,City--15th Ward,73,1,0,0,74,3041,65,3,0,3109
SCHOOL DIR 2YR HBG,Roy E. CHRIST,"City--1st Ward, 1st Precinct",71,1,0,0,72,2952,59,3,0,3014
SCHOOL DIR 2YR HBG,Roy E. CHRIST,"City--1st Ward, 2nd Precinct",120,2,1,0,123,2952,59,3,0,3014
SCHOOL DIR 2YR HBG,Roy E. CHRIST,"City--1st Ward, 3rd Precinct",56,0,0,0,56,2952,59,3,0,3014
SCHOOL DIR 2YR HBG,Roy E. CHRIST,"City--2nd Ward, 1st Precinct",22,0,0,0,22,2952,59,3,0,3014
SCHOOL DIR 2YR HBG,Roy E. CHRIST,"City--2nd Ward, 2nd Precinct",59,1,0,0,60,2952,59,3,0,3014
SCHOOL DIR 2YR HBG,Roy E. CHRIST,City--3rd Ward,86,1,0,0,87,2952,59,3,0,3014
SCHOOL DIR 2YR HBG,Roy E. CHRIST,City--4th Ward,119,5,0,0,124,2952,59,3,0,3014
SCHOOL DIR 2YR HBG,Roy E. CHRIST,City--5th Ward,250,6,0,0,256,2952,59,3,0,3014
SCHOOL DIR 2YR HBG,Roy E. CHRIST,City--6th Ward,131,2,2,0,135,2952,59,3,0,3014
SCHOOL DIR 2YR HBG,Roy E. CHRIST,"City--7th Ward, 1st Precinct",40,1,0,0,41,2952,59,3,0,3014
SCHOOL DIR 2YR HBG,Roy E. CHRIST,"City--7th Ward, 2nd Precinct",108,1,0,0,109,2952,59,3,0,3014
SCHOOL DIR 2YR HBG,Roy E. CHRIST,City--8th Ward,104,0,0,0,104,2952,59,3,0,3014
SCHOOL DIR 2YR HBG,Roy E. CHRIST,"City--9th Ward, 1st Precinct",41,2,0,0,43,2952,59,3,0,3014
SCHOOL DIR 2YR HBG,Roy E. CHRIST,"City--9th Ward, 2nd Precinct",73,1,0,0,74,2952,59,3,0,3014
SCHOOL DIR 2YR HBG,Roy E. CHRIST,"City--9th Ward, 3rd Precinct",138,0,0,0,138,2952,59,3,0,3014
SCHOOL DIR 2YR HBG,Roy E. CHRIST,"City--9th Ward, 4th Precinct",124,2,0,0,126,2952,59,3,0,3014
SCHOOL DIR 2YR HBG,Roy E. CHRIST,"City--9th Ward, 5th Precinct",93,3,0,0,96,2952,59,3,0,3014
SCHOOL DIR 2YR HBG,Roy E. CHRIST,"City--10th Ward, 1st Precinct",179,2,0,0,181,2952,59,3,0,3014
SCHOOL DIR 2YR HBG,Roy E. CHRIST,"City--10th Ward, 2nd Precinct",65,0,0,0,65,2952,59,3,0,3014
SCHOOL DIR 2YR HBG,Roy E. CHRIST,"City--10th Ward, 3rd Precinct",59,0,0,0,59,2952,59,3,0,3014
SCHOOL DIR 2YR HBG,Roy E. CHRIST,"City--10th Ward, 4th Precinct",89,0,0,0,89,2952,59,3,0,3014
SCHOOL DIR 2YR HBG,Roy E. CHRIST,City--11th Ward,77,15,0,0,92,2952,59,3,0,3014
SCHOOL DIR 2YR HBG,Roy E. CHRIST,City--12th Ward,172,5,0,0,177,2952,59,3,0,3014
SCHOOL DIR 2YR HBG,Roy E. CHRIST,"City--13th Ward, 1st Precinct",87,0,0,0,87,2952,59,3,0,3014
SCHOOL DIR 2YR HBG,Roy E. CHRIST,"City--13th Ward, 2nd Precinct",117,1,0,0,118,2952,59,3,0,3014
SCHOOL DIR 2YR HBG,Roy E. CHRIST,"City--13th Ward, 3rd Precinct",150,2,0,0,152,2952,59,3,0,3014
SCHOOL DIR 2YR HBG,Roy E. CHRIST,City--14th Ward,253,5,0,0,258,2952,59,3,0,3014
SCHOOL DIR 2YR HBG,Roy E. CHRIST,City--15th Ward,69,1,0,0,70,2952,59,3,0,3014
SCHOOL DIR 2YR HBG,Write In  ,"City--1st Ward, 1st Precinct",0,0,0,0,0,10,0,0,0,10
SCHOOL DIR 2YR HBG,Write In  ,"City--1st Ward, 2nd Precinct",0,0,0,0,0,10,0,0,0,10
SCHOOL DIR 2YR HBG,Write In  ,"City--1st Ward, 3rd Precinct",0,0,0,0,0,10,0,0,0,10
SCHOOL DIR 2YR HBG,Write In  ,"City--2nd Ward, 1st Precinct",0,0,0,0,0,10,0,0,0,10
SCHOOL DIR 2YR HBG,Write In  ,"City--2nd Ward, 2nd Precinct",0,0,0,0,0,10,0,0,0,10
SCHOOL DIR 2YR HBG,Write In  ,City--3rd Ward,0,0,0,0,0,10,0,0,0,10
SCHOOL DIR 2YR HBG,Write In  ,City--4th Ward,0,0,0,0,0,10,0,0,0,10
SCHOOL DIR 2YR HBG,Write In  ,City--5th Ward,3,0,0,0,3,10,0,0,0,10
SCHOOL DIR 2YR HBG,Write In  ,City--6th Ward,2,0,0,0,2,10,0,0,0,10
SCHOOL DIR 2YR HBG,Write In  ,"City--7th Ward, 1st Precinct",0,0,0,0,0,10,0,0,0,10
SCHOOL DIR 2YR HBG,Write In  ,"City--7th Ward, 2nd Precinct",0,0,0,0,0,10,0,0,0,10
SCHOOL DIR 2YR HBG,Write In  ,City--8th Ward,0,0,0,0,0,10,0,0,0,10
SCHOOL DIR 2YR HBG,Write In  ,"City--9th Ward, 1st Precinct",0,0,0,0,0,10,0,0,0,10
SCHOOL DIR 2YR HBG,Write In  ,"City--9th Ward, 2nd Precinct",0,0,0,0,0,10,0,0,0,10
SCHOOL DIR 2YR HBG,Write In  ,"City--9th Ward, 3rd Precinct",0,0,0,0,0,10,0,0,0,10
SCHOOL DIR 2YR HBG,Write In  ,"City--9th Ward, 4th Precinct",0,0,0,0,0,10,0,0,0,10
SCHOOL DIR 2YR HBG,Write In  ,"City--9th Ward, 5th Precinct",0,0,0,0,0,10,0,0,0,10
SCHOOL DIR 2YR HBG,Write In  ,"City--10th Ward, 1st Precinct",0,0,0,0,0,10,0,0,0,10
SCHOOL DIR 2YR HBG,Write In  ,"City--10th Ward, 2nd Precinct",0,0,0,0,0,10,0,0,0,10
SCHOOL DIR 2YR HBG,Write In  ,"City--10th Ward, 3rd Precinct",0,0,0,0,0,10,0,0,0,10
SCHOOL DIR 2YR HBG,Write In  ,"City--10th Ward, 4th Precinct",1,0,0,0,1,10,0,0,0,10
SCHOOL DIR 2YR HBG,Write In  ,City--11th Ward,0,0,0,0,0,10,0,0,0,10
SCHOOL DIR 2YR HBG,Write In  ,City--12th Ward,0,0,0,0,0,10,0,0,0,10
SCHOOL DIR 2YR HBG,Write In  ,"City--13th Ward, 1st Precinct",0,0,0,0,0,10,0,0,0,10
SCHOOL DIR 2YR HBG,Write In  ,"City--13th Ward, 2nd Precinct",0,0,0,0,0,10,0,0,0,10
SCHOOL DIR 2YR HBG,Write In  ,"City--13th Ward, 3rd Precinct",2,0,0,0,2,10,0,0,0,10
SCHOOL DIR 2YR HBG,Write In  ,City--14th Ward,2,0,0,0,2,10,0,0,0,10
SCHOOL DIR 2YR HBG,Write In  ,City--15th Ward,0,0,0,0,0,10,0,0,0,10
SCHOOL DIR 2YR MDLT,Jay R. BURNS,"Middletown--1st Ward, 1st Precinct",69,0,0,0,69,1573,33,1,0,1607
SCHOOL DIR 2YR MDLT,Jay R. BURNS,"Middletown--1st Ward, 2nd Precinct",111,5,1,0,117,1573,33,1,0,1607
SCHOOL DIR 2YR MDLT,Jay R. BURNS,"Middletown--2nd Ward, 1st Precinct",114,1,0,0,115,1573,33,1,0,1607
SCHOOL DIR 2YR MDLT,Jay R. BURNS,"Middletown--2nd Ward, 2nd Precinct",118,3,0,0,121,1573,33,1,0,1607
SCHOOL DIR 2YR MDLT,Jay R. BURNS,"Middletown--3rd Ward, 1st Precinct",83,2,0,0,85,1573,33,1,0,1607
SCHOOL DIR 2YR MDLT,Jay R. BURNS,"Middletown--3rd Ward, 2nd Precinct",148,0,0,0,148,1573,33,1,0,1607
SCHOOL DIR 2YR MDLT,Jay R. BURNS,Royalton Borough--1st Ward,23,0,0,0,23,1573,33,1,0,1607
SCHOOL DIR 2YR MDLT,Jay R. BURNS,Royalton Borough--2nd Ward,58,0,0,0,58,1573,33,1,0,1607
SCHOOL DIR 2YR MDLT,Jay R. BURNS,Lower Swatara Twp--1st Precinct,277,2,0,0,279,1573,33,1,0,1607
SCHOOL DIR 2YR MDLT,Jay R. BURNS,Lower Swatara Twp--2nd Precinct,221,4,0,0,225,1573,33,1,0,1607
SCHOOL DIR 2YR MDLT,Jay R. BURNS,Lower Swatara Twp--3rd Precinct,176,16,0,0,192,1573,33,1,0,1607
SCHOOL DIR 2YR MDLT,Jay R. BURNS,Lower Swatara Twp--4th Precinct,175,0,0,0,175,1573,33,1,0,1607
SCHOOL DIR 2YR MDLT,Mary G. SHENK,"Middletown--1st Ward, 1st Precinct",33,0,0,0,33,877,21,0,0,898
SCHOOL DIR 2YR MDLT,Mary G. SHENK,"Middletown--1st Ward, 2nd Precinct",63,0,0,0,63,877,21,0,0,898
SCHOOL DIR 2YR MDLT,Mary G. SHENK,"Middletown--2nd Ward, 1st Precinct",71,0,0,0,71,877,21,0,0,898
SCHOOL DIR 2YR MDLT,Mary G. SHENK,"Middletown--2nd Ward, 2nd Precinct",70,2,0,0,72,877,21,0,0,898
SCHOOL DIR 2YR MDLT,Mary G. SHENK,"Middletown--3rd Ward, 1st Precinct",47,1,0,0,48,877,21,0,0,898
SCHOOL DIR 2YR MDLT,Mary G. SHENK,"Middletown--3rd Ward, 2nd Precinct",79,0,0,0,79,877,21,0,0,898
SCHOOL DIR 2YR MDLT,Mary G. SHENK,Royalton Borough--1st Ward,26,0,0,0,26,877,21,0,0,898
SCHOOL DIR 2YR MDLT,Mary G. SHENK,Royalton Borough--2nd Ward,19,0,0,0,19,877,21,0,0,898
SCHOOL DIR 2YR MDLT,Mary G. SHENK,Lower Swatara Twp--1st Precinct,107,1,0,0,108,877,21,0,0,898
SCHOOL DIR 2YR MDLT,Mary G. SHENK,Lower Swatara Twp--2nd Precinct,130,4,0,0,134,877,21,0,0,898
SCHOOL DIR 2YR MDLT,Mary G. SHENK,Lower Swatara Twp--3rd Precinct,124,13,0,0,137,877,21,0,0,898
SCHOOL DIR 2YR MDLT,Mary G. SHENK,Lower Swatara Twp--4th Precinct,108,0,0,0,108,877,21,0,0,898
SCHOOL DIR 2YR MDLT,"Melvin A. FAGER, JR.","Middletown--1st Ward, 1st Precinct",92,0,0,0,92,2085,45,0,0,2130
SCHOOL DIR 2YR MDLT,"Melvin A. FAGER, JR.","Middletown--1st Ward, 2nd Precinct",142,6,0,0,148,2085,45,0,0,2130
SCHOOL DIR 2YR MDLT,"Melvin A. FAGER, JR.","Middletown--2nd Ward, 1st Precinct",147,1,0,0,148,2085,45,0,0,2130
SCHOOL DIR 2YR MDLT,"Melvin A. FAGER, JR.","Middletown--2nd Ward, 2nd Precinct",152,2,0,0,154,2085,45,0,0,2130
SCHOOL DIR 2YR MDLT,"Melvin A. FAGER, JR.","Middletown--3rd Ward, 1st Precinct",126,3,0,0,129,2085,45,0,0,2130
SCHOOL DIR 2YR MDLT,"Melvin A. FAGER, JR.","Middletown--3rd Ward, 2nd Precinct",191,0,0,0,191,2085,45,0,0,2130
SCHOOL DIR 2YR MDLT,"Melvin A. FAGER, JR.",Royalton Borough--1st Ward,41,0,0,0,41,2085,45,0,0,2130
SCHOOL DIR 2YR MDLT,"Melvin A. FAGER, JR.",Royalton Borough--2nd Ward,78,0,0,0,78,2085,45,0,0,2130
SCHOOL DIR 2YR MDLT,"Melvin A. FAGER, JR.",Lower Swatara Twp--1st Precinct,335,3,0,0,338,2085,45,0,0,2130
SCHOOL DIR 2YR MDLT,"Melvin A. FAGER, JR.",Lower Swatara Twp--2nd Precinct,281,8,0,0,289,2085,45,0,0,2130
SCHOOL DIR 2YR MDLT,"Melvin A. FAGER, JR.",Lower Swatara Twp--3rd Precinct,255,22,0,0,277,2085,45,0,0,2130
SCHOOL DIR 2YR MDLT,"Melvin A. FAGER, JR.",Lower Swatara Twp--4th Precinct,245,0,0,0,245,2085,45,0,0,2130
SCHOOL DIR 2YR MDLT,Write In  ,"Middletown--1st Ward, 1st Precinct",0,0,0,0,0,7,0,0,0,7
SCHOOL DIR 2YR MDLT,Write In  ,"Middletown--1st Ward, 2nd Precinct",0,0,0,0,0,7,0,0,0,7
SCHOOL DIR 2YR MDLT,Write In  ,"Middletown--2nd Ward, 1st Precinct",0,0,0,0,0,7,0,0,0,7
SCHOOL DIR 2YR MDLT,Write In  ,"Middletown--2nd Ward, 2nd Precinct",0,0,0,0,0,7,0,0,0,7
SCHOOL DIR 2YR MDLT,Write In  ,"Middletown--3rd Ward, 1st Precinct",1,0,0,0,1,7,0,0,0,7
SCHOOL DIR 2YR MDLT,Write In  ,"Middletown--3rd Ward, 2nd Precinct",1,0,0,0,1,7,0,0,0,7
SCHOOL DIR 2YR MDLT,Write In  ,Royalton Borough--1st Ward,0,0,0,0,0,7,0,0,0,7
SCHOOL DIR 2YR MDLT,Write In  ,Royalton Borough--2nd Ward,2,0,0,0,2,7,0,0,0,7
SCHOOL DIR 2YR MDLT,Write In  ,Lower Swatara Twp--1st Precinct,2,0,0,0,2,7,0,0,0,7
SCHOOL DIR 2YR MDLT,Write In  ,Lower Swatara Twp--2nd Precinct,0,0,0,0,0,7,0,0,0,7
SCHOOL DIR 2YR MDLT,Write In  ,Lower Swatara Twp--3rd Precinct,1,0,0,0,1,7,0,0,0,7
SCHOOL DIR 2YR MDLT,Write In  ,Lower Swatara Twp--4th Precinct,0,0,0,0,0,7,0,0,0,7
SCHOOL DIR 2YR STEEL/HIGH,Samuel  PETROVICH,Highspire--1st Precinct,150,2,0,0,152,907,9,0,0,916
SCHOOL DIR 2YR STEEL/HIGH,Samuel  PETROVICH,Highspire--2nd Precinct,158,1,0,0,159,907,9,0,0,916
SCHOOL DIR 2YR STEEL/HIGH,Samuel  PETROVICH,Steelton--1st Ward,136,4,0,0,140,907,9,0,0,916
SCHOOL DIR 2YR STEEL/HIGH,Samuel  PETROVICH,"Steelton--2nd Ward, 1st Precinct",117,0,0,0,117,907,9,0,0,916
SCHOOL DIR 2YR STEEL/HIGH,Samuel  PETROVICH,"Steelton--2nd Ward, 2nd Precinct",82,0,0,0,82,907,9,0,0,916
SCHOOL DIR 2YR STEEL/HIGH,Samuel  PETROVICH,"Steelton--3rd Ward, 1st Precinct",50,0,0,0,50,907,9,0,0,916
SCHOOL DIR 2YR STEEL/HIGH,Samuel  PETROVICH,"Steelton--3rd Ward, 2nd Precinct",114,0,0,0,114,907,9,0,0,916
SCHOOL DIR 2YR STEEL/HIGH,Samuel  PETROVICH,Steelton--4th Ward,100,2,0,0,102,907,9,0,0,916
SCHOOL DIR 2YR STEEL/HIGH,Write In  ,Highspire--1st Precinct,0,0,0,0,0,2,0,0,0,2
SCHOOL DIR 2YR STEEL/HIGH,Write In  ,Highspire--2nd Precinct,0,0,0,0,0,2,0,0,0,2
SCHOOL DIR 2YR STEEL/HIGH,Write In  ,Steelton--1st Ward,1,0,0,0,1,2,0,0,0,2
SCHOOL DIR 2YR STEEL/HIGH,Write In  ,"Steelton--2nd Ward, 1st Precinct",1,0,0,0,1,2,0,0,0,2
SCHOOL DIR 2YR STEEL/HIGH,Write In  ,"Steelton--2nd Ward, 2nd Precinct",0,0,0,0,0,2,0,0,0,2
SCHOOL DIR 2YR STEEL/HIGH,Write In  ,"Steelton--3rd Ward, 1st Precinct",0,0,0,0,0,2,0,0,0,2
SCHOOL DIR 2YR STEEL/HIGH,Write In  ,"Steelton--3rd Ward, 2nd Precinct",0,0,0,0,0,2,0,0,0,2
SCHOOL DIR 2YR STEEL/HIGH,Write In  ,Steelton--4th Ward,0,0,0,0,0,2,0,0,0,2
SCHOOL DIR 4YR  STEEL/HIGH,Barry L. BAUMGARDNER,Highspire--1st Precinct,131,2,0,0,133,803,9,0,0,812
SCHOOL DIR 4YR  STEEL/HIGH,Barry L. BAUMGARDNER,Highspire--2nd Precinct,118,0,0,0,118,803,9,0,0,812
SCHOOL DIR 4YR  STEEL/HIGH,Barry L. BAUMGARDNER,Steelton--1st Ward,137,3,0,0,140,803,9,0,0,812
SCHOOL DIR 4YR  STEEL/HIGH,Barry L. BAUMGARDNER,"Steelton--2nd Ward, 1st Precinct",98,2,0,0,100,803,9,0,0,812
SCHOOL DIR 4YR  STEEL/HIGH,Barry L. BAUMGARDNER,"Steelton--2nd Ward, 2nd Precinct",75,0,0,0,75,803,9,0,0,812
SCHOOL DIR 4YR  STEEL/HIGH,Barry L. BAUMGARDNER,"Steelton--3rd Ward, 1st Precinct",50,0,0,0,50,803,9,0,0,812
SCHOOL DIR 4YR  STEEL/HIGH,Barry L. BAUMGARDNER,"Steelton--3rd Ward, 2nd Precinct",98,0,0,0,98,803,9,0,0,812
SCHOOL DIR 4YR  STEEL/HIGH,Barry L. BAUMGARDNER,Steelton--4th Ward,96,2,0,0,98,803,9,0,0,812
SCHOOL DIR 4YR  STEEL/HIGH,Bernice L. BAUMGARDNER,Highspire--1st Precinct,72,1,0,0,73,434,7,0,0,441
SCHOOL DIR 4YR  STEEL/HIGH,Bernice L. BAUMGARDNER,Highspire--2nd Precinct,69,0,0,0,69,434,7,0,0,441
SCHOOL DIR 4YR  STEEL/HIGH,Bernice L. BAUMGARDNER,Steelton--1st Ward,79,2,0,0,81,434,7,0,0,441
SCHOOL DIR 4YR  STEEL/HIGH,Bernice L. BAUMGARDNER,"Steelton--2nd Ward, 1st Precinct",39,2,0,0,41,434,7,0,0,441
SCHOOL DIR 4YR  STEEL/HIGH,Bernice L. BAUMGARDNER,"Steelton--2nd Ward, 2nd Precinct",45,0,0,0,45,434,7,0,0,441
SCHOOL DIR 4YR  STEEL/HIGH,Bernice L. BAUMGARDNER,"Steelton--3rd Ward, 1st Precinct",26,0,0,0,26,434,7,0,0,441
SCHOOL DIR 4YR  STEEL/HIGH,Bernice L. BAUMGARDNER,"Steelton--3rd Ward, 2nd Precinct",47,0,0,0,47,434,7,0,0,441
SCHOOL DIR 4YR  STEEL/HIGH,Bernice L. BAUMGARDNER,Steelton--4th Ward,57,2,0,0,59,434,7,0,0,441
SCHOOL DIR 4YR  STEEL/HIGH,Joseph M. PILSITZ,Highspire--1st Precinct,85,2,0,0,87,463,9,0,0,472
SCHOOL DIR 4YR  STEEL/HIGH,Joseph M. PILSITZ,Highspire--2nd Precinct,88,0,0,0,88,463,9,0,0,472
SCHOOL DIR 4YR  STEEL/HIGH,Joseph M. PILSITZ,Steelton--1st Ward,81,4,0,0,85,463,9,0,0,472
SCHOOL DIR 4YR  STEEL/HIGH,Joseph M. PILSITZ,"Steelton--2nd Ward, 1st Precinct",43,2,0,0,45,463,9,0,0,472
SCHOOL DIR 4YR  STEEL/HIGH,Joseph M. PILSITZ,"Steelton--2nd Ward, 2nd Precinct",42,1,0,0,43,463,9,0,0,472
SCHOOL DIR 4YR  STEEL/HIGH,Joseph M. PILSITZ,"Steelton--3rd Ward, 1st Precinct",22,0,0,0,22,463,9,0,0,472
SCHOOL DIR 4YR  STEEL/HIGH,Joseph M. PILSITZ,"Steelton--3rd Ward, 2nd Precinct",54,0,0,0,54,463,9,0,0,472
SCHOOL DIR 4YR  STEEL/HIGH,Joseph M. PILSITZ,Steelton--4th Ward,48,0,0,0,48,463,9,0,0,472
SCHOOL DIR 4YR  STEEL/HIGH,Mary  CARRICATO,Highspire--1st Precinct,134,2,0,0,136,838,13,0,0,851
SCHOOL DIR 4YR  STEEL/HIGH,Mary  CARRICATO,Highspire--2nd Precinct,140,0,0,0,140,838,13,0,0,851
SCHOOL DIR 4YR  STEEL/HIGH,Mary  CARRICATO,Steelton--1st Ward,140,6,0,0,146,838,13,0,0,851
SCHOOL DIR 4YR  STEEL/HIGH,Mary  CARRICATO,"Steelton--2nd Ward, 1st Precinct",100,2,0,0,102,838,13,0,0,851
SCHOOL DIR 4YR  STEEL/HIGH,Mary  CARRICATO,"Steelton--2nd Ward, 2nd Precinct",80,1,0,0,81,838,13,0,0,851
SCHOOL DIR 4YR  STEEL/HIGH,Mary  CARRICATO,"Steelton--3rd Ward, 1st Precinct",45,0,0,0,45,838,13,0,0,851
SCHOOL DIR 4YR  STEEL/HIGH,Mary  CARRICATO,"Steelton--3rd Ward, 2nd Precinct",100,0,0,0,100,838,13,0,0,851
SCHOOL DIR 4YR  STEEL/HIGH,Mary  CARRICATO,Steelton--4th Ward,99,2,0,0,101,838,13,0,0,851
SCHOOL DIR 4YR  STEEL/HIGH,Rachel  SLADE,Highspire--1st Precinct,64,1,0,0,65,550,4,0,0,554
SCHOOL DIR 4YR  STEEL/HIGH,Rachel  SLADE,Highspire--2nd Precinct,76,0,0,0,76,550,4,0,0,554
SCHOOL DIR 4YR  STEEL/HIGH,Rachel  SLADE,Steelton--1st Ward,79,3,0,0,82,550,4,0,0,554
SCHOOL DIR 4YR  STEEL/HIGH,Rachel  SLADE,"Steelton--2nd Ward, 1st Precinct",86,0,0,0,86,550,4,0,0,554
SCHOOL DIR 4YR  STEEL/HIGH,Rachel  SLADE,"Steelton--2nd Ward, 2nd Precinct",35,0,0,0,35,550,4,0,0,554
SCHOOL DIR 4YR  STEEL/HIGH,Rachel  SLADE,"Steelton--3rd Ward, 1st Precinct",33,0,0,0,33,550,4,0,0,554
SCHOOL DIR 4YR  STEEL/HIGH,Rachel  SLADE,"Steelton--3rd Ward, 2nd Precinct",92,0,0,0,92,550,4,0,0,554
SCHOOL DIR 4YR  STEEL/HIGH,Rachel  SLADE,Steelton--4th Ward,85,0,0,0,85,550,4,0,0,554
SCHOOL DIR 4YR  STEEL/HIGH,Samuel  PETROVICH,Highspire--1st Precinct,127,2,0,0,129,785,9,0,0,794
SCHOOL DIR 4YR  STEEL/HIGH,Samuel  PETROVICH,Highspire--2nd Precinct,135,1,0,0,136,785,9,0,0,794
SCHOOL DIR 4YR  STEEL/HIGH,Samuel  PETROVICH,Steelton--1st Ward,145,3,0,0,148,785,9,0,0,794
SCHOOL DIR 4YR  STEEL/HIGH,Samuel  PETROVICH,"Steelton--2nd Ward, 1st Precinct",96,2,0,0,98,785,9,0,0,794
SCHOOL DIR 4YR  STEEL/HIGH,Samuel  PETROVICH,"Steelton--2nd Ward, 2nd Precinct",73,1,0,0,74,785,9,0,0,794
SCHOOL DIR 4YR  STEEL/HIGH,Samuel  PETROVICH,"Steelton--3rd Ward, 1st Precinct",41,0,0,0,41,785,9,0,0,794
SCHOOL DIR 4YR  STEEL/HIGH,Samuel  PETROVICH,"Steelton--3rd Ward, 2nd Precinct",92,0,0,0,92,785,9,0,0,794
SCHOOL DIR 4YR  STEEL/HIGH,Samuel  PETROVICH,Steelton--4th Ward,76,0,0,0,76,785,9,0,0,794
SCHOOL DIR 4YR  STEEL/HIGH,Sarah F. METALLO,Highspire--1st Precinct,80,2,0,0,82,485,6,0,0,491
SCHOOL DIR 4YR  STEEL/HIGH,Sarah F. METALLO,Highspire--2nd Precinct,89,1,0,0,90,485,6,0,0,491
SCHOOL DIR 4YR  STEEL/HIGH,Sarah F. METALLO,Steelton--1st Ward,69,3,0,0,72,485,6,0,0,491
SCHOOL DIR 4YR  STEEL/HIGH,Sarah F. METALLO,"Steelton--2nd Ward, 1st Precinct",67,0,0,0,67,485,6,0,0,491
SCHOOL DIR 4YR  STEEL/HIGH,Sarah F. METALLO,"Steelton--2nd Ward, 2nd Precinct",42,0,0,0,42,485,6,0,0,491
SCHOOL DIR 4YR  STEEL/HIGH,Sarah F. METALLO,"Steelton--3rd Ward, 1st Precinct",30,0,0,0,30,485,6,0,0,491
SCHOOL DIR 4YR  STEEL/HIGH,Sarah F. METALLO,"Steelton--3rd Ward, 2nd Precinct",54,0,0,0,54,485,6,0,0,491
SCHOOL DIR 4YR  STEEL/HIGH,Sarah F. METALLO,Steelton--4th Ward,54,0,0,0,54,485,6,0,0,491
SCHOOL DIR 4YR  STEEL/HIGH,Write In  ,Highspire--1st Precinct,0,0,0,0,0,0,0,0,0,0
SCHOOL DIR 4YR  STEEL/HIGH,Write In  ,Highspire--2nd Precinct,0,0,0,0,0,0,0,0,0,0
SCHOOL DIR 4YR  STEEL/HIGH,Write In  ,Steelton--1st Ward,0,0,0,0,0,0,0,0,0,0
SCHOOL DIR 4YR  STEEL/HIGH,Write In  ,"Steelton--2nd Ward, 1st Precinct",0,0,0,0,0,0,0,0,0,0
SCHOOL DIR 4YR  STEEL/HIGH,Write In  ,"Steelton--2nd Ward, 2nd Precinct",0,0,0,0,0,0,0,0,0,0
SCHOOL DIR 4YR  STEEL/HIGH,Write In  ,"Steelton--3rd Ward, 1st Precinct",0,0,0,0,0,0,0,0,0,0
SCHOOL DIR 4YR  STEEL/HIGH,Write In  ,"Steelton--3rd Ward, 2nd Precinct",0,0,0,0,0,0,0,0,0,0
SCHOOL DIR 4YR  STEEL/HIGH,Write In  ,Steelton--4th Ward,0,0,0,0,0,0,0,0,0,0
SCHOOL DIR 4YR DERRY,Beulah  CHABAL,Derry Township--1st Precinct,292,4,0,0,296,3152,55,2,0,3209
SCHOOL DIR 4YR DERRY,Beulah  CHABAL,Derry Township--2nd Precinct,256,4,0,0,260,3152,55,2,0,3209
SCHOOL DIR 4YR DERRY,Beulah  CHABAL,Derry Township--3rd Precinct,205,3,0,0,208,3152,55,2,0,3209
SCHOOL DIR 4YR DERRY,Beulah  CHABAL,Derry Township--4th Precinct,164,4,0,0,168,3152,55,2,0,3209
SCHOOL DIR 4YR DERRY,Beulah  CHABAL,Derry Township--5th Precinct,128,2,0,0,130,3152,55,2,0,3209
SCHOOL DIR 4YR DERRY,Beulah  CHABAL,Derry Township--6th Precinct,157,1,1,0,159,3152,55,2,0,3209
SCHOOL DIR 4YR DERRY,Beulah  CHABAL,Derry Township--7th Precinct,308,11,0,0,319,3152,55,2,0,3209
SCHOOL DIR 4YR DERRY,Beulah  CHABAL,Derry Township--8th Precinct,161,0,0,0,161,3152,55,2,0,3209
SCHOOL DIR 4YR DERRY,Beulah  CHABAL,Derry Township--9th Precinct,119,4,0,0,123,3152,55,2,0,3209
SCHOOL DIR 4YR DERRY,Beulah  CHABAL,Derry Township--10th Precinct,217,3,0,0,220,3152,55,2,0,3209
SCHOOL DIR 4YR DERRY,Beulah  CHABAL,Derry Township--11th Precinct,298,4,0,0,302,3152,55,2,0,3209
SCHOOL DIR 4YR DERRY,Beulah  CHABAL,Derry Township--12th Precinct,173,2,0,0,175,3152,55,2,0,3209
SCHOOL DIR 4YR DERRY,Beulah  CHABAL,Derry Township--13th Precinct,218,3,0,0,221,3152,55,2,0,3209
SCHOOL DIR 4YR DERRY,Beulah  CHABAL,Derry Township--14th Precinct,159,6,0,0,165,3152,55,2,0,3209
SCHOOL DIR 4YR DERRY,Beulah  CHABAL,Derry Township--15th Precinct,297,4,1,0,302,3152,55,2,0,3209
SCHOOL DIR 4YR DERRY,Charles N. STOVER,Derry Township--1st Precinct,309,5,0,0,314,3355,71,2,0,3428
SCHOOL DIR 4YR DERRY,Charles N. STOVER,Derry Township--2nd Precinct,261,4,0,0,265,3355,71,2,0,3428
SCHOOL DIR 4YR DERRY,Charles N. STOVER,Derry Township--3rd Precinct,227,4,0,0,231,3355,71,2,0,3428
SCHOOL DIR 4YR DERRY,Charles N. STOVER,Derry Township--4th Precinct,182,4,0,0,186,3355,71,2,0,3428
SCHOOL DIR 4YR DERRY,Charles N. STOVER,Derry Township--5th Precinct,132,3,0,0,135,3355,71,2,0,3428
SCHOOL DIR 4YR DERRY,Charles N. STOVER,Derry Township--6th Precinct,169,2,1,0,172,3355,71,2,0,3428
SCHOOL DIR 4YR DERRY,Charles N. STOVER,Derry Township--7th Precinct,327,13,0,0,340,3355,71,2,0,3428
SCHOOL DIR 4YR DERRY,Charles N. STOVER,Derry Township--8th Precinct,174,0,0,0,174,3355,71,2,0,3428
SCHOOL DIR 4YR DERRY,Charles N. STOVER,Derry Township--9th Precinct,134,4,0,0,138,3355,71,2,0,3428
SCHOOL DIR 4YR DERRY,Charles N. STOVER,Derry Township--10th Precinct,229,3,0,0,232,3355,71,2,0,3428
SCHOOL DIR 4YR DERRY,Charles N. STOVER,Derry Township--11th Precinct,325,6,0,0,331,3355,71,2,0,3428
SCHOOL DIR 4YR DERRY,Charles N. STOVER,Derry Township--12th Precinct,169,3,0,0,172,3355,71,2,0,3428
SCHOOL DIR 4YR DERRY,Charles N. STOVER,Derry Township--13th Precinct,251,10,0,0,261,3355,71,2,0,3428
SCHOOL DIR 4YR DERRY,Charles N. STOVER,Derry Township--14th Precinct,174,7,0,0,181,3355,71,2,0,3428
SCHOOL DIR 4YR DERRY,Charles N. STOVER,Derry Township--15th Precinct,292,3,1,0,296,3355,71,2,0,3428
SCHOOL DIR 4YR DERRY,Ellen  SHEFFEY,Derry Township--1st Precinct,341,5,0,0,346,3472,66,1,0,3539
SCHOOL DIR 4YR DERRY,Ellen  SHEFFEY,Derry Township--2nd Precinct,273,4,0,0,277,3472,66,1,0,3539
SCHOOL DIR 4YR DERRY,Ellen  SHEFFEY,Derry Township--3rd Precinct,226,3,0,0,229,3472,66,1,0,3539
SCHOOL DIR 4YR DERRY,Ellen  SHEFFEY,Derry Township--4th Precinct,176,2,0,0,178,3472,66,1,0,3539
SCHOOL DIR 4YR DERRY,Ellen  SHEFFEY,Derry Township--5th Precinct,138,2,0,0,140,3472,66,1,0,3539
SCHOOL DIR 4YR DERRY,Ellen  SHEFFEY,Derry Township--6th Precinct,171,2,0,0,173,3472,66,1,0,3539
SCHOOL DIR 4YR DERRY,Ellen  SHEFFEY,Derry Township--7th Precinct,366,14,0,0,380,3472,66,1,0,3539
SCHOOL DIR 4YR DERRY,Ellen  SHEFFEY,Derry Township--8th Precinct,188,0,0,0,188,3472,66,1,0,3539
SCHOOL DIR 4YR DERRY,Ellen  SHEFFEY,Derry Township--9th Precinct,129,4,0,0,133,3472,66,1,0,3539
SCHOOL DIR 4YR DERRY,Ellen  SHEFFEY,Derry Township--10th Precinct,231,3,0,0,234,3472,66,1,0,3539
SCHOOL DIR 4YR DERRY,Ellen  SHEFFEY,Derry Township--11th Precinct,320,8,0,0,328,3472,66,1,0,3539
SCHOOL DIR 4YR DERRY,Ellen  SHEFFEY,Derry Township--12th Precinct,163,3,0,0,166,3472,66,1,0,3539
SCHOOL DIR 4YR DERRY,Ellen  SHEFFEY,Derry Township--13th Precinct,249,4,0,0,253,3472,66,1,0,3539
SCHOOL DIR 4YR DERRY,Ellen  SHEFFEY,Derry Township--14th Precinct,177,6,0,0,183,3472,66,1,0,3539
SCHOOL DIR 4YR DERRY,Ellen  SHEFFEY,Derry Township--15th Precinct,324,6,1,0,331,3472,66,1,0,3539
SCHOOL DIR 4YR DERRY,Henry J. Hank DONAHUE,Derry Township--1st Precinct,249,5,0,0,254,2450,61,1,0,2512
SCHOOL DIR 4YR DERRY,Henry J. Hank DONAHUE,Derry Township--2nd Precinct,174,5,0,0,179,2450,61,1,0,2512
SCHOOL DIR 4YR DERRY,Henry J. Hank DONAHUE,Derry Township--3rd Precinct,129,3,0,0,132,2450,61,1,0,2512
SCHOOL DIR 4YR DERRY,Henry J. Hank DONAHUE,Derry Township--4th Precinct,115,5,0,0,120,2450,61,1,0,2512
SCHOOL DIR 4YR DERRY,Henry J. Hank DONAHUE,Derry Township--5th Precinct,103,2,0,0,105,2450,61,1,0,2512
SCHOOL DIR 4YR DERRY,Henry J. Hank DONAHUE,Derry Township--6th Precinct,124,0,0,0,124,2450,61,1,0,2512
SCHOOL DIR 4YR DERRY,Henry J. Hank DONAHUE,Derry Township--7th Precinct,275,14,0,0,289,2450,61,1,0,2512
SCHOOL DIR 4YR DERRY,Henry J. Hank DONAHUE,Derry Township--8th Precinct,127,0,0,0,127,2450,61,1,0,2512
SCHOOL DIR 4YR DERRY,Henry J. Hank DONAHUE,Derry Township--9th Precinct,82,4,0,0,86,2450,61,1,0,2512
SCHOOL DIR 4YR DERRY,Henry J. Hank DONAHUE,Derry Township--10th Precinct,179,2,0,0,181,2450,61,1,0,2512
SCHOOL DIR 4YR DERRY,Henry J. Hank DONAHUE,Derry Township--11th Precinct,217,5,0,0,222,2450,61,1,0,2512
SCHOOL DIR 4YR DERRY,Henry J. Hank DONAHUE,Derry Township--12th Precinct,136,1,0,0,137,2450,61,1,0,2512
SCHOOL DIR 4YR DERRY,Henry J. Hank DONAHUE,Derry Township--13th Precinct,178,5,0,0,183,2450,61,1,0,2512
SCHOOL DIR 4YR DERRY,Henry J. Hank DONAHUE,Derry Township--14th Precinct,120,5,0,0,125,2450,61,1,0,2512
SCHOOL DIR 4YR DERRY,Henry J. Hank DONAHUE,Derry Township--15th Precinct,242,5,1,0,248,2450,61,1,0,2512
SCHOOL DIR 4YR DERRY,Selma D SANDERS-WEST,Derry Township--1st Precinct,157,1,0,0,158,1509,32,0,0,1541
SCHOOL DIR 4YR DERRY,Selma D SANDERS-WEST,Derry Township--2nd Precinct,116,3,0,0,119,1509,32,0,0,1541
SCHOOL DIR 4YR DERRY,Selma D SANDERS-WEST,Derry Township--3rd Precinct,128,4,0,0,132,1509,32,0,0,1541
SCHOOL DIR 4YR DERRY,Selma D SANDERS-WEST,Derry Township--4th Precinct,74,2,0,0,76,1509,32,0,0,1541
SCHOOL DIR 4YR DERRY,Selma D SANDERS-WEST,Derry Township--5th Precinct,58,1,0,0,59,1509,32,0,0,1541
SCHOOL DIR 4YR DERRY,Selma D SANDERS-WEST,Derry Township--6th Precinct,71,0,0,0,71,1509,32,0,0,1541
SCHOOL DIR 4YR DERRY,Selma D SANDERS-WEST,Derry Township--7th Precinct,152,7,0,0,159,1509,32,0,0,1541
SCHOOL DIR 4YR DERRY,Selma D SANDERS-WEST,Derry Township--8th Precinct,74,0,0,0,74,1509,32,0,0,1541
SCHOOL DIR 4YR DERRY,Selma D SANDERS-WEST,Derry Township--9th Precinct,51,2,0,0,53,1509,32,0,0,1541
SCHOOL DIR 4YR DERRY,Selma D SANDERS-WEST,Derry Township--10th Precinct,82,2,0,0,84,1509,32,0,0,1541
SCHOOL DIR 4YR DERRY,Selma D SANDERS-WEST,Derry Township--11th Precinct,147,0,0,0,147,1509,32,0,0,1541
SCHOOL DIR 4YR DERRY,Selma D SANDERS-WEST,Derry Township--12th Precinct,80,2,0,0,82,1509,32,0,0,1541
SCHOOL DIR 4YR DERRY,Selma D SANDERS-WEST,Derry Township--13th Precinct,117,2,0,0,119,1509,32,0,0,1541
SCHOOL DIR 4YR DERRY,Selma D SANDERS-WEST,Derry Township--14th Precinct,71,2,0,0,73,1509,32,0,0,1541
SCHOOL DIR 4YR DERRY,Selma D SANDERS-WEST,Derry Township--15th Precinct,131,4,0,0,135,1509,32,0,0,1541
SCHOOL DIR 4YR DERRY,William M. PARRISH,Derry Township--1st Precinct,337,5,0,0,342,3656,78,2,0,3736
SCHOOL DIR 4YR DERRY,William M. PARRISH,Derry Township--2nd Precinct,290,5,0,0,295,3656,78,2,0,3736
SCHOOL DIR 4YR DERRY,William M. PARRISH,Derry Township--3rd Precinct,237,4,0,0,241,3656,78,2,0,3736
SCHOOL DIR 4YR DERRY,William M. PARRISH,Derry Township--4th Precinct,177,4,0,0,181,3656,78,2,0,3736
SCHOOL DIR 4YR DERRY,William M. PARRISH,Derry Township--5th Precinct,157,3,0,0,160,3656,78,2,0,3736
SCHOOL DIR 4YR DERRY,William M. PARRISH,Derry Township--6th Precinct,178,1,1,0,180,3656,78,2,0,3736
SCHOOL DIR 4YR DERRY,William M. PARRISH,Derry Township--7th Precinct,385,17,0,0,402,3656,78,2,0,3736
SCHOOL DIR 4YR DERRY,William M. PARRISH,Derry Township--8th Precinct,193,0,0,0,193,3656,78,2,0,3736
SCHOOL DIR 4YR DERRY,William M. PARRISH,Derry Township--9th Precinct,136,4,0,0,140,3656,78,2,0,3736
SCHOOL DIR 4YR DERRY,William M. PARRISH,Derry Township--10th Precinct,257,3,0,0,260,3656,78,2,0,3736
SCHOOL DIR 4YR DERRY,William M. PARRISH,Derry Township--11th Precinct,340,7,0,0,347,3656,78,2,0,3736
SCHOOL DIR 4YR DERRY,William M. PARRISH,Derry Township--12th Precinct,181,3,0,0,184,3656,78,2,0,3736
SCHOOL DIR 4YR DERRY,William M. PARRISH,Derry Township--13th Precinct,277,9,0,0,286,3656,78,2,0,3736
SCHOOL DIR 4YR DERRY,William M. PARRISH,Derry Township--14th Precinct,185,7,0,0,192,3656,78,2,0,3736
SCHOOL DIR 4YR DERRY,William M. PARRISH,Derry Township--15th Precinct,326,6,1,0,333,3656,78,2,0,3736
SCHOOL DIR 4YR DERRY,Write In  ,Derry Township--1st Precinct,26,0,0,0,26,175,0,0,0,175
SCHOOL DIR 4YR DERRY,Write In  ,Derry Township--2nd Precinct,8,0,0,0,8,175,0,0,0,175
SCHOOL DIR 4YR DERRY,Write In  ,Derry Township--3rd Precinct,6,0,0,0,6,175,0,0,0,175
SCHOOL DIR 4YR DERRY,Write In  ,Derry Township--4th Precinct,3,0,0,0,3,175,0,0,0,175
SCHOOL DIR 4YR DERRY,Write In  ,Derry Township--5th Precinct,10,0,0,0,10,175,0,0,0,175
SCHOOL DIR 4YR DERRY,Write In  ,Derry Township--6th Precinct,1,0,0,0,1,175,0,0,0,175
SCHOOL DIR 4YR DERRY,Write In  ,Derry Township--7th Precinct,27,0,0,0,27,175,0,0,0,175
SCHOOL DIR 4YR DERRY,Write In  ,Derry Township--8th Precinct,4,0,0,0,4,175,0,0,0,175
SCHOOL DIR 4YR DERRY,Write In  ,Derry Township--9th Precinct,1,0,0,0,1,175,0,0,0,175
SCHOOL DIR 4YR DERRY,Write In  ,Derry Township--10th Precinct,9,0,0,0,9,175,0,0,0,175
SCHOOL DIR 4YR DERRY,Write In  ,Derry Township--11th Precinct,8,0,0,0,8,175,0,0,0,175
SCHOOL DIR 4YR DERRY,Write In  ,Derry Township--12th Precinct,27,0,0,0,27,175,0,0,0,175
SCHOOL DIR 4YR DERRY,Write In  ,Derry Township--13th Precinct,25,0,0,0,25,175,0,0,0,175
SCHOOL DIR 4YR DERRY,Write In  ,Derry Township--14th Precinct,1,0,0,0,1,175,0,0,0,175
SCHOOL DIR 4YR DERRY,Write In  ,Derry Township--15th Precinct,19,0,0,0,19,175,0,0,0,175
SCHOOL DIR 4YR HBG,Daniel T. HOWARD,"City--1st Ward, 1st Precinct",70,1,0,0,71,2974,58,3,0,3035
SCHOOL DIR 4YR HBG,Daniel T. HOWARD,"City--1st Ward, 2nd Precinct",124,2,1,0,127,2974,58,3,0,3035
SCHOOL DIR 4YR HBG,Daniel T. HOWARD,"City--1st Ward, 3rd Precinct",65,1,0,0,66,2974,58,3,0,3035
SCHOOL DIR 4YR HBG,Daniel T. HOWARD,"City--2nd Ward, 1st Precinct",25,0,0,0,25,2974,58,3,0,3035
SCHOOL DIR 4YR HBG,Daniel T. HOWARD,"City--2nd Ward, 2nd Precinct",65,1,0,0,66,2974,58,3,0,3035
SCHOOL DIR 4YR HBG,Daniel T. HOWARD,City--3rd Ward,87,1,0,0,88,2974,58,3,0,3035
SCHOOL DIR 4YR HBG,Daniel T. HOWARD,City--4th Ward,110,4,0,0,114,2974,58,3,0,3035
SCHOOL DIR 4YR HBG,Daniel T. HOWARD,City--5th Ward,228,5,0,0,233,2974,58,3,0,3035
SCHOOL DIR 4YR HBG,Daniel T. HOWARD,City--6th Ward,117,2,2,0,121,2974,58,3,0,3035
SCHOOL DIR 4YR HBG,Daniel T. HOWARD,"City--7th Ward, 1st Precinct",39,1,0,0,40,2974,58,3,0,3035
SCHOOL DIR 4YR HBG,Daniel T. HOWARD,"City--7th Ward, 2nd Precinct",127,1,0,0,128,2974,58,3,0,3035
SCHOOL DIR 4YR HBG,Daniel T. HOWARD,City--8th Ward,121,0,0,0,121,2974,58,3,0,3035
SCHOOL DIR 4YR HBG,Daniel T. HOWARD,"City--9th Ward, 1st Precinct",44,2,0,0,46,2974,58,3,0,3035
SCHOOL DIR 4YR HBG,Daniel T. HOWARD,"City--9th Ward, 2nd Precinct",70,0,0,0,70,2974,58,3,0,3035
SCHOOL DIR 4YR HBG,Daniel T. HOWARD,"City--9th Ward, 3rd Precinct",134,1,0,0,135,2974,58,3,0,3035
SCHOOL DIR 4YR HBG,Daniel T. HOWARD,"City--9th Ward, 4th Precinct",124,1,0,0,125,2974,58,3,0,3035
SCHOOL DIR 4YR HBG,Daniel T. HOWARD,"City--9th Ward, 5th Precinct",95,4,0,0,99,2974,58,3,0,3035
SCHOOL DIR 4YR HBG,Daniel T. HOWARD,"City--10th Ward, 1st Precinct",184,3,0,0,187,2974,58,3,0,3035
SCHOOL DIR 4YR HBG,Daniel T. HOWARD,"City--10th Ward, 2nd Precinct",70,0,0,0,70,2974,58,3,0,3035
SCHOOL DIR 4YR HBG,Daniel T. HOWARD,"City--10th Ward, 3rd Precinct",55,0,0,0,55,2974,58,3,0,3035
SCHOOL DIR 4YR HBG,Daniel T. HOWARD,"City--10th Ward, 4th Precinct",93,0,0,0,93,2974,58,3,0,3035
SCHOOL DIR 4YR HBG,Daniel T. HOWARD,City--11th Ward,73,12,0,0,85,2974,58,3,0,3035
SCHOOL DIR 4YR HBG,Daniel T. HOWARD,City--12th Ward,174,5,0,0,179,2974,58,3,0,3035
SCHOOL DIR 4YR HBG,Daniel T. HOWARD,"City--13th Ward, 1st Precinct",87,0,0,0,87,2974,58,3,0,3035
SCHOOL DIR 4YR HBG,Daniel T. HOWARD,"City--13th Ward, 2nd Precinct",113,2,0,0,115,2974,58,3,0,3035
SCHOOL DIR 4YR HBG,Daniel T. HOWARD,"City--13th Ward, 3rd Precinct",154,2,0,0,156,2974,58,3,0,3035
SCHOOL DIR 4YR HBG,Daniel T. HOWARD,City--14th Ward,259,6,0,0,265,2974,58,3,0,3035
SCHOOL DIR 4YR HBG,Daniel T. HOWARD,City--15th Ward,67,1,0,0,68,2974,58,3,0,3035
SCHOOL DIR 4YR HBG,Esther E. EDWARDS,"City--1st Ward, 1st Precinct",70,1,0,0,71,2979,61,3,0,3043
SCHOOL DIR 4YR HBG,Esther E. EDWARDS,"City--1st Ward, 2nd Precinct",125,2,1,0,128,2979,61,3,0,3043
SCHOOL DIR 4YR HBG,Esther E. EDWARDS,"City--1st Ward, 3rd Precinct",64,0,0,0,64,2979,61,3,0,3043
SCHOOL DIR 4YR HBG,Esther E. EDWARDS,"City--2nd Ward, 1st Precinct",24,0,0,0,24,2979,61,3,0,3043
SCHOOL DIR 4YR HBG,Esther E. EDWARDS,"City--2nd Ward, 2nd Precinct",64,1,0,0,65,2979,61,3,0,3043
SCHOOL DIR 4YR HBG,Esther E. EDWARDS,City--3rd Ward,86,1,0,0,87,2979,61,3,0,3043
SCHOOL DIR 4YR HBG,Esther E. EDWARDS,City--4th Ward,114,4,0,0,118,2979,61,3,0,3043
SCHOOL DIR 4YR HBG,Esther E. EDWARDS,City--5th Ward,222,6,0,0,228,2979,61,3,0,3043
SCHOOL DIR 4YR HBG,Esther E. EDWARDS,City--6th Ward,113,1,2,0,116,2979,61,3,0,3043
SCHOOL DIR 4YR HBG,Esther E. EDWARDS,"City--7th Ward, 1st Precinct",43,1,0,0,44,2979,61,3,0,3043
SCHOOL DIR 4YR HBG,Esther E. EDWARDS,"City--7th Ward, 2nd Precinct",118,1,0,0,119,2979,61,3,0,3043
SCHOOL DIR 4YR HBG,Esther E. EDWARDS,City--8th Ward,109,1,0,0,110,2979,61,3,0,3043
SCHOOL DIR 4YR HBG,Esther E. EDWARDS,"City--9th Ward, 1st Precinct",44,2,0,0,46,2979,61,3,0,3043
SCHOOL DIR 4YR HBG,Esther E. EDWARDS,"City--9th Ward, 2nd Precinct",76,1,0,0,77,2979,61,3,0,3043
SCHOOL DIR 4YR HBG,Esther E. EDWARDS,"City--9th Ward, 3rd Precinct",139,1,0,0,140,2979,61,3,0,3043
SCHOOL DIR 4YR HBG,Esther E. EDWARDS,"City--9th Ward, 4th Precinct",115,2,0,0,117,2979,61,3,0,3043
SCHOOL DIR 4YR HBG,Esther E. EDWARDS,"City--9th Ward, 5th Precinct",97,3,0,0,100,2979,61,3,0,3043
SCHOOL DIR 4YR HBG,Esther E. EDWARDS,"City--10th Ward, 1st Precinct",186,3,0,0,189,2979,61,3,0,3043
SCHOOL DIR 4YR HBG,Esther E. EDWARDS,"City--10th Ward, 2nd Precinct",74,0,0,0,74,2979,61,3,0,3043
SCHOOL DIR 4YR HBG,Esther E. EDWARDS,"City--10th Ward, 3rd Precinct",60,1,0,0,61,2979,61,3,0,3043
SCHOOL DIR 4YR HBG,Esther E. EDWARDS,"City--10th Ward, 4th Precinct",104,0,0,0,104,2979,61,3,0,3043
SCHOOL DIR 4YR HBG,Esther E. EDWARDS,City--11th Ward,81,14,0,0,95,2979,61,3,0,3043
SCHOOL DIR 4YR HBG,Esther E. EDWARDS,City--12th Ward,171,5,0,0,176,2979,61,3,0,3043
SCHOOL DIR 4YR HBG,Esther E. EDWARDS,"City--13th Ward, 1st Precinct",75,0,0,0,75,2979,61,3,0,3043
SCHOOL DIR 4YR HBG,Esther E. EDWARDS,"City--13th Ward, 2nd Precinct",124,1,0,0,125,2979,61,3,0,3043
SCHOOL DIR 4YR HBG,Esther E. EDWARDS,"City--13th Ward, 3rd Precinct",155,2,0,0,157,2979,61,3,0,3043
SCHOOL DIR 4YR HBG,Esther E. EDWARDS,City--14th Ward,257,6,0,0,263,2979,61,3,0,3043
SCHOOL DIR 4YR HBG,Esther E. EDWARDS,City--15th Ward,69,1,0,0,70,2979,61,3,0,3043
SCHOOL DIR 4YR HBG,Jeffrey R. MOORE,"City--1st Ward, 1st Precinct",66,2,0,0,68,3007,60,3,0,3070
SCHOOL DIR 4YR HBG,Jeffrey R. MOORE,"City--1st Ward, 2nd Precinct",130,2,1,0,133,3007,60,3,0,3070
SCHOOL DIR 4YR HBG,Jeffrey R. MOORE,"City--1st Ward, 3rd Precinct",61,0,0,0,61,3007,60,3,0,3070
SCHOOL DIR 4YR HBG,Jeffrey R. MOORE,"City--2nd Ward, 1st Precinct",27,0,0,0,27,3007,60,3,0,3070
SCHOOL DIR 4YR HBG,Jeffrey R. MOORE,"City--2nd Ward, 2nd Precinct",63,1,0,0,64,3007,60,3,0,3070
SCHOOL DIR 4YR HBG,Jeffrey R. MOORE,City--3rd Ward,90,1,0,0,91,3007,60,3,0,3070
SCHOOL DIR 4YR HBG,Jeffrey R. MOORE,City--4th Ward,111,4,0,0,115,3007,60,3,0,3070
SCHOOL DIR 4YR HBG,Jeffrey R. MOORE,City--5th Ward,224,6,0,0,230,3007,60,3,0,3070
SCHOOL DIR 4YR HBG,Jeffrey R. MOORE,City--6th Ward,118,2,2,0,122,3007,60,3,0,3070
SCHOOL DIR 4YR HBG,Jeffrey R. MOORE,"City--7th Ward, 1st Precinct",44,2,0,0,46,3007,60,3,0,3070
SCHOOL DIR 4YR HBG,Jeffrey R. MOORE,"City--7th Ward, 2nd Precinct",115,1,0,0,116,3007,60,3,0,3070
SCHOOL DIR 4YR HBG,Jeffrey R. MOORE,City--8th Ward,112,0,0,0,112,3007,60,3,0,3070
SCHOOL DIR 4YR HBG,Jeffrey R. MOORE,"City--9th Ward, 1st Precinct",42,2,0,0,44,3007,60,3,0,3070
SCHOOL DIR 4YR HBG,Jeffrey R. MOORE,"City--9th Ward, 2nd Precinct",69,1,0,0,70,3007,60,3,0,3070
SCHOOL DIR 4YR HBG,Jeffrey R. MOORE,"City--9th Ward, 3rd Precinct",144,1,0,0,145,3007,60,3,0,3070
SCHOOL DIR 4YR HBG,Jeffrey R. MOORE,"City--9th Ward, 4th Precinct",118,2,0,0,120,3007,60,3,0,3070
SCHOOL DIR 4YR HBG,Jeffrey R. MOORE,"City--9th Ward, 5th Precinct",100,4,0,0,104,3007,60,3,0,3070
SCHOOL DIR 4YR HBG,Jeffrey R. MOORE,"City--10th Ward, 1st Precinct",183,3,0,0,186,3007,60,3,0,3070
SCHOOL DIR 4YR HBG,Jeffrey R. MOORE,"City--10th Ward, 2nd Precinct",74,0,0,0,74,3007,60,3,0,3070
SCHOOL DIR 4YR HBG,Jeffrey R. MOORE,"City--10th Ward, 3rd Precinct",62,0,0,0,62,3007,60,3,0,3070
SCHOOL DIR 4YR HBG,Jeffrey R. MOORE,"City--10th Ward, 4th Precinct",98,0,0,0,98,3007,60,3,0,3070
SCHOOL DIR 4YR HBG,Jeffrey R. MOORE,City--11th Ward,81,13,0,0,94,3007,60,3,0,3070
SCHOOL DIR 4YR HBG,Jeffrey R. MOORE,City--12th Ward,177,5,0,0,182,3007,60,3,0,3070
SCHOOL DIR 4YR HBG,Jeffrey R. MOORE,"City--13th Ward, 1st Precinct",85,0,0,0,85,3007,60,3,0,3070
SCHOOL DIR 4YR HBG,Jeffrey R. MOORE,"City--13th Ward, 2nd Precinct",122,0,0,0,122,3007,60,3,0,3070
SCHOOL DIR 4YR HBG,Jeffrey R. MOORE,"City--13th Ward, 3rd Precinct",160,2,0,0,162,3007,60,3,0,3070
SCHOOL DIR 4YR HBG,Jeffrey R. MOORE,City--14th Ward,260,5,0,0,265,3007,60,3,0,3070
SCHOOL DIR 4YR HBG,Jeffrey R. MOORE,City--15th Ward,71,1,0,0,72,3007,60,3,0,3070
SCHOOL DIR 4YR HBG,Lionel  GONZALEZ,"City--1st Ward, 1st Precinct",69,1,0,0,70,2898,56,2,0,2956
SCHOOL DIR 4YR HBG,Lionel  GONZALEZ,"City--1st Ward, 2nd Precinct",119,2,0,0,121,2898,56,2,0,2956
SCHOOL DIR 4YR HBG,Lionel  GONZALEZ,"City--1st Ward, 3rd Precinct",59,0,0,0,59,2898,56,2,0,2956
SCHOOL DIR 4YR HBG,Lionel  GONZALEZ,"City--2nd Ward, 1st Precinct",27,0,0,0,27,2898,56,2,0,2956
SCHOOL DIR 4YR HBG,Lionel  GONZALEZ,"City--2nd Ward, 2nd Precinct",62,1,0,0,63,2898,56,2,0,2956
SCHOOL DIR 4YR HBG,Lionel  GONZALEZ,City--3rd Ward,87,1,0,0,88,2898,56,2,0,2956
SCHOOL DIR 4YR HBG,Lionel  GONZALEZ,City--4th Ward,108,4,0,0,112,2898,56,2,0,2956
SCHOOL DIR 4YR HBG,Lionel  GONZALEZ,City--5th Ward,225,6,0,0,231,2898,56,2,0,2956
SCHOOL DIR 4YR HBG,Lionel  GONZALEZ,City--6th Ward,124,1,2,0,127,2898,56,2,0,2956
SCHOOL DIR 4YR HBG,Lionel  GONZALEZ,"City--7th Ward, 1st Precinct",42,0,0,0,42,2898,56,2,0,2956
SCHOOL DIR 4YR HBG,Lionel  GONZALEZ,"City--7th Ward, 2nd Precinct",107,1,0,0,108,2898,56,2,0,2956
SCHOOL DIR 4YR HBG,Lionel  GONZALEZ,City--8th Ward,106,0,0,0,106,2898,56,2,0,2956
SCHOOL DIR 4YR HBG,Lionel  GONZALEZ,"City--9th Ward, 1st Precinct",47,2,0,0,49,2898,56,2,0,2956
SCHOOL DIR 4YR HBG,Lionel  GONZALEZ,"City--9th Ward, 2nd Precinct",69,1,0,0,70,2898,56,2,0,2956
SCHOOL DIR 4YR HBG,Lionel  GONZALEZ,"City--9th Ward, 3rd Precinct",131,1,0,0,132,2898,56,2,0,2956
SCHOOL DIR 4YR HBG,Lionel  GONZALEZ,"City--9th Ward, 4th Precinct",123,2,0,0,125,2898,56,2,0,2956
SCHOOL DIR 4YR HBG,Lionel  GONZALEZ,"City--9th Ward, 5th Precinct",97,5,0,0,102,2898,56,2,0,2956
SCHOOL DIR 4YR HBG,Lionel  GONZALEZ,"City--10th Ward, 1st Precinct",181,3,0,0,184,2898,56,2,0,2956
SCHOOL DIR 4YR HBG,Lionel  GONZALEZ,"City--10th Ward, 2nd Precinct",60,0,0,0,60,2898,56,2,0,2956
SCHOOL DIR 4YR HBG,Lionel  GONZALEZ,"City--10th Ward, 3rd Precinct",52,0,0,0,52,2898,56,2,0,2956
SCHOOL DIR 4YR HBG,Lionel  GONZALEZ,"City--10th Ward, 4th Precinct",89,0,0,0,89,2898,56,2,0,2956
SCHOOL DIR 4YR HBG,Lionel  GONZALEZ,City--11th Ward,73,12,0,0,85,2898,56,2,0,2956
SCHOOL DIR 4YR HBG,Lionel  GONZALEZ,City--12th Ward,172,4,0,0,176,2898,56,2,0,2956
SCHOOL DIR 4YR HBG,Lionel  GONZALEZ,"City--13th Ward, 1st Precinct",84,0,0,0,84,2898,56,2,0,2956
SCHOOL DIR 4YR HBG,Lionel  GONZALEZ,"City--13th Ward, 2nd Precinct",113,1,0,0,114,2898,56,2,0,2956
SCHOOL DIR 4YR HBG,Lionel  GONZALEZ,"City--13th Ward, 3rd Precinct",150,2,0,0,152,2898,56,2,0,2956
SCHOOL DIR 4YR HBG,Lionel  GONZALEZ,City--14th Ward,257,5,0,0,262,2898,56,2,0,2956
SCHOOL DIR 4YR HBG,Lionel  GONZALEZ,City--15th Ward,65,1,0,0,66,2898,56,2,0,2956
SCHOOL DIR 4YR HBG,Loretta  BARBEE-DARE,"City--1st Ward, 1st Precinct",69,2,0,0,71,3215,58,3,0,3276
SCHOOL DIR 4YR HBG,Loretta  BARBEE-DARE,"City--1st Ward, 2nd Precinct",135,2,1,0,138,3215,58,3,0,3276
SCHOOL DIR 4YR HBG,Loretta  BARBEE-DARE,"City--1st Ward, 3rd Precinct",70,1,0,0,71,3215,58,3,0,3276
SCHOOL DIR 4YR HBG,Loretta  BARBEE-DARE,"City--2nd Ward, 1st Precinct",27,0,0,0,27,3215,58,3,0,3276
SCHOOL DIR 4YR HBG,Loretta  BARBEE-DARE,"City--2nd Ward, 2nd Precinct",72,1,0,0,73,3215,58,3,0,3276
SCHOOL DIR 4YR HBG,Loretta  BARBEE-DARE,City--3rd Ward,89,1,0,0,90,3215,58,3,0,3276
SCHOOL DIR 4YR HBG,Loretta  BARBEE-DARE,City--4th Ward,114,4,0,0,118,3215,58,3,0,3276
SCHOOL DIR 4YR HBG,Loretta  BARBEE-DARE,City--5th Ward,237,6,0,0,243,3215,58,3,0,3276
SCHOOL DIR 4YR HBG,Loretta  BARBEE-DARE,City--6th Ward,126,1,2,0,129,3215,58,3,0,3276
SCHOOL DIR 4YR HBG,Loretta  BARBEE-DARE,"City--7th Ward, 1st Precinct",48,0,0,0,48,3215,58,3,0,3276
SCHOOL DIR 4YR HBG,Loretta  BARBEE-DARE,"City--7th Ward, 2nd Precinct",132,1,0,0,133,3215,58,3,0,3276
SCHOOL DIR 4YR HBG,Loretta  BARBEE-DARE,City--8th Ward,139,0,0,0,139,3215,58,3,0,3276
SCHOOL DIR 4YR HBG,Loretta  BARBEE-DARE,"City--9th Ward, 1st Precinct",48,2,0,0,50,3215,58,3,0,3276
SCHOOL DIR 4YR HBG,Loretta  BARBEE-DARE,"City--9th Ward, 2nd Precinct",76,1,0,0,77,3215,58,3,0,3276
SCHOOL DIR 4YR HBG,Loretta  BARBEE-DARE,"City--9th Ward, 3rd Precinct",165,0,0,0,165,3215,58,3,0,3276
SCHOOL DIR 4YR HBG,Loretta  BARBEE-DARE,"City--9th Ward, 4th Precinct",119,2,0,0,121,3215,58,3,0,3276
SCHOOL DIR 4YR HBG,Loretta  BARBEE-DARE,"City--9th Ward, 5th Precinct",106,3,0,0,109,3215,58,3,0,3276
SCHOOL DIR 4YR HBG,Loretta  BARBEE-DARE,"City--10th Ward, 1st Precinct",198,3,0,0,201,3215,58,3,0,3276
SCHOOL DIR 4YR HBG,Loretta  BARBEE-DARE,"City--10th Ward, 2nd Precinct",85,0,0,0,85,3215,58,3,0,3276
SCHOOL DIR 4YR HBG,Loretta  BARBEE-DARE,"City--10th Ward, 3rd Precinct",54,0,0,0,54,3215,58,3,0,3276
SCHOOL DIR 4YR HBG,Loretta  BARBEE-DARE,"City--10th Ward, 4th Precinct",115,0,0,0,115,3215,58,3,0,3276
SCHOOL DIR 4YR HBG,Loretta  BARBEE-DARE,City--11th Ward,81,14,0,0,95,3215,58,3,0,3276
SCHOOL DIR 4YR HBG,Loretta  BARBEE-DARE,City--12th Ward,183,5,0,0,188,3215,58,3,0,3276
SCHOOL DIR 4YR HBG,Loretta  BARBEE-DARE,"City--13th Ward, 1st Precinct",96,0,0,0,96,3215,58,3,0,3276
SCHOOL DIR 4YR HBG,Loretta  BARBEE-DARE,"City--13th Ward, 2nd Precinct",123,1,0,0,124,3215,58,3,0,3276
SCHOOL DIR 4YR HBG,Loretta  BARBEE-DARE,"City--13th Ward, 3rd Precinct",172,2,0,0,174,3215,58,3,0,3276
SCHOOL DIR 4YR HBG,Loretta  BARBEE-DARE,City--14th Ward,255,5,0,0,260,3215,58,3,0,3276
SCHOOL DIR 4YR HBG,Loretta  BARBEE-DARE,City--15th Ward,81,1,0,0,82,3215,58,3,0,3276
SCHOOL DIR 4YR HBG,Write In  ,"City--1st Ward, 1st Precinct",0,0,0,0,0,27,0,0,0,27
SCHOOL DIR 4YR HBG,Write In  ,"City--1st Ward, 2nd Precinct",0,0,0,0,0,27,0,0,0,27
SCHOOL DIR 4YR HBG,Write In  ,"City--1st Ward, 3rd Precinct",0,0,0,0,0,27,0,0,0,27
SCHOOL DIR 4YR HBG,Write In  ,"City--2nd Ward, 1st Precinct",0,0,0,0,0,27,0,0,0,27
SCHOOL DIR 4YR HBG,Write In  ,"City--2nd Ward, 2nd Precinct",0,0,0,0,0,27,0,0,0,27
SCHOOL DIR 4YR HBG,Write In  ,City--3rd Ward,0,0,0,0,0,27,0,0,0,27
SCHOOL DIR 4YR HBG,Write In  ,City--4th Ward,0,0,0,0,0,27,0,0,0,27
SCHOOL DIR 4YR HBG,Write In  ,City--5th Ward,7,0,0,0,7,27,0,0,0,27
SCHOOL DIR 4YR HBG,Write In  ,City--6th Ward,3,0,0,0,3,27,0,0,0,27
SCHOOL DIR 4YR HBG,Write In  ,"City--7th Ward, 1st Precinct",1,0,0,0,1,27,0,0,0,27
SCHOOL DIR 4YR HBG,Write In  ,"City--7th Ward, 2nd Precinct",0,0,0,0,0,27,0,0,0,27
SCHOOL DIR 4YR HBG,Write In  ,City--8th Ward,0,0,0,0,0,27,0,0,0,27
SCHOOL DIR 4YR HBG,Write In  ,"City--9th Ward, 1st Precinct",0,0,0,0,0,27,0,0,0,27
SCHOOL DIR 4YR HBG,Write In  ,"City--9th Ward, 2nd Precinct",1,0,0,0,1,27,0,0,0,27
SCHOOL DIR 4YR HBG,Write In  ,"City--9th Ward, 3rd Precinct",0,0,0,0,0,27,0,0,0,27
SCHOOL DIR 4YR HBG,Write In  ,"City--9th Ward, 4th Precinct",1,0,0,0,1,27,0,0,0,27
SCHOOL DIR 4YR HBG,Write In  ,"City--9th Ward, 5th Precinct",0,0,0,0,0,27,0,0,0,27
SCHOOL DIR 4YR HBG,Write In  ,"City--10th Ward, 1st Precinct",0,0,0,0,0,27,0,0,0,27
SCHOOL DIR 4YR HBG,Write In  ,"City--10th Ward, 2nd Precinct",0,0,0,0,0,27,0,0,0,27
SCHOOL DIR 4YR HBG,Write In  ,"City--10th Ward, 3rd Precinct",0,0,0,0,0,27,0,0,0,27
SCHOOL DIR 4YR HBG,Write In  ,"City--10th Ward, 4th Precinct",3,0,0,0,3,27,0,0,0,27
SCHOOL DIR 4YR HBG,Write In  ,City--11th Ward,0,0,0,0,0,27,0,0,0,27
SCHOOL DIR 4YR HBG,Write In  ,City--12th Ward,1,0,0,0,1,27,0,0,0,27
SCHOOL DIR 4YR HBG,Write In  ,"City--13th Ward, 1st Precinct",0,0,0,0,0,27,0,0,0,27
SCHOOL DIR 4YR HBG,Write In  ,"City--13th Ward, 2nd Precinct",1,0,0,0,1,27,0,0,0,27
SCHOOL DIR 4YR HBG,Write In  ,"City--13th Ward, 3rd Precinct",2,0,0,0,2,27,0,0,0,27
SCHOOL DIR 4YR HBG,Write In  ,City--14th Ward,7,0,0,0,7,27,0,0,0,27
SCHOOL DIR 4YR HBG,Write In  ,City--15th Ward,0,0,0,0,0,27,0,0,0,27
SCHOOL DIR 4YR MDLT,Barbara N. LAYNE,"Middletown--1st Ward, 1st Precinct",79,0,0,0,79,2092,47,0,0,2139
SCHOOL DIR 4YR MDLT,Barbara N. LAYNE,"Middletown--1st Ward, 2nd Precinct",141,6,0,0,147,2092,47,0,0,2139
SCHOOL DIR 4YR MDLT,Barbara N. LAYNE,"Middletown--2nd Ward, 1st Precinct",144,1,0,0,145,2092,47,0,0,2139
SCHOOL DIR 4YR MDLT,Barbara N. LAYNE,"Middletown--2nd Ward, 2nd Precinct",144,5,0,0,149,2092,47,0,0,2139
SCHOOL DIR 4YR MDLT,Barbara N. LAYNE,"Middletown--3rd Ward, 1st Precinct",115,2,0,0,117,2092,47,0,0,2139
SCHOOL DIR 4YR MDLT,Barbara N. LAYNE,"Middletown--3rd Ward, 2nd Precinct",200,0,0,0,200,2092,47,0,0,2139
SCHOOL DIR 4YR MDLT,Barbara N. LAYNE,Royalton Borough--1st Ward,32,0,0,0,32,2092,47,0,0,2139
SCHOOL DIR 4YR MDLT,Barbara N. LAYNE,Royalton Borough--2nd Ward,70,0,0,0,70,2092,47,0,0,2139
SCHOOL DIR 4YR MDLT,Barbara N. LAYNE,Lower Swatara Twp--1st Precinct,344,4,0,0,348,2092,47,0,0,2139
SCHOOL DIR 4YR MDLT,Barbara N. LAYNE,Lower Swatara Twp--2nd Precinct,305,6,0,0,311,2092,47,0,0,2139
SCHOOL DIR 4YR MDLT,Barbara N. LAYNE,Lower Swatara Twp--3rd Precinct,271,23,0,0,294,2092,47,0,0,2139
SCHOOL DIR 4YR MDLT,Barbara N. LAYNE,Lower Swatara Twp--4th Precinct,247,0,0,0,247,2092,47,0,0,2139
SCHOOL DIR 4YR MDLT,Gordon A. EINHORN,"Middletown--1st Ward, 1st Precinct",85,0,0,0,85,2073,44,1,0,2118
SCHOOL DIR 4YR MDLT,Gordon A. EINHORN,"Middletown--1st Ward, 2nd Precinct",143,6,1,0,150,2073,44,1,0,2118
SCHOOL DIR 4YR MDLT,Gordon A. EINHORN,"Middletown--2nd Ward, 1st Precinct",151,1,0,0,152,2073,44,1,0,2118
SCHOOL DIR 4YR MDLT,Gordon A. EINHORN,"Middletown--2nd Ward, 2nd Precinct",151,3,0,0,154,2073,44,1,0,2118
SCHOOL DIR 4YR MDLT,Gordon A. EINHORN,"Middletown--3rd Ward, 1st Precinct",119,2,0,0,121,2073,44,1,0,2118
SCHOOL DIR 4YR MDLT,Gordon A. EINHORN,"Middletown--3rd Ward, 2nd Precinct",201,0,0,0,201,2073,44,1,0,2118
SCHOOL DIR 4YR MDLT,Gordon A. EINHORN,Royalton Borough--1st Ward,36,0,0,0,36,2073,44,1,0,2118
SCHOOL DIR 4YR MDLT,Gordon A. EINHORN,Royalton Borough--2nd Ward,74,0,0,0,74,2073,44,1,0,2118
SCHOOL DIR 4YR MDLT,Gordon A. EINHORN,Lower Swatara Twp--1st Precinct,334,3,0,0,337,2073,44,1,0,2118
SCHOOL DIR 4YR MDLT,Gordon A. EINHORN,Lower Swatara Twp--2nd Precinct,293,7,0,0,300,2073,44,1,0,2118
SCHOOL DIR 4YR MDLT,Gordon A. EINHORN,Lower Swatara Twp--3rd Precinct,257,22,0,0,279,2073,44,1,0,2118
SCHOOL DIR 4YR MDLT,Gordon A. EINHORN,Lower Swatara Twp--4th Precinct,229,0,0,0,229,2073,44,1,0,2118
SCHOOL DIR 4YR MDLT,Michael S. RICHARDS,"Middletown--1st Ward, 1st Precinct",91,0,0,0,91,2164,48,1,0,2213
SCHOOL DIR 4YR MDLT,Michael S. RICHARDS,"Middletown--1st Ward, 2nd Precinct",147,6,1,0,154,2164,48,1,0,2213
SCHOOL DIR 4YR MDLT,Michael S. RICHARDS,"Middletown--2nd Ward, 1st Precinct",161,2,0,0,163,2164,48,1,0,2213
SCHOOL DIR 4YR MDLT,Michael S. RICHARDS,"Middletown--2nd Ward, 2nd Precinct",166,5,0,0,171,2164,48,1,0,2213
SCHOOL DIR 4YR MDLT,Michael S. RICHARDS,"Middletown--3rd Ward, 1st Precinct",118,2,0,0,120,2164,48,1,0,2213
SCHOOL DIR 4YR MDLT,Michael S. RICHARDS,"Middletown--3rd Ward, 2nd Precinct",206,0,0,0,206,2164,48,1,0,2213
SCHOOL DIR 4YR MDLT,Michael S. RICHARDS,Royalton Borough--1st Ward,41,0,0,0,41,2164,48,1,0,2213
SCHOOL DIR 4YR MDLT,Michael S. RICHARDS,Royalton Borough--2nd Ward,83,0,0,0,83,2164,48,1,0,2213
SCHOOL DIR 4YR MDLT,Michael S. RICHARDS,Lower Swatara Twp--1st Precinct,343,5,0,0,348,2164,48,1,0,2213
SCHOOL DIR 4YR MDLT,Michael S. RICHARDS,Lower Swatara Twp--2nd Precinct,297,3,0,0,300,2164,48,1,0,2213
SCHOOL DIR 4YR MDLT,Michael S. RICHARDS,Lower Swatara Twp--3rd Precinct,256,25,0,0,281,2164,48,1,0,2213
SCHOOL DIR 4YR MDLT,Michael S. RICHARDS,Lower Swatara Twp--4th Precinct,255,0,0,0,255,2164,48,1,0,2213
SCHOOL DIR 4YR MDLT,Pamela M. PRICE,"Middletown--1st Ward, 1st Precinct",89,0,0,0,89,2078,45,0,0,2123
SCHOOL DIR 4YR MDLT,Pamela M. PRICE,"Middletown--1st Ward, 2nd Precinct",151,5,0,0,156,2078,45,0,0,2123
SCHOOL DIR 4YR MDLT,Pamela M. PRICE,"Middletown--2nd Ward, 1st Precinct",152,3,0,0,155,2078,45,0,0,2123
SCHOOL DIR 4YR MDLT,Pamela M. PRICE,"Middletown--2nd Ward, 2nd Precinct",151,3,0,0,154,2078,45,0,0,2123
SCHOOL DIR 4YR MDLT,Pamela M. PRICE,"Middletown--3rd Ward, 1st Precinct",114,3,0,0,117,2078,45,0,0,2123
SCHOOL DIR 4YR MDLT,Pamela M. PRICE,"Middletown--3rd Ward, 2nd Precinct",192,0,0,0,192,2078,45,0,0,2123
SCHOOL DIR 4YR MDLT,Pamela M. PRICE,Royalton Borough--1st Ward,36,0,0,0,36,2078,45,0,0,2123
SCHOOL DIR 4YR MDLT,Pamela M. PRICE,Royalton Borough--2nd Ward,69,0,0,0,69,2078,45,0,0,2123
SCHOOL DIR 4YR MDLT,Pamela M. PRICE,Lower Swatara Twp--1st Precinct,329,3,0,0,332,2078,45,0,0,2123
SCHOOL DIR 4YR MDLT,Pamela M. PRICE,Lower Swatara Twp--2nd Precinct,289,7,0,0,296,2078,45,0,0,2123
SCHOOL DIR 4YR MDLT,Pamela M. PRICE,Lower Swatara Twp--3rd Precinct,261,21,0,0,282,2078,45,0,0,2123
SCHOOL DIR 4YR MDLT,Pamela M. PRICE,Lower Swatara Twp--4th Precinct,245,0,0,0,245,2078,45,0,0,2123
SCHOOL DIR 4YR MDLT,Terry  GILMAN,"Middletown--1st Ward, 1st Precinct",90,0,0,0,90,2178,42,0,0,2220
SCHOOL DIR 4YR MDLT,Terry  GILMAN,"Middletown--1st Ward, 2nd Precinct",150,6,0,0,156,2178,42,0,0,2220
SCHOOL DIR 4YR MDLT,Terry  GILMAN,"Middletown--2nd Ward, 1st Precinct",155,3,0,0,158,2178,42,0,0,2220
SCHOOL DIR 4YR MDLT,Terry  GILMAN,"Middletown--2nd Ward, 2nd Precinct",164,3,0,0,167,2178,42,0,0,2220
SCHOOL DIR 4YR MDLT,Terry  GILMAN,"Middletown--3rd Ward, 1st Precinct",132,2,0,0,134,2178,42,0,0,2220
SCHOOL DIR 4YR MDLT,Terry  GILMAN,"Middletown--3rd Ward, 2nd Precinct",212,0,0,0,212,2178,42,0,0,2220
SCHOOL DIR 4YR MDLT,Terry  GILMAN,Royalton Borough--1st Ward,43,0,0,0,43,2178,42,0,0,2220
SCHOOL DIR 4YR MDLT,Terry  GILMAN,Royalton Borough--2nd Ward,76,0,0,0,76,2178,42,0,0,2220
SCHOOL DIR 4YR MDLT,Terry  GILMAN,Lower Swatara Twp--1st Precinct,336,4,0,0,340,2178,42,0,0,2220
SCHOOL DIR 4YR MDLT,Terry  GILMAN,Lower Swatara Twp--2nd Precinct,300,2,0,0,302,2178,42,0,0,2220
SCHOOL DIR 4YR MDLT,Terry  GILMAN,Lower Swatara Twp--3rd Precinct,264,22,0,0,286,2178,42,0,0,2220
SCHOOL DIR 4YR MDLT,Terry  GILMAN,Lower Swatara Twp--4th Precinct,256,0,0,0,256,2178,42,0,0,2220
SCHOOL DIR 4YR MDLT,Write In  ,"Middletown--1st Ward, 1st Precinct",0,0,0,0,0,10,0,0,0,10
SCHOOL DIR 4YR MDLT,Write In  ,"Middletown--1st Ward, 2nd Precinct",0,0,0,0,0,10,0,0,0,10
SCHOOL DIR 4YR MDLT,Write In  ,"Middletown--2nd Ward, 1st Precinct",2,0,0,0,2,10,0,0,0,10
SCHOOL DIR 4YR MDLT,Write In  ,"Middletown--2nd Ward, 2nd Precinct",0,0,0,0,0,10,0,0,0,10
SCHOOL DIR 4YR MDLT,Write In  ,"Middletown--3rd Ward, 1st Precinct",2,0,0,0,2,10,0,0,0,10
SCHOOL DIR 4YR MDLT,Write In  ,"Middletown--3rd Ward, 2nd Precinct",1,0,0,0,1,10,0,0,0,10
SCHOOL DIR 4YR MDLT,Write In  ,Royalton Borough--1st Ward,0,0,0,0,0,10,0,0,0,10
SCHOOL DIR 4YR MDLT,Write In  ,Royalton Borough--2nd Ward,4,0,0,0,4,10,0,0,0,10
SCHOOL DIR 4YR MDLT,Write In  ,Lower Swatara Twp--1st Precinct,1,0,0,0,1,10,0,0,0,10
SCHOOL DIR 4YR MDLT,Write In  ,Lower Swatara Twp--2nd Precinct,0,0,0,0,0,10,0,0,0,10
SCHOOL DIR 4YR MDLT,Write In  ,Lower Swatara Twp--3rd Precinct,0,0,0,0,0,10,0,0,0,10
SCHOOL DIR 4YR MDLT,Write In  ,Lower Swatara Twp--4th Precinct,0,0,0,0,0,10,0,0,0,10
SCHOOL DIR CD REG 1,Jay R. WENGER,Paxtang Borough,259,3,0,0,262,4018,79,0,0,4097
SCHOOL DIR CD REG 1,Jay R. WENGER,Penbrook Borough--1st Ward,63,1,0,0,64,4018,79,0,0,4097
SCHOOL DIR CD REG 1,Jay R. WENGER,Penbrook Borough--2nd Ward,80,1,0,0,81,4018,79,0,0,4097
SCHOOL DIR CD REG 1,Jay R. WENGER,Penbrook Borough--3rd Ward,84,0,0,0,84,4018,79,0,0,4097
SCHOOL DIR CD REG 1,Jay R. WENGER,Penbrook Borough--4th Ward,100,1,0,0,101,4018,79,0,0,4097
SCHOOL DIR CD REG 1,Jay R. WENGER,Swatara Township--1st Ward,380,4,0,0,384,4018,79,0,0,4097
SCHOOL DIR CD REG 1,Jay R. WENGER,Swatara Township--2nd Ward,220,22,0,0,242,4018,79,0,0,4097
SCHOOL DIR CD REG 1,Jay R. WENGER,Swatara Township--3rd Ward,262,5,0,0,267,4018,79,0,0,4097
SCHOOL DIR CD REG 1,Jay R. WENGER,Swatara Township--4th Ward,373,8,0,0,381,4018,79,0,0,4097
SCHOOL DIR CD REG 1,Jay R. WENGER,Swatara Township--5th Ward,506,4,0,0,510,4018,79,0,0,4097
SCHOOL DIR CD REG 1,Jay R. WENGER,Swatara Township--6th Ward,462,2,0,0,464,4018,79,0,0,4097
SCHOOL DIR CD REG 1,Jay R. WENGER,Swatara Township--7th Ward,478,13,0,0,491,4018,79,0,0,4097
SCHOOL DIR CD REG 1,Jay R. WENGER,Swatara Township--8th Ward,522,6,0,0,528,4018,79,0,0,4097
SCHOOL DIR CD REG 1,Jay R. WENGER,Swatara Township--9th Ward,229,9,0,0,238,4018,79,0,0,4097
SCHOOL DIR CD REG 1,Write In  ,Paxtang Borough,6,0,0,0,6,26,0,0,0,26
SCHOOL DIR CD REG 1,Write In  ,Penbrook Borough--1st Ward,1,0,0,0,1,26,0,0,0,26
SCHOOL DIR CD REG 1,Write In  ,Penbrook Borough--2nd Ward,1,0,0,0,1,26,0,0,0,26
SCHOOL DIR CD REG 1,Write In  ,Penbrook Borough--3rd Ward,0,0,0,0,0,26,0,0,0,26
SCHOOL DIR CD REG 1,Write In  ,Penbrook Borough--4th Ward,1,0,0,0,1,26,0,0,0,26
SCHOOL DIR CD REG 1,Write In  ,Swatara Township--1st Ward,2,0,0,0,2,26,0,0,0,26
SCHOOL DIR CD REG 1,Write In  ,Swatara Township--2nd Ward,1,0,0,0,1,26,0,0,0,26
SCHOOL DIR CD REG 1,Write In  ,Swatara Township--3rd Ward,0,0,0,0,0,26,0,0,0,26
SCHOOL DIR CD REG 1,Write In  ,Swatara Township--4th Ward,2,0,0,0,2,26,0,0,0,26
SCHOOL DIR CD REG 1,Write In  ,Swatara Township--5th Ward,4,0,0,0,4,26,0,0,0,26
SCHOOL DIR CD REG 1,Write In  ,Swatara Township--6th Ward,2,0,0,0,2,26,0,0,0,26
SCHOOL DIR CD REG 1,Write In  ,Swatara Township--7th Ward,4,0,0,0,4,26,0,0,0,26
SCHOOL DIR CD REG 1,Write In  ,Swatara Township--8th Ward,1,0,0,0,1,26,0,0,0,26
SCHOOL DIR CD REG 1,Write In  ,Swatara Township--9th Ward,1,0,0,0,1,26,0,0,0,26
SCHOOL DIR CD REG 2,Kristine  LEBER,Dauphin Borough,128,1,0,0,129,3553,56,3,0,3612
SCHOOL DIR CD REG 2,Kristine  LEBER,Lower Paxton Twp--1st Precinct,195,2,0,0,197,3553,56,3,0,3612
SCHOOL DIR CD REG 2,Kristine  LEBER,Lower Paxton Twp--2nd Precinct,167,5,0,0,172,3553,56,3,0,3612
SCHOOL DIR CD REG 2,Kristine  LEBER,Lower Paxton Twp--6th Precinct,150,3,0,0,153,3553,56,3,0,3612
SCHOOL DIR CD REG 2,Kristine  LEBER,Lower Paxton Twp--8th Precinct,128,1,0,0,129,3553,56,3,0,3612
SCHOOL DIR CD REG 2,Kristine  LEBER,Lower Paxton Twp--10th Precinct,98,4,0,0,102,3553,56,3,0,3612
SCHOOL DIR CD REG 2,Kristine  LEBER,Lower Paxton Twp--11th Precinct,168,1,0,0,169,3553,56,3,0,3612
SCHOOL DIR CD REG 2,Kristine  LEBER,Lower Paxton Twp--14th Precinct,129,2,3,0,134,3553,56,3,0,3612
SCHOOL DIR CD REG 2,Kristine  LEBER,Lower Paxton Twp--17th Precinct,166,6,0,0,172,3553,56,3,0,3612
SCHOOL DIR CD REG 2,Kristine  LEBER,Lower Paxton Twp--18th Precinct,147,1,0,0,148,3553,56,3,0,3612
SCHOOL DIR CD REG 2,Kristine  LEBER,Lower Paxton Twp--19th Precinct,254,10,0,0,264,3553,56,3,0,3612
SCHOOL DIR CD REG 2,Kristine  LEBER,Lower Paxton Twp--21st Precinct,247,4,0,0,251,3553,56,3,0,3612
SCHOOL DIR CD REG 2,Kristine  LEBER,Lower Paxton Twp--22nd Precinct,206,2,0,0,208,3553,56,3,0,3612
SCHOOL DIR CD REG 2,Kristine  LEBER,Lower Paxton Twp--23rd Precinct,210,3,0,0,213,3553,56,3,0,3612
SCHOOL DIR CD REG 2,Kristine  LEBER,Lower Paxton Twp--25th Precinct,132,2,0,0,134,3553,56,3,0,3612
SCHOOL DIR CD REG 2,Kristine  LEBER,Lower Paxton Twp--26th Precinct,221,5,0,0,226,3553,56,3,0,3612
SCHOOL DIR CD REG 2,Kristine  LEBER,Middle Paxton Twp--1st Precinct,283,1,0,0,284,3553,56,3,0,3612
SCHOOL DIR CD REG 2,Kristine  LEBER,Middle Paxton Twp--2nd Precinct,214,1,0,0,215,3553,56,3,0,3612
SCHOOL DIR CD REG 2,Kristine  LEBER,Middle Paxton Twp--3rd Precinct,310,2,0,0,312,3553,56,3,0,3612
SCHOOL DIR CD REG 2,Michael L. MAUSNER,Dauphin Borough,60,1,0,0,61,2592,53,0,0,2645
SCHOOL DIR CD REG 2,Michael L. MAUSNER,Lower Paxton Twp--1st Precinct,92,1,0,0,93,2592,53,0,0,2645
SCHOOL DIR CD REG 2,Michael L. MAUSNER,Lower Paxton Twp--2nd Precinct,122,6,0,0,128,2592,53,0,0,2645
SCHOOL DIR CD REG 2,Michael L. MAUSNER,Lower Paxton Twp--6th Precinct,112,2,0,0,114,2592,53,0,0,2645
SCHOOL DIR CD REG 2,Michael L. MAUSNER,Lower Paxton Twp--8th Precinct,95,2,0,0,97,2592,53,0,0,2645
SCHOOL DIR CD REG 2,Michael L. MAUSNER,Lower Paxton Twp--10th Precinct,88,3,0,0,91,2592,53,0,0,2645
SCHOOL DIR CD REG 2,Michael L. MAUSNER,Lower Paxton Twp--11th Precinct,114,2,0,0,116,2592,53,0,0,2645
SCHOOL DIR CD REG 2,Michael L. MAUSNER,Lower Paxton Twp--14th Precinct,99,3,0,0,102,2592,53,0,0,2645
SCHOOL DIR CD REG 2,Michael L. MAUSNER,Lower Paxton Twp--17th Precinct,108,2,0,0,110,2592,53,0,0,2645
SCHOOL DIR CD REG 2,Michael L. MAUSNER,Lower Paxton Twp--18th Precinct,111,0,0,0,111,2592,53,0,0,2645
SCHOOL DIR CD REG 2,Michael L. MAUSNER,Lower Paxton Twp--19th Precinct,293,7,0,0,300,2592,53,0,0,2645
SCHOOL DIR CD REG 2,Michael L. MAUSNER,Lower Paxton Twp--21st Precinct,234,9,0,0,243,2592,53,0,0,2645
SCHOOL DIR CD REG 2,Michael L. MAUSNER,Lower Paxton Twp--22nd Precinct,243,6,0,0,249,2592,53,0,0,2645
SCHOOL DIR CD REG 2,Michael L. MAUSNER,Lower Paxton Twp--23rd Precinct,145,4,0,0,149,2592,53,0,0,2645
SCHOOL DIR CD REG 2,Michael L. MAUSNER,Lower Paxton Twp--25th Precinct,148,2,0,0,150,2592,53,0,0,2645
SCHOOL DIR CD REG 2,Michael L. MAUSNER,Lower Paxton Twp--26th Precinct,146,3,0,0,149,2592,53,0,0,2645
SCHOOL DIR CD REG 2,Michael L. MAUSNER,Middle Paxton Twp--1st Precinct,110,0,0,0,110,2592,53,0,0,2645
SCHOOL DIR CD REG 2,Michael L. MAUSNER,Middle Paxton Twp--2nd Precinct,141,0,0,0,141,2592,53,0,0,2645
SCHOOL DIR CD REG 2,Michael L. MAUSNER,Middle Paxton Twp--3rd Precinct,131,0,0,0,131,2592,53,0,0,2645
SCHOOL DIR CD REG 2,Michael W. BREHM,Dauphin Borough,157,2,0,0,159,4162,64,3,0,4229
SCHOOL DIR CD REG 2,Michael W. BREHM,Lower Paxton Twp--1st Precinct,192,0,0,0,192,4162,64,3,0,4229
SCHOOL DIR CD REG 2,Michael W. BREHM,Lower Paxton Twp--2nd Precinct,198,8,0,0,206,4162,64,3,0,4229
SCHOOL DIR CD REG 2,Michael W. BREHM,Lower Paxton Twp--6th Precinct,193,5,0,0,198,4162,64,3,0,4229
SCHOOL DIR CD REG 2,Michael W. BREHM,Lower Paxton Twp--8th Precinct,169,1,0,0,170,4162,64,3,0,4229
SCHOOL DIR CD REG 2,Michael W. BREHM,Lower Paxton Twp--10th Precinct,167,7,0,0,174,4162,64,3,0,4229
SCHOOL DIR CD REG 2,Michael W. BREHM,Lower Paxton Twp--11th Precinct,194,4,0,0,198,4162,64,3,0,4229
SCHOOL DIR CD REG 2,Michael W. BREHM,Lower Paxton Twp--14th Precinct,161,1,3,0,165,4162,64,3,0,4229
SCHOOL DIR CD REG 2,Michael W. BREHM,Lower Paxton Twp--17th Precinct,224,3,0,0,227,4162,64,3,0,4229
SCHOOL DIR CD REG 2,Michael W. BREHM,Lower Paxton Twp--18th Precinct,195,2,0,0,197,4162,64,3,0,4229
SCHOOL DIR CD REG 2,Michael W. BREHM,Lower Paxton Twp--19th Precinct,288,11,0,0,299,4162,64,3,0,4229
SCHOOL DIR CD REG 2,Michael W. BREHM,Lower Paxton Twp--21st Precinct,293,7,0,0,300,4162,64,3,0,4229
SCHOOL DIR CD REG 2,Michael W. BREHM,Lower Paxton Twp--22nd Precinct,197,1,0,0,198,4162,64,3,0,4229
SCHOOL DIR CD REG 2,Michael W. BREHM,Lower Paxton Twp--23rd Precinct,218,0,0,0,218,4162,64,3,0,4229
SCHOOL DIR CD REG 2,Michael W. BREHM,Lower Paxton Twp--25th Precinct,153,3,0,0,156,4162,64,3,0,4229
SCHOOL DIR CD REG 2,Michael W. BREHM,Lower Paxton Twp--26th Precinct,265,5,0,0,270,4162,64,3,0,4229
SCHOOL DIR CD REG 2,Michael W. BREHM,Middle Paxton Twp--1st Precinct,321,1,0,0,322,4162,64,3,0,4229
SCHOOL DIR CD REG 2,Michael W. BREHM,Middle Paxton Twp--2nd Precinct,244,1,0,0,245,4162,64,3,0,4229
SCHOOL DIR CD REG 2,Michael W. BREHM,Middle Paxton Twp--3rd Precinct,333,2,0,0,335,4162,64,3,0,4229
SCHOOL DIR CD REG 2,Write In  ,Dauphin Borough,3,0,0,0,3,175,0,0,0,175
SCHOOL DIR CD REG 2,Write In  ,Lower Paxton Twp--1st Precinct,10,0,0,0,10,175,0,0,0,175
SCHOOL DIR CD REG 2,Write In  ,Lower Paxton Twp--2nd Precinct,12,0,0,0,12,175,0,0,0,175
SCHOOL DIR CD REG 2,Write In  ,Lower Paxton Twp--6th Precinct,3,0,0,0,3,175,0,0,0,175
SCHOOL DIR CD REG 2,Write In  ,Lower Paxton Twp--8th Precinct,18,0,0,0,18,175,0,0,0,175
SCHOOL DIR CD REG 2,Write In  ,Lower Paxton Twp--10th Precinct,2,0,0,0,2,175,0,0,0,175
SCHOOL DIR CD REG 2,Write In  ,Lower Paxton Twp--11th Precinct,14,0,0,0,14,175,0,0,0,175
SCHOOL DIR CD REG 2,Write In  ,Lower Paxton Twp--14th Precinct,4,0,0,0,4,175,0,0,0,175
SCHOOL DIR CD REG 2,Write In  ,Lower Paxton Twp--17th Precinct,6,0,0,0,6,175,0,0,0,175
SCHOOL DIR CD REG 2,Write In  ,Lower Paxton Twp--18th Precinct,5,0,0,0,5,175,0,0,0,175
SCHOOL DIR CD REG 2,Write In  ,Lower Paxton Twp--19th Precinct,19,0,0,0,19,175,0,0,0,175
SCHOOL DIR CD REG 2,Write In  ,Lower Paxton Twp--21st Precinct,33,0,0,0,33,175,0,0,0,175
SCHOOL DIR CD REG 2,Write In  ,Lower Paxton Twp--22nd Precinct,12,0,0,0,12,175,0,0,0,175
SCHOOL DIR CD REG 2,Write In  ,Lower Paxton Twp--23rd Precinct,14,0,0,0,14,175,0,0,0,175
SCHOOL DIR CD REG 2,Write In  ,Lower Paxton Twp--25th Precinct,2,0,0,0,2,175,0,0,0,175
SCHOOL DIR CD REG 2,Write In  ,Lower Paxton Twp--26th Precinct,10,0,0,0,10,175,0,0,0,175
SCHOOL DIR CD REG 2,Write In  ,Middle Paxton Twp--1st Precinct,2,0,0,0,2,175,0,0,0,175
SCHOOL DIR CD REG 2,Write In  ,Middle Paxton Twp--2nd Precinct,0,0,0,0,0,175,0,0,0,175
SCHOOL DIR CD REG 2,Write In  ,Middle Paxton Twp--3rd Precinct,6,0,0,0,6,175,0,0,0,175
SCHOOL DIR CD REG 3,Christian D. MALESIC,Lower Paxton Twp--3rd precinct,258,7,0,0,265,3606,73,1,0,3680
SCHOOL DIR CD REG 3,Christian D. MALESIC,Lower Paxton Twp--4th Precinct,213,3,0,0,216,3606,73,1,0,3680
SCHOOL DIR CD REG 3,Christian D. MALESIC,Lower Paxton Twp--5th Precinct,194,2,1,0,197,3606,73,1,0,3680
SCHOOL DIR CD REG 3,Christian D. MALESIC,Lower Paxton Twp--7th Precinct,245,3,0,0,248,3606,73,1,0,3680
SCHOOL DIR CD REG 3,Christian D. MALESIC,Lower Paxton Twp--9th Precinct,141,1,0,0,142,3606,73,1,0,3680
SCHOOL DIR CD REG 3,Christian D. MALESIC,Lower Paxton Twp--12th Precinct,192,6,0,0,198,3606,73,1,0,3680
SCHOOL DIR CD REG 3,Christian D. MALESIC,Lower Paxton Twp--13th Precinct,193,5,0,0,198,3606,73,1,0,3680
SCHOOL DIR CD REG 3,Christian D. MALESIC,Lower Paxton Twp--15th Precinct,189,2,0,0,191,3606,73,1,0,3680
SCHOOL DIR CD REG 3,Christian D. MALESIC,Lower Paxton Twp--16th Precinct,321,8,0,0,329,3606,73,1,0,3680
SCHOOL DIR CD REG 3,Christian D. MALESIC,Lower Paxton Twp--20th Precinct,172,4,0,0,176,3606,73,1,0,3680
SCHOOL DIR CD REG 3,Christian D. MALESIC,Lower Paxton Twp--24th Precinct,187,6,0,0,193,3606,73,1,0,3680
SCHOOL DIR CD REG 3,Christian D. MALESIC,Lower Paxton Twp--27th Precinct,179,2,0,0,181,3606,73,1,0,3680
SCHOOL DIR CD REG 3,Christian D. MALESIC,West Hanover Twp--1st Precinct,214,5,0,0,219,3606,73,1,0,3680
SCHOOL DIR CD REG 3,Christian D. MALESIC,West Hanover Twp--2nd Precinct,187,7,0,0,194,3606,73,1,0,3680
SCHOOL DIR CD REG 3,Christian D. MALESIC,West Hanover Twp--3rd Precinct,444,11,0,0,455,3606,73,1,0,3680
SCHOOL DIR CD REG 3,Christian D. MALESIC,West Hanover Twp--4th Precinct,277,1,0,0,278,3606,73,1,0,3680
SCHOOL DIR CD REG 3,"Ford S. THOMPSON, JR.",Lower Paxton Twp--3rd precinct,432,8,0,0,440,5566,93,0,0,5659
SCHOOL DIR CD REG 3,"Ford S. THOMPSON, JR.",Lower Paxton Twp--4th Precinct,324,3,0,0,327,5566,93,0,0,5659
SCHOOL DIR CD REG 3,"Ford S. THOMPSON, JR.",Lower Paxton Twp--5th Precinct,270,4,0,0,274,5566,93,0,0,5659
SCHOOL DIR CD REG 3,"Ford S. THOMPSON, JR.",Lower Paxton Twp--7th Precinct,401,7,0,0,408,5566,93,0,0,5659
SCHOOL DIR CD REG 3,"Ford S. THOMPSON, JR.",Lower Paxton Twp--9th Precinct,219,7,0,0,226,5566,93,0,0,5659
SCHOOL DIR CD REG 3,"Ford S. THOMPSON, JR.",Lower Paxton Twp--12th Precinct,355,6,0,0,361,5566,93,0,0,5659
SCHOOL DIR CD REG 3,"Ford S. THOMPSON, JR.",Lower Paxton Twp--13th Precinct,302,2,0,0,304,5566,93,0,0,5659
SCHOOL DIR CD REG 3,"Ford S. THOMPSON, JR.",Lower Paxton Twp--15th Precinct,294,3,0,0,297,5566,93,0,0,5659
SCHOOL DIR CD REG 3,"Ford S. THOMPSON, JR.",Lower Paxton Twp--16th Precinct,474,10,0,0,484,5566,93,0,0,5659
SCHOOL DIR CD REG 3,"Ford S. THOMPSON, JR.",Lower Paxton Twp--20th Precinct,292,5,0,0,297,5566,93,0,0,5659
SCHOOL DIR CD REG 3,"Ford S. THOMPSON, JR.",Lower Paxton Twp--24th Precinct,300,7,0,0,307,5566,93,0,0,5659
SCHOOL DIR CD REG 3,"Ford S. THOMPSON, JR.",Lower Paxton Twp--27th Precinct,244,2,0,0,246,5566,93,0,0,5659
SCHOOL DIR CD REG 3,"Ford S. THOMPSON, JR.",West Hanover Twp--1st Precinct,296,4,0,0,300,5566,93,0,0,5659
SCHOOL DIR CD REG 3,"Ford S. THOMPSON, JR.",West Hanover Twp--2nd Precinct,308,6,0,0,314,5566,93,0,0,5659
SCHOOL DIR CD REG 3,"Ford S. THOMPSON, JR.",West Hanover Twp--3rd Precinct,673,16,0,0,689,5566,93,0,0,5659
SCHOOL DIR CD REG 3,"Ford S. THOMPSON, JR.",West Hanover Twp--4th Precinct,382,3,0,0,385,5566,93,0,0,5659
SCHOOL DIR CD REG 3,Write In  ,Lower Paxton Twp--3rd precinct,160,0,0,0,160,1791,0,0,0,1791
SCHOOL DIR CD REG 3,Write In  ,Lower Paxton Twp--4th Precinct,95,0,0,0,95,1791,0,0,0,1791
SCHOOL DIR CD REG 3,Write In  ,Lower Paxton Twp--5th Precinct,94,0,0,0,94,1791,0,0,0,1791
SCHOOL DIR CD REG 3,Write In  ,Lower Paxton Twp--7th Precinct,129,0,0,0,129,1791,0,0,0,1791
SCHOOL DIR CD REG 3,Write In  ,Lower Paxton Twp--9th Precinct,77,0,0,0,77,1791,0,0,0,1791
SCHOOL DIR CD REG 3,Write In  ,Lower Paxton Twp--12th Precinct,125,0,0,0,125,1791,0,0,0,1791
SCHOOL DIR CD REG 3,Write In  ,Lower Paxton Twp--13th Precinct,146,0,0,0,146,1791,0,0,0,1791
SCHOOL DIR CD REG 3,Write In  ,Lower Paxton Twp--15th Precinct,85,0,0,0,85,1791,0,0,0,1791
SCHOOL DIR CD REG 3,Write In  ,Lower Paxton Twp--16th Precinct,128,0,0,0,128,1791,0,0,0,1791
SCHOOL DIR CD REG 3,Write In  ,Lower Paxton Twp--20th Precinct,114,0,0,0,114,1791,0,0,0,1791
SCHOOL DIR CD REG 3,Write In  ,Lower Paxton Twp--24th Precinct,97,0,0,0,97,1791,0,0,0,1791
SCHOOL DIR CD REG 3,Write In  ,Lower Paxton Twp--27th Precinct,71,0,0,0,71,1791,0,0,0,1791
SCHOOL DIR CD REG 3,Write In  ,West Hanover Twp--1st Precinct,103,0,0,0,103,1791,0,0,0,1791
SCHOOL DIR CD REG 3,Write In  ,West Hanover Twp--2nd Precinct,109,0,0,0,109,1791,0,0,0,1791
SCHOOL DIR CD REG 3,Write In  ,West Hanover Twp--3rd Precinct,168,0,0,0,168,1791,0,0,0,1791
SCHOOL DIR CD REG 3,Write In  ,West Hanover Twp--4th Precinct,90,0,0,0,90,1791,0,0,0,1791
SCHOOL DIR LD REG 1,Sara  GELLATLY,Conewago Twp--1st Precinct,267,2,0,0,269,1187,10,0,0,1197
SCHOOL DIR LD REG 1,Sara  GELLATLY,Conewago Twp--2nd Precinct,209,3,0,0,212,1187,10,0,0,1197
SCHOOL DIR LD REG 1,Sara  GELLATLY,Londonderry Twp--1st Precinct,294,0,0,0,294,1187,10,0,0,1197
SCHOOL DIR LD REG 1,Sara  GELLATLY,Londonderry Twp--2nd Precinct,294,4,0,0,298,1187,10,0,0,1197
SCHOOL DIR LD REG 1,Sara  GELLATLY,Londonderry Twp--3rd Precinct,123,1,0,0,124,1187,10,0,0,1197
SCHOOL DIR LD REG 1,Todd M. KREISER,Conewago Twp--1st Precinct,285,2,0,0,287,1240,9,0,0,1249
SCHOOL DIR LD REG 1,Todd M. KREISER,Conewago Twp--2nd Precinct,217,3,0,0,220,1240,9,0,0,1249
SCHOOL DIR LD REG 1,Todd M. KREISER,Londonderry Twp--1st Precinct,311,0,0,0,311,1240,9,0,0,1249
SCHOOL DIR LD REG 1,Todd M. KREISER,Londonderry Twp--2nd Precinct,294,3,0,0,297,1240,9,0,0,1249
SCHOOL DIR LD REG 1,Todd M. KREISER,Londonderry Twp--3rd Precinct,133,1,0,0,134,1240,9,0,0,1249
SCHOOL DIR LD REG 1,Write In  ,Conewago Twp--1st Precinct,0,0,0,0,0,3,0,0,0,3
SCHOOL DIR LD REG 1,Write In  ,Conewago Twp--2nd Precinct,2,0,0,0,2,3,0,0,0,3
SCHOOL DIR LD REG 1,Write In  ,Londonderry Twp--1st Precinct,0,0,0,0,0,3,0,0,0,3
SCHOOL DIR LD REG 1,Write In  ,Londonderry Twp--2nd Precinct,1,0,0,0,1,3,0,0,0,3
SCHOOL DIR LD REG 1,Write In  ,Londonderry Twp--3rd Precinct,0,0,0,0,0,3,0,0,0,3
SCHOOL DIR MILLERSBURG,Mark D. ROTHERMEL,Millersburg--1st Ward,133,4,0,0,137,781,10,0,0,791
SCHOOL DIR MILLERSBURG,Mark D. ROTHERMEL,Millersburg--2nd Ward,175,4,0,0,179,781,10,0,0,791
SCHOOL DIR MILLERSBURG,Mark D. ROTHERMEL,Upper Paxton Twp--1st Precinct,283,1,0,0,284,781,10,0,0,791
SCHOOL DIR MILLERSBURG,Mark D. ROTHERMEL,Upper Paxton Twp--2nd Precinct,190,1,0,0,191,781,10,0,0,791
SCHOOL DIR MILLERSBURG,Steven T. BOYER,Millersburg--1st Ward,135,3,0,0,138,835,8,0,0,843
SCHOOL DIR MILLERSBURG,Steven T. BOYER,Millersburg--2nd Ward,188,3,0,0,191,835,8,0,0,843
SCHOOL DIR MILLERSBURG,Steven T. BOYER,Upper Paxton Twp--1st Precinct,309,1,0,0,310,835,8,0,0,843
SCHOOL DIR MILLERSBURG,Steven T. BOYER,Upper Paxton Twp--2nd Precinct,203,1,0,0,204,835,8,0,0,843
SCHOOL DIR MILLERSBURG,Terry L. BURROWS,Millersburg--1st Ward,137,3,0,0,140,796,10,0,0,806
SCHOOL DIR MILLERSBURG,Terry L. BURROWS,Millersburg--2nd Ward,181,4,0,0,185,796,10,0,0,806
SCHOOL DIR MILLERSBURG,Terry L. BURROWS,Upper Paxton Twp--1st Precinct,289,1,0,0,290,796,10,0,0,806
SCHOOL DIR MILLERSBURG,Terry L. BURROWS,Upper Paxton Twp--2nd Precinct,189,2,0,0,191,796,10,0,0,806
SCHOOL DIR MILLERSBURG,Write In  ,Millersburg--1st Ward,6,0,0,0,6,75,0,0,0,75
SCHOOL DIR MILLERSBURG,Write In  ,Millersburg--2nd Ward,10,0,0,0,10,75,0,0,0,75
SCHOOL DIR MILLERSBURG,Write In  ,Upper Paxton Twp--1st Precinct,32,0,0,0,32,75,0,0,0,75
SCHOOL DIR MILLERSBURG,Write In  ,Upper Paxton Twp--2nd Precinct,27,0,0,0,27,75,0,0,0,75
SCHOOL DIR REED,Write In  ,Reed Township,0,0,0,0,0,0,0,0,0,0
SCHOOL DIR SUSQ,Kevin R. HELM,Susquehanna Twp--1st Ward,221,12,0,0,233,1886,47,0,0,1933
SCHOOL DIR SUSQ,Kevin R. HELM,Susquehanna Twp--2nd Ward,345,14,0,0,359,1886,47,0,0,1933
SCHOOL DIR SUSQ,Kevin R. HELM,Susquehanna Twp--3rd Ward,119,0,0,0,119,1886,47,0,0,1933
SCHOOL DIR SUSQ,Kevin R. HELM,Susquehanna Twp--4th Ward,158,4,0,0,162,1886,47,0,0,1933
SCHOOL DIR SUSQ,Kevin R. HELM,Susquehanna Twp--5th Ward,199,3,0,0,202,1886,47,0,0,1933
SCHOOL DIR SUSQ,Kevin R. HELM,Susquehanna Twp--6th Ward,262,3,0,0,265,1886,47,0,0,1933
SCHOOL DIR SUSQ,Kevin R. HELM,Susquehanna Twp--7th Ward,114,0,0,0,114,1886,47,0,0,1933
SCHOOL DIR SUSQ,Kevin R. HELM,Susquehanna Twp--8th Ward,289,9,0,0,298,1886,47,0,0,1933
SCHOOL DIR SUSQ,Kevin R. HELM,Susquehanna Twp--9th Ward,179,2,0,0,181,1886,47,0,0,1933
SCHOOL DIR SUSQ,Michael S. FERGUSON,Susquehanna Twp--1st Ward,458,14,0,0,472,3539,66,0,0,3605
SCHOOL DIR SUSQ,Michael S. FERGUSON,Susquehanna Twp--2nd Ward,602,21,0,0,623,3539,66,0,0,3605
SCHOOL DIR SUSQ,Michael S. FERGUSON,Susquehanna Twp--3rd Ward,284,3,0,0,287,3539,66,0,0,3605
SCHOOL DIR SUSQ,Michael S. FERGUSON,Susquehanna Twp--4th Ward,316,4,0,0,320,3539,66,0,0,3605
SCHOOL DIR SUSQ,Michael S. FERGUSON,Susquehanna Twp--5th Ward,342,3,0,0,345,3539,66,0,0,3605
SCHOOL DIR SUSQ,Michael S. FERGUSON,Susquehanna Twp--6th Ward,423,6,0,0,429,3539,66,0,0,3605
SCHOOL DIR SUSQ,Michael S. FERGUSON,Susquehanna Twp--7th Ward,214,0,0,0,214,3539,66,0,0,3605
SCHOOL DIR SUSQ,Michael S. FERGUSON,Susquehanna Twp--8th Ward,531,14,0,0,545,3539,66,0,0,3605
SCHOOL DIR SUSQ,Michael S. FERGUSON,Susquehanna Twp--9th Ward,369,1,0,0,370,3539,66,0,0,3605
SCHOOL DIR SUSQ,Nick G. GEKAS,Susquehanna Twp--1st Ward,261,11,0,0,272,2173,55,0,0,2228
SCHOOL DIR SUSQ,Nick G. GEKAS,Susquehanna Twp--2nd Ward,381,15,0,0,396,2173,55,0,0,2228
SCHOOL DIR SUSQ,Nick G. GEKAS,Susquehanna Twp--3rd Ward,147,0,0,0,147,2173,55,0,0,2228
SCHOOL DIR SUSQ,Nick G. GEKAS,Susquehanna Twp--4th Ward,185,4,0,0,189,2173,55,0,0,2228
SCHOOL DIR SUSQ,Nick G. GEKAS,Susquehanna Twp--5th Ward,265,5,0,0,270,2173,55,0,0,2228
SCHOOL DIR SUSQ,Nick G. GEKAS,Susquehanna Twp--6th Ward,257,7,0,0,264,2173,55,0,0,2228
SCHOOL DIR SUSQ,Nick G. GEKAS,Susquehanna Twp--7th Ward,118,0,0,0,118,2173,55,0,0,2228
SCHOOL DIR SUSQ,Nick G. GEKAS,Susquehanna Twp--8th Ward,352,11,0,0,363,2173,55,0,0,2228
SCHOOL DIR SUSQ,Nick G. GEKAS,Susquehanna Twp--9th Ward,207,2,0,0,209,2173,55,0,0,2228
SCHOOL DIR SUSQ,Patricia  GARCIA,Susquehanna Twp--1st Ward,470,15,0,0,485,3591,73,0,0,3664
SCHOOL DIR SUSQ,Patricia  GARCIA,Susquehanna Twp--2nd Ward,647,24,0,0,671,3591,73,0,0,3664
SCHOOL DIR SUSQ,Patricia  GARCIA,Susquehanna Twp--3rd Ward,297,4,0,0,301,3591,73,0,0,3664
SCHOOL DIR SUSQ,Patricia  GARCIA,Susquehanna Twp--4th Ward,308,4,0,0,312,3591,73,0,0,3664
SCHOOL DIR SUSQ,Patricia  GARCIA,Susquehanna Twp--5th Ward,353,6,0,0,359,3591,73,0,0,3664
SCHOOL DIR SUSQ,Patricia  GARCIA,Susquehanna Twp--6th Ward,372,2,0,0,374,3591,73,0,0,3664
SCHOOL DIR SUSQ,Patricia  GARCIA,Susquehanna Twp--7th Ward,204,0,0,0,204,3591,73,0,0,3664
SCHOOL DIR SUSQ,Patricia  GARCIA,Susquehanna Twp--8th Ward,548,15,0,0,563,3591,73,0,0,3664
SCHOOL DIR SUSQ,Patricia  GARCIA,Susquehanna Twp--9th Ward,392,3,0,0,395,3591,73,0,0,3664
SCHOOL DIR SUSQ,Peter J. SAKOL,Susquehanna Twp--1st Ward,471,15,0,0,486,3583,63,0,0,3646
SCHOOL DIR SUSQ,Peter J. SAKOL,Susquehanna Twp--2nd Ward,658,19,0,0,677,3583,63,0,0,3646
SCHOOL DIR SUSQ,Peter J. SAKOL,Susquehanna Twp--3rd Ward,275,4,0,0,279,3583,63,0,0,3646
SCHOOL DIR SUSQ,Peter J. SAKOL,Susquehanna Twp--4th Ward,299,5,0,0,304,3583,63,0,0,3646
SCHOOL DIR SUSQ,Peter J. SAKOL,Susquehanna Twp--5th Ward,342,3,0,0,345,3583,63,0,0,3646
SCHOOL DIR SUSQ,Peter J. SAKOL,Susquehanna Twp--6th Ward,381,3,0,0,384,3583,63,0,0,3646
SCHOOL DIR SUSQ,Peter J. SAKOL,Susquehanna Twp--7th Ward,205,0,0,0,205,3583,63,0,0,3646
SCHOOL DIR SUSQ,Peter J. SAKOL,Susquehanna Twp--8th Ward,547,13,0,0,560,3583,63,0,0,3646
SCHOOL DIR SUSQ,Peter J. SAKOL,Susquehanna Twp--9th Ward,405,1,0,0,406,3583,63,0,0,3646
SCHOOL DIR SUSQ,Ray E. LANDIS,Susquehanna Twp--1st Ward,280,4,0,0,284,1986,41,0,0,2027
SCHOOL DIR SUSQ,Ray E. LANDIS,Susquehanna Twp--2nd Ward,341,14,0,0,355,1986,41,0,0,2027
SCHOOL DIR SUSQ,Ray E. LANDIS,Susquehanna Twp--3rd Ward,188,4,0,0,192,1986,41,0,0,2027
SCHOOL DIR SUSQ,Ray E. LANDIS,Susquehanna Twp--4th Ward,178,1,0,0,179,1986,41,0,0,2027
SCHOOL DIR SUSQ,Ray E. LANDIS,Susquehanna Twp--5th Ward,165,5,0,0,170,1986,41,0,0,2027
SCHOOL DIR SUSQ,Ray E. LANDIS,Susquehanna Twp--6th Ward,176,3,0,0,179,1986,41,0,0,2027
SCHOOL DIR SUSQ,Ray E. LANDIS,Susquehanna Twp--7th Ward,118,0,0,0,118,1986,41,0,0,2027
SCHOOL DIR SUSQ,Ray E. LANDIS,Susquehanna Twp--8th Ward,285,10,0,0,295,1986,41,0,0,2027
SCHOOL DIR SUSQ,Ray E. LANDIS,Susquehanna Twp--9th Ward,255,0,0,0,255,1986,41,0,0,2027
SCHOOL DIR SUSQ,Robert T. ADAMS,Susquehanna Twp--1st Ward,265,7,0,0,272,1916,40,0,0,1956
SCHOOL DIR SUSQ,Robert T. ADAMS,Susquehanna Twp--2nd Ward,298,12,0,0,310,1916,40,0,0,1956
SCHOOL DIR SUSQ,Robert T. ADAMS,Susquehanna Twp--3rd Ward,244,4,0,0,248,1916,40,0,0,1956
SCHOOL DIR SUSQ,Robert T. ADAMS,Susquehanna Twp--4th Ward,186,1,0,0,187,1916,40,0,0,1956
SCHOOL DIR SUSQ,Robert T. ADAMS,Susquehanna Twp--5th Ward,153,5,0,0,158,1916,40,0,0,1956
SCHOOL DIR SUSQ,Robert T. ADAMS,Susquehanna Twp--6th Ward,158,1,0,0,159,1916,40,0,0,1956
SCHOOL DIR SUSQ,Robert T. ADAMS,Susquehanna Twp--7th Ward,130,0,0,0,130,1916,40,0,0,1956
SCHOOL DIR SUSQ,Robert T. ADAMS,Susquehanna Twp--8th Ward,240,9,0,0,249,1916,40,0,0,1956
SCHOOL DIR SUSQ,Robert T. ADAMS,Susquehanna Twp--9th Ward,242,1,0,0,243,1916,40,0,0,1956
SCHOOL DIR SUSQ,Write In  ,Susquehanna Twp--1st Ward,65,0,0,0,65,540,0,0,0,540
SCHOOL DIR SUSQ,Write In  ,Susquehanna Twp--2nd Ward,133,0,0,0,133,540,0,0,0,540
SCHOOL DIR SUSQ,Write In  ,Susquehanna Twp--3rd Ward,30,0,0,0,30,540,0,0,0,540
SCHOOL DIR SUSQ,Write In  ,Susquehanna Twp--4th Ward,39,0,0,0,39,540,0,0,0,540
SCHOOL DIR SUSQ,Write In  ,Susquehanna Twp--5th Ward,45,0,0,0,45,540,0,0,0,540
SCHOOL DIR SUSQ,Write In  ,Susquehanna Twp--6th Ward,64,0,0,0,64,540,0,0,0,540
SCHOOL DIR SUSQ,Write In  ,Susquehanna Twp--7th Ward,4,0,0,0,4,540,0,0,0,540
SCHOOL DIR SUSQ,Write In  ,Susquehanna Twp--8th Ward,123,0,0,0,123,540,0,0,0,540
SCHOOL DIR SUSQ,Write In  ,Susquehanna Twp--9th Ward,37,0,0,0,37,540,0,0,0,540
SCHOOL DIR UD REG 1,Jack L. LAUDENSLAGER,Berrysburg Borough,62,0,0,0,62,395,1,0,0,396
SCHOOL DIR UD REG 1,Jack L. LAUDENSLAGER,Gratz Borough,87,1,0,0,88,395,1,0,0,396
SCHOOL DIR UD REG 1,Jack L. LAUDENSLAGER,Pillow Borough,58,0,0,0,58,395,1,0,0,396
SCHOOL DIR UD REG 1,Jack L. LAUDENSLAGER,Lykens Township,99,0,0,0,99,395,1,0,0,396
SCHOOL DIR UD REG 1,Jack L. LAUDENSLAGER,Mifflin Township,89,0,0,0,89,395,1,0,0,396
SCHOOL DIR UD REG 1,Write In  ,Berrysburg Borough,0,0,0,0,0,1,0,0,0,1
SCHOOL DIR UD REG 1,Write In  ,Gratz Borough,1,0,0,0,1,1,0,0,0,1
SCHOOL DIR UD REG 1,Write In  ,Pillow Borough,0,0,0,0,0,1,0,0,0,1
SCHOOL DIR UD REG 1,Write In  ,Lykens Township,0,0,0,0,0,1,0,0,0,1
SCHOOL DIR UD REG 1,Write In  ,Mifflin Township,0,0,0,0,0,1,0,0,0,1
SCHOOL DIR UD REG 2,Dennis  HENNINGER,Elizabethville Borough,177,1,0,0,178,525,6,0,0,531
SCHOOL DIR UD REG 2,Dennis  HENNINGER,Jefferson Township,71,0,0,0,71,525,6,0,0,531
SCHOOL DIR UD REG 2,Dennis  HENNINGER,Washington Township,277,5,0,0,282,525,6,0,0,531
SCHOOL DIR UD REG 2,Tracy L. SCHREY,Elizabethville Borough,173,0,0,0,173,509,4,0,0,513
SCHOOL DIR UD REG 2,Tracy L. SCHREY,Jefferson Township,64,0,0,0,64,509,4,0,0,513
SCHOOL DIR UD REG 2,Tracy L. SCHREY,Washington Township,272,4,0,0,276,509,4,0,0,513
SCHOOL DIR UD REG 2,Write In  ,Elizabethville Borough,0,0,0,0,0,0,0,0,0,0
SCHOOL DIR UD REG 2,Write In  ,Jefferson Township,0,0,0,0,0,0,0,0,0,0
SCHOOL DIR UD REG 2,Write In  ,Washington Township,0,0,0,0,0,0,0,0,0,0
SCHOOL DIR UD REG 3,Write In  ,Lykens Borough--1st Ward,4,0,0,0,4,15,0,0,0,15
SCHOOL DIR UD REG 3,Write In  ,Lykens Borough--2nd Ward,11,0,0,0,11,15,0,0,0,15
SCHOOL DIR WICONISCO 2,Write In  ,Wiconisco Twp--2nd Precinct,23,0,0,0,23,23,0,0,0,23
SCHOOL DIR WILLIAMS,Tracey L. MINNICH,Williams Twp,89,1,0,0,90,89,1,0,0,90
SCHOOL DIR WILLIAMS,Write In  ,Williams Twp,90,0,0,0,90,90,0,0,0,90
SCHOOL DIR WILLIAMSTWN 2,Write In  ,Williamstown--2nd Ward,19,0,0,0,19,19,0,0,0,19
SCHOOL DIRECTOR RUSH,Write In  ,Rush Township,21,0,0,0,21,21,0,0,0,21
SHERIFF,Jack  LOTWICK,"City--1st Ward, 1st Precinct",64,2,0,0,66,32162,665,19,0,32846
SHERIFF,Jack  LOTWICK,"City--1st Ward, 2nd Precinct",124,1,1,0,126,32162,665,19,0,32846
SHERIFF,Jack  LOTWICK,"City--1st Ward, 3rd Precinct",33,0,0,0,33,32162,665,19,0,32846
SHERIFF,Jack  LOTWICK,"City--2nd Ward, 1st Precinct",34,0,0,0,34,32162,665,19,0,32846
SHERIFF,Jack  LOTWICK,"City--2nd Ward, 2nd Precinct",51,1,0,0,52,32162,665,19,0,32846
SHERIFF,Jack  LOTWICK,City--3rd Ward,64,1,0,0,65,32162,665,19,0,32846
SHERIFF,Jack  LOTWICK,City--4th Ward,105,4,0,0,109,32162,665,19,0,32846
SHERIFF,Jack  LOTWICK,City--5th Ward,191,9,0,0,200,32162,665,19,0,32846
SHERIFF,Jack  LOTWICK,City--6th Ward,113,1,2,0,116,32162,665,19,0,32846
SHERIFF,Jack  LOTWICK,"City--7th Ward, 1st Precinct",39,2,0,0,41,32162,665,19,0,32846
SHERIFF,Jack  LOTWICK,"City--7th Ward, 2nd Precinct",60,2,0,0,62,32162,665,19,0,32846
SHERIFF,Jack  LOTWICK,City--8th Ward,53,2,0,0,55,32162,665,19,0,32846
SHERIFF,Jack  LOTWICK,"City--9th Ward, 1st Precinct",31,2,0,0,33,32162,665,19,0,32846
SHERIFF,Jack  LOTWICK,"City--9th Ward, 2nd Precinct",39,1,0,0,40,32162,665,19,0,32846
SHERIFF,Jack  LOTWICK,"City--9th Ward, 3rd Precinct",73,2,0,0,75,32162,665,19,0,32846
SHERIFF,Jack  LOTWICK,"City--9th Ward, 4th Precinct",146,3,0,0,149,32162,665,19,0,32846
SHERIFF,Jack  LOTWICK,"City--9th Ward, 5th Precinct",91,5,0,0,96,32162,665,19,0,32846
SHERIFF,Jack  LOTWICK,"City--10th Ward, 1st Precinct",127,6,0,0,133,32162,665,19,0,32846
SHERIFF,Jack  LOTWICK,"City--10th Ward, 2nd Precinct",43,0,0,0,43,32162,665,19,0,32846
SHERIFF,Jack  LOTWICK,"City--10th Ward, 3rd Precinct",87,1,0,0,88,32162,665,19,0,32846
SHERIFF,Jack  LOTWICK,"City--10th Ward, 4th Precinct",50,0,0,0,50,32162,665,19,0,32846
SHERIFF,Jack  LOTWICK,City--11th Ward,56,32,0,0,88,32162,665,19,0,32846
SHERIFF,Jack  LOTWICK,City--12th Ward,158,6,0,0,164,32162,665,19,0,32846
SHERIFF,Jack  LOTWICK,"City--13th Ward, 1st Precinct",94,0,0,0,94,32162,665,19,0,32846
SHERIFF,Jack  LOTWICK,"City--13th Ward, 2nd Precinct",142,4,0,0,146,32162,665,19,0,32846
SHERIFF,Jack  LOTWICK,"City--13th Ward, 3rd Precinct",149,2,0,0,151,32162,665,19,0,32846
SHERIFF,Jack  LOTWICK,City--14th Ward,271,3,0,0,274,32162,665,19,0,32846
SHERIFF,Jack  LOTWICK,City--15th Ward,39,0,0,0,39,32162,665,19,0,32846
SHERIFF,Jack  LOTWICK,Berrysburg Borough,59,0,0,0,59,32162,665,19,0,32846
SHERIFF,Jack  LOTWICK,Dauphin Borough,150,1,0,0,151,32162,665,19,0,32846
SHERIFF,Jack  LOTWICK,Elizabethville Borough,167,1,0,0,168,32162,665,19,0,32846
SHERIFF,Jack  LOTWICK,Gratz Borough,87,2,0,0,89,32162,665,19,0,32846
SHERIFF,Jack  LOTWICK,Halifax Borough,76,3,0,0,79,32162,665,19,0,32846
SHERIFF,Jack  LOTWICK,Highspire--1st Precinct,129,3,0,0,132,32162,665,19,0,32846
SHERIFF,Jack  LOTWICK,Highspire--2nd Precinct,142,1,0,0,143,32162,665,19,0,32846
SHERIFF,Jack  LOTWICK,Hummelstown--1st Precinct,197,4,0,0,201,32162,665,19,0,32846
SHERIFF,Jack  LOTWICK,Hummelstown--2nd Precinct,410,4,0,0,414,32162,665,19,0,32846
SHERIFF,Jack  LOTWICK,Lykens Borough--1st Ward,83,1,0,0,84,32162,665,19,0,32846
SHERIFF,Jack  LOTWICK,Lykens Borough--2nd Ward,122,4,0,0,126,32162,665,19,0,32846
SHERIFF,Jack  LOTWICK,"Middletown--1st Ward, 1st Precinct",93,0,0,0,93,32162,665,19,0,32846
SHERIFF,Jack  LOTWICK,"Middletown--1st Ward, 2nd Precinct",142,7,1,0,150,32162,665,19,0,32846
SHERIFF,Jack  LOTWICK,"Middletown--2nd Ward, 1st Precinct",153,2,0,0,155,32162,665,19,0,32846
SHERIFF,Jack  LOTWICK,"Middletown--2nd Ward, 2nd Precinct",153,5,0,0,158,32162,665,19,0,32846
SHERIFF,Jack  LOTWICK,"Middletown--3rd Ward, 1st Precinct",126,1,0,0,127,32162,665,19,0,32846
SHERIFF,Jack  LOTWICK,"Middletown--3rd Ward, 2nd Precinct",194,0,0,0,194,32162,665,19,0,32846
SHERIFF,Jack  LOTWICK,Millersburg--1st Ward,135,4,0,0,139,32162,665,19,0,32846
SHERIFF,Jack  LOTWICK,Millersburg--2nd Ward,184,4,0,0,188,32162,665,19,0,32846
SHERIFF,Jack  LOTWICK,Paxtang Borough,239,4,0,0,243,32162,665,19,0,32846
SHERIFF,Jack  LOTWICK,Penbrook Borough--1st Ward,54,1,0,0,55,32162,665,19,0,32846
SHERIFF,Jack  LOTWICK,Penbrook Borough--2nd Ward,68,1,0,0,69,32162,665,19,0,32846
SHERIFF,Jack  LOTWICK,Penbrook Borough--3rd Ward,75,0,0,0,75,32162,665,19,0,32846
SHERIFF,Jack  LOTWICK,Penbrook Borough--4th Ward,80,1,0,0,81,32162,665,19,0,32846
SHERIFF,Jack  LOTWICK,Royalton Borough--1st Ward,39,0,0,0,39,32162,665,19,0,32846
SHERIFF,Jack  LOTWICK,Royalton Borough--2nd Ward,75,0,0,0,75,32162,665,19,0,32846
SHERIFF,Jack  LOTWICK,Steelton--1st Ward,126,6,0,0,132,32162,665,19,0,32846
SHERIFF,Jack  LOTWICK,"Steelton--2nd Ward, 1st Precinct",87,2,0,0,89,32162,665,19,0,32846
SHERIFF,Jack  LOTWICK,"Steelton--2nd Ward, 2nd Precinct",81,1,0,0,82,32162,665,19,0,32846
SHERIFF,Jack  LOTWICK,"Steelton--3rd Ward, 1st Precinct",37,0,0,0,37,32162,665,19,0,32846
SHERIFF,Jack  LOTWICK,"Steelton--3rd Ward, 2nd Precinct",77,0,0,0,77,32162,665,19,0,32846
SHERIFF,Jack  LOTWICK,Steelton--4th Ward,71,1,1,0,73,32162,665,19,0,32846
SHERIFF,Jack  LOTWICK,Pillow Borough,48,0,0,0,48,32162,665,19,0,32846
SHERIFF,Jack  LOTWICK,Williamstown--1st Ward,91,1,0,0,92,32162,665,19,0,32846
SHERIFF,Jack  LOTWICK,Williamstown--2nd Ward,68,0,0,0,68,32162,665,19,0,32846
SHERIFF,Jack  LOTWICK,Conewago Twp--1st Precinct,272,1,0,0,273,32162,665,19,0,32846
SHERIFF,Jack  LOTWICK,Conewago Twp--2nd Precinct,200,7,0,0,207,32162,665,19,0,32846
SHERIFF,Jack  LOTWICK,Derry Township--1st Precinct,323,4,0,0,327,32162,665,19,0,32846
SHERIFF,Jack  LOTWICK,Derry Township--2nd Precinct,253,7,0,0,260,32162,665,19,0,32846
SHERIFF,Jack  LOTWICK,Derry Township--3rd Precinct,195,4,0,0,199,32162,665,19,0,32846
SHERIFF,Jack  LOTWICK,Derry Township--4th Precinct,169,5,0,0,174,32162,665,19,0,32846
SHERIFF,Jack  LOTWICK,Derry Township--5th Precinct,136,3,0,0,139,32162,665,19,0,32846
SHERIFF,Jack  LOTWICK,Derry Township--6th Precinct,161,1,1,0,163,32162,665,19,0,32846
SHERIFF,Jack  LOTWICK,Derry Township--7th Precinct,367,16,0,0,383,32162,665,19,0,32846
SHERIFF,Jack  LOTWICK,Derry Township--8th Precinct,180,0,0,0,180,32162,665,19,0,32846
SHERIFF,Jack  LOTWICK,Derry Township--9th Precinct,109,3,0,0,112,32162,665,19,0,32846
SHERIFF,Jack  LOTWICK,Derry Township--10th Precinct,255,3,0,0,258,32162,665,19,0,32846
SHERIFF,Jack  LOTWICK,Derry Township--11th Precinct,316,7,0,0,323,32162,665,19,0,32846
SHERIFF,Jack  LOTWICK,Derry Township--12th Precinct,182,2,0,0,184,32162,665,19,0,32846
SHERIFF,Jack  LOTWICK,Derry Township--13th Precinct,250,7,0,0,257,32162,665,19,0,32846
SHERIFF,Jack  LOTWICK,Derry Township--14th Precinct,179,5,0,0,184,32162,665,19,0,32846
SHERIFF,Jack  LOTWICK,Derry Township--15th Precinct,324,6,1,0,331,32162,665,19,0,32846
SHERIFF,Jack  LOTWICK,East Hanover Township--1st Precinct,344,9,0,0,353,32162,665,19,0,32846
SHERIFF,Jack  LOTWICK,East Hanover Township--2nd Precinct,397,5,0,0,402,32162,665,19,0,32846
SHERIFF,Jack  LOTWICK,Halifax Twp--1st Precinct,273,3,0,0,276,32162,665,19,0,32846
SHERIFF,Jack  LOTWICK,Halifax Twp--2nd Precinct,329,12,0,0,341,32162,665,19,0,32846
SHERIFF,Jack  LOTWICK,Jackson Township,221,1,0,0,222,32162,665,19,0,32846
SHERIFF,Jack  LOTWICK,Jefferson Township,63,0,0,0,63,32162,665,19,0,32846
SHERIFF,Jack  LOTWICK,Londonderry Twp--1st Precinct,292,0,0,0,292,32162,665,19,0,32846
SHERIFF,Jack  LOTWICK,Londonderry Twp--2nd Precinct,284,3,0,0,287,32162,665,19,0,32846
SHERIFF,Jack  LOTWICK,Londonderry Twp--3rd Precinct,117,1,0,0,118,32162,665,19,0,32846
SHERIFF,Jack  LOTWICK,Lower Paxton Twp--1st Precinct,211,3,0,0,214,32162,665,19,0,32846
SHERIFF,Jack  LOTWICK,Lower Paxton Twp--2nd Precinct,217,8,0,0,225,32162,665,19,0,32846
SHERIFF,Jack  LOTWICK,Lower Paxton Twp--3rd precinct,422,11,0,0,433,32162,665,19,0,32846
SHERIFF,Jack  LOTWICK,Lower Paxton Twp--4th Precinct,310,4,0,0,314,32162,665,19,0,32846
SHERIFF,Jack  LOTWICK,Lower Paxton Twp--5th Precinct,251,4,1,0,256,32162,665,19,0,32846
SHERIFF,Jack  LOTWICK,Lower Paxton Twp--6th Precinct,198,3,0,0,201,32162,665,19,0,32846
SHERIFF,Jack  LOTWICK,Lower Paxton Twp--7th Precinct,371,7,0,0,378,32162,665,19,0,32846
SHERIFF,Jack  LOTWICK,Lower Paxton Twp--8th Precinct,160,2,0,0,162,32162,665,19,0,32846
SHERIFF,Jack  LOTWICK,Lower Paxton Twp--9th Precinct,222,4,0,0,226,32162,665,19,0,32846
SHERIFF,Jack  LOTWICK,Lower Paxton Twp--10th Precinct,119,4,0,0,123,32162,665,19,0,32846
SHERIFF,Jack  LOTWICK,Lower Paxton Twp--11th Precinct,207,2,1,0,210,32162,665,19,0,32846
SHERIFF,Jack  LOTWICK,Lower Paxton Twp--12th Precinct,318,8,1,0,327,32162,665,19,0,32846
SHERIFF,Jack  LOTWICK,Lower Paxton Twp--13th Precinct,280,6,0,0,286,32162,665,19,0,32846
SHERIFF,Jack  LOTWICK,Lower Paxton Twp--14th Precinct,162,3,3,0,168,32162,665,19,0,32846
SHERIFF,Jack  LOTWICK,Lower Paxton Twp--15th Precinct,259,4,0,0,263,32162,665,19,0,32846
SHERIFF,Jack  LOTWICK,Lower Paxton Twp--16th Precinct,451,11,0,0,462,32162,665,19,0,32846
SHERIFF,Jack  LOTWICK,Lower Paxton Twp--17th Precinct,201,7,0,0,208,32162,665,19,0,32846
SHERIFF,Jack  LOTWICK,Lower Paxton Twp--18th Precinct,190,2,0,0,192,32162,665,19,0,32846
SHERIFF,Jack  LOTWICK,Lower Paxton Twp--19th Precinct,359,15,0,0,374,32162,665,19,0,32846
SHERIFF,Jack  LOTWICK,Lower Paxton Twp--20th Precinct,286,5,0,0,291,32162,665,19,0,32846
SHERIFF,Jack  LOTWICK,Lower Paxton Twp--21st Precinct,355,10,0,0,365,32162,665,19,0,32846
SHERIFF,Jack  LOTWICK,Lower Paxton Twp--22nd Precinct,304,5,0,0,309,32162,665,19,0,32846
SHERIFF,Jack  LOTWICK,Lower Paxton Twp--23rd Precinct,275,3,0,0,278,32162,665,19,0,32846
SHERIFF,Jack  LOTWICK,Lower Paxton Twp--24th Precinct,270,6,0,0,276,32162,665,19,0,32846
SHERIFF,Jack  LOTWICK,Lower Paxton Twp--25th Precinct,164,4,0,0,168,32162,665,19,0,32846
SHERIFF,Jack  LOTWICK,Lower Paxton Twp--26th Precinct,272,7,0,0,279,32162,665,19,0,32846
SHERIFF,Jack  LOTWICK,Lower Paxton Twp--27th Precinct,237,2,0,0,239,32162,665,19,0,32846
SHERIFF,Jack  LOTWICK,Lower Swatara Twp--1st Precinct,362,3,0,0,365,32162,665,19,0,32846
SHERIFF,Jack  LOTWICK,Lower Swatara Twp--2nd Precinct,294,8,0,0,302,32162,665,19,0,32846
SHERIFF,Jack  LOTWICK,Lower Swatara Twp--3rd Precinct,253,27,0,0,280,32162,665,19,0,32846
SHERIFF,Jack  LOTWICK,Lower Swatara Twp--4th Precinct,249,1,0,0,250,32162,665,19,0,32846
SHERIFF,Jack  LOTWICK,Lykens Township,97,0,0,0,97,32162,665,19,0,32846
SHERIFF,Jack  LOTWICK,Middle Paxton Twp--1st Precinct,327,0,0,0,327,32162,665,19,0,32846
SHERIFF,Jack  LOTWICK,Middle Paxton Twp--2nd Precinct,262,2,0,0,264,32162,665,19,0,32846
SHERIFF,Jack  LOTWICK,Middle Paxton Twp--3rd Precinct,372,2,0,0,374,32162,665,19,0,32846
SHERIFF,Jack  LOTWICK,Mifflin Township,85,0,0,0,85,32162,665,19,0,32846
SHERIFF,Jack  LOTWICK,Reed Township,43,0,0,0,43,32162,665,19,0,32846
SHERIFF,Jack  LOTWICK,Rush Township,39,0,0,0,39,32162,665,19,0,32846
SHERIFF,Jack  LOTWICK,South Hanover Twp--1st Precinct,294,5,0,0,299,32162,665,19,0,32846
SHERIFF,Jack  LOTWICK,South Hanover Twp--2nd Precinct,391,8,0,0,399,32162,665,19,0,32846
SHERIFF,Jack  LOTWICK,South Hanover Twp--3rd Precinct,230,2,0,0,232,32162,665,19,0,32846
SHERIFF,Jack  LOTWICK,Susquehanna Twp--1st Ward,379,16,0,0,395,32162,665,19,0,32846
SHERIFF,Jack  LOTWICK,Susquehanna Twp--2nd Ward,602,24,0,0,626,32162,665,19,0,32846
SHERIFF,Jack  LOTWICK,Susquehanna Twp--3rd Ward,221,0,0,0,221,32162,665,19,0,32846
SHERIFF,Jack  LOTWICK,Susquehanna Twp--4th Ward,269,5,0,0,274,32162,665,19,0,32846
SHERIFF,Jack  LOTWICK,Susquehanna Twp--5th Ward,316,6,0,0,322,32162,665,19,0,32846
SHERIFF,Jack  LOTWICK,Susquehanna Twp--6th Ward,373,9,0,0,382,32162,665,19,0,32846
SHERIFF,Jack  LOTWICK,Susquehanna Twp--7th Ward,180,0,0,0,180,32162,665,19,0,32846
SHERIFF,Jack  LOTWICK,Susquehanna Twp--8th Ward,466,17,0,0,483,32162,665,19,0,32846
SHERIFF,Jack  LOTWICK,Susquehanna Twp--9th Ward,315,4,0,0,319,32162,665,19,0,32846
SHERIFF,Jack  LOTWICK,Swatara Township--1st Ward,303,3,0,0,306,32162,665,19,0,32846
SHERIFF,Jack  LOTWICK,Swatara Township--2nd Ward,173,12,0,0,185,32162,665,19,0,32846
SHERIFF,Jack  LOTWICK,Swatara Township--3rd Ward,208,5,0,0,213,32162,665,19,0,32846
SHERIFF,Jack  LOTWICK,Swatara Township--4th Ward,319,10,0,0,329,32162,665,19,0,32846
SHERIFF,Jack  LOTWICK,Swatara Township--5th Ward,432,5,0,0,437,32162,665,19,0,32846
SHERIFF,Jack  LOTWICK,Swatara Township--6th Ward,401,2,1,0,404,32162,665,19,0,32846
SHERIFF,Jack  LOTWICK,Swatara Township--7th Ward,397,10,0,0,407,32162,665,19,0,32846
SHERIFF,Jack  LOTWICK,Swatara Township--8th Ward,474,6,1,0,481,32162,665,19,0,32846
SHERIFF,Jack  LOTWICK,Swatara Township--9th Ward,182,8,0,0,190,32162,665,19,0,32846
SHERIFF,Jack  LOTWICK,Upper Paxton Twp--1st Precinct,293,3,0,0,296,32162,665,19,0,32846
SHERIFF,Jack  LOTWICK,Upper Paxton Twp--2nd Precinct,190,2,0,0,192,32162,665,19,0,32846
SHERIFF,Jack  LOTWICK,Washington Township,276,7,0,0,283,32162,665,19,0,32846
SHERIFF,Jack  LOTWICK,Wayne Township,250,0,1,0,251,32162,665,19,0,32846
SHERIFF,Jack  LOTWICK,West Hanover Twp--1st Precinct,305,4,1,0,310,32162,665,19,0,32846
SHERIFF,Jack  LOTWICK,West Hanover Twp--2nd Precinct,294,7,1,0,302,32162,665,19,0,32846
SHERIFF,Jack  LOTWICK,West Hanover Twp--3rd Precinct,678,16,1,0,695,32162,665,19,0,32846
SHERIFF,Jack  LOTWICK,West Hanover Twp--4th Precinct,385,2,0,0,387,32162,665,19,0,32846
SHERIFF,Jack  LOTWICK,Wiconisco Twp--1st Precinct,74,1,0,0,75,32162,665,19,0,32846
SHERIFF,Jack  LOTWICK,Wiconisco Twp--2nd Precinct,59,1,0,0,60,32162,665,19,0,32846
SHERIFF,Jack  LOTWICK,Williams Twp,143,0,0,0,143,32162,665,19,0,32846
SHERIFF,Write In  ,"City--1st Ward, 1st Precinct",0,0,0,0,0,49,0,0,0,49
SHERIFF,Write In  ,"City--1st Ward, 2nd Precinct",0,0,0,0,0,49,0,0,0,49
SHERIFF,Write In  ,"City--1st Ward, 3rd Precinct",0,0,0,0,0,49,0,0,0,49
SHERIFF,Write In  ,"City--2nd Ward, 1st Precinct",0,0,0,0,0,49,0,0,0,49
SHERIFF,Write In  ,"City--2nd Ward, 2nd Precinct",0,0,0,0,0,49,0,0,0,49
SHERIFF,Write In  ,City--3rd Ward,0,0,0,0,0,49,0,0,0,49
SHERIFF,Write In  ,City--4th Ward,1,0,0,0,1,49,0,0,0,49
SHERIFF,Write In  ,City--5th Ward,2,0,0,0,2,49,0,0,0,49
SHERIFF,Write In  ,City--6th Ward,0,0,0,0,0,49,0,0,0,49
SHERIFF,Write In  ,"City--7th Ward, 1st Precinct",0,0,0,0,0,49,0,0,0,49
SHERIFF,Write In  ,"City--7th Ward, 2nd Precinct",0,0,0,0,0,49,0,0,0,49
SHERIFF,Write In  ,City--8th Ward,1,0,0,0,1,49,0,0,0,49
SHERIFF,Write In  ,"City--9th Ward, 1st Precinct",0,0,0,0,0,49,0,0,0,49
SHERIFF,Write In  ,"City--9th Ward, 2nd Precinct",0,0,0,0,0,49,0,0,0,49
SHERIFF,Write In  ,"City--9th Ward, 3rd Precinct",0,0,0,0,0,49,0,0,0,49
SHERIFF,Write In  ,"City--9th Ward, 4th Precinct",0,0,0,0,0,49,0,0,0,49
SHERIFF,Write In  ,"City--9th Ward, 5th Precinct",0,0,0,0,0,49,0,0,0,49
SHERIFF,Write In  ,"City--10th Ward, 1st Precinct",0,0,0,0,0,49,0,0,0,49
SHERIFF,Write In  ,"City--10th Ward, 2nd Precinct",0,0,0,0,0,49,0,0,0,49
SHERIFF,Write In  ,"City--10th Ward, 3rd Precinct",1,0,0,0,1,49,0,0,0,49
SHERIFF,Write In  ,"City--10th Ward, 4th Precinct",1,0,0,0,1,49,0,0,0,49
SHERIFF,Write In  ,City--11th Ward,0,0,0,0,0,49,0,0,0,49
SHERIFF,Write In  ,City--12th Ward,1,0,0,0,1,49,0,0,0,49
SHERIFF,Write In  ,"City--13th Ward, 1st Precinct",1,0,0,0,1,49,0,0,0,49
SHERIFF,Write In  ,"City--13th Ward, 2nd Precinct",0,0,0,0,0,49,0,0,0,49
SHERIFF,Write In  ,"City--13th Ward, 3rd Precinct",0,0,0,0,0,49,0,0,0,49
SHERIFF,Write In  ,City--14th Ward,1,0,0,0,1,49,0,0,0,49
SHERIFF,Write In  ,City--15th Ward,0,0,0,0,0,49,0,0,0,49
SHERIFF,Write In  ,Berrysburg Borough,0,0,0,0,0,49,0,0,0,49
SHERIFF,Write In  ,Dauphin Borough,0,0,0,0,0,49,0,0,0,49
SHERIFF,Write In  ,Elizabethville Borough,0,0,0,0,0,49,0,0,0,49
SHERIFF,Write In  ,Gratz Borough,0,0,0,0,0,49,0,0,0,49
SHERIFF,Write In  ,Halifax Borough,1,0,0,0,1,49,0,0,0,49
SHERIFF,Write In  ,Highspire--1st Precinct,0,0,0,0,0,49,0,0,0,49
SHERIFF,Write In  ,Highspire--2nd Precinct,0,0,0,0,0,49,0,0,0,49
SHERIFF,Write In  ,Hummelstown--1st Precinct,0,0,0,0,0,49,0,0,0,49
SHERIFF,Write In  ,Hummelstown--2nd Precinct,0,0,0,0,0,49,0,0,0,49
SHERIFF,Write In  ,Lykens Borough--1st Ward,0,0,0,0,0,49,0,0,0,49
SHERIFF,Write In  ,Lykens Borough--2nd Ward,1,0,0,0,1,49,0,0,0,49
SHERIFF,Write In  ,"Middletown--1st Ward, 1st Precinct",0,0,0,0,0,49,0,0,0,49
SHERIFF,Write In  ,"Middletown--1st Ward, 2nd Precinct",0,0,0,0,0,49,0,0,0,49
SHERIFF,Write In  ,"Middletown--2nd Ward, 1st Precinct",1,0,0,0,1,49,0,0,0,49
SHERIFF,Write In  ,"Middletown--2nd Ward, 2nd Precinct",0,0,0,0,0,49,0,0,0,49
SHERIFF,Write In  ,"Middletown--3rd Ward, 1st Precinct",0,0,0,0,0,49,0,0,0,49
SHERIFF,Write In  ,"Middletown--3rd Ward, 2nd Precinct",0,0,0,0,0,49,0,0,0,49
SHERIFF,Write In  ,Millersburg--1st Ward,0,0,0,0,0,49,0,0,0,49
SHERIFF,Write In  ,Millersburg--2nd Ward,0,0,0,0,0,49,0,0,0,49
SHERIFF,Write In  ,Paxtang Borough,0,0,0,0,0,49,0,0,0,49
SHERIFF,Write In  ,Penbrook Borough--1st Ward,2,0,0,0,2,49,0,0,0,49
SHERIFF,Write In  ,Penbrook Borough--2nd Ward,0,0,0,0,0,49,0,0,0,49
SHERIFF,Write In  ,Penbrook Borough--3rd Ward,0,0,0,0,0,49,0,0,0,49
SHERIFF,Write In  ,Penbrook Borough--4th Ward,1,0,0,0,1,49,0,0,0,49
SHERIFF,Write In  ,Royalton Borough--1st Ward,0,0,0,0,0,49,0,0,0,49
SHERIFF,Write In  ,Royalton Borough--2nd Ward,0,0,0,0,0,49,0,0,0,49
SHERIFF,Write In  ,Steelton--1st Ward,0,0,0,0,0,49,0,0,0,49
SHERIFF,Write In  ,"Steelton--2nd Ward, 1st Precinct",0,0,0,0,0,49,0,0,0,49
SHERIFF,Write In  ,"Steelton--2nd Ward, 2nd Precinct",0,0,0,0,0,49,0,0,0,49
SHERIFF,Write In  ,"Steelton--3rd Ward, 1st Precinct",0,0,0,0,0,49,0,0,0,49
SHERIFF,Write In  ,"Steelton--3rd Ward, 2nd Precinct",1,0,0,0,1,49,0,0,0,49
SHERIFF,Write In  ,Steelton--4th Ward,0,0,0,0,0,49,0,0,0,49
SHERIFF,Write In  ,Pillow Borough,0,0,0,0,0,49,0,0,0,49
SHERIFF,Write In  ,Williamstown--1st Ward,0,0,0,0,0,49,0,0,0,49
SHERIFF,Write In  ,Williamstown--2nd Ward,0,0,0,0,0,49,0,0,0,49
SHERIFF,Write In  ,Conewago Twp--1st Precinct,0,0,0,0,0,49,0,0,0,49
SHERIFF,Write In  ,Conewago Twp--2nd Precinct,1,0,0,0,1,49,0,0,0,49
SHERIFF,Write In  ,Derry Township--1st Precinct,0,0,0,0,0,49,0,0,0,49
SHERIFF,Write In  ,Derry Township--2nd Precinct,0,0,0,0,0,49,0,0,0,49
SHERIFF,Write In  ,Derry Township--3rd Precinct,0,0,0,0,0,49,0,0,0,49
SHERIFF,Write In  ,Derry Township--4th Precinct,0,0,0,0,0,49,0,0,0,49
SHERIFF,Write In  ,Derry Township--5th Precinct,0,0,0,0,0,49,0,0,0,49
SHERIFF,Write In  ,Derry Township--6th Precinct,0,0,0,0,0,49,0,0,0,49
SHERIFF,Write In  ,Derry Township--7th Precinct,0,0,0,0,0,49,0,0,0,49
SHERIFF,Write In  ,Derry Township--8th Precinct,1,0,0,0,1,49,0,0,0,49
SHERIFF,Write In  ,Derry Township--9th Precinct,0,0,0,0,0,49,0,0,0,49
SHERIFF,Write In  ,Derry Township--10th Precinct,0,0,0,0,0,49,0,0,0,49
SHERIFF,Write In  ,Derry Township--11th Precinct,0,0,0,0,0,49,0,0,0,49
SHERIFF,Write In  ,Derry Township--12th Precinct,0,0,0,0,0,49,0,0,0,49
SHERIFF,Write In  ,Derry Township--13th Precinct,1,0,0,0,1,49,0,0,0,49
SHERIFF,Write In  ,Derry Township--14th Precinct,0,0,0,0,0,49,0,0,0,49
SHERIFF,Write In  ,Derry Township--15th Precinct,2,0,0,0,2,49,0,0,0,49
SHERIFF,Write In  ,East Hanover Township--1st Precinct,0,0,0,0,0,49,0,0,0,49
SHERIFF,Write In  ,East Hanover Township--2nd Precinct,1,0,0,0,1,49,0,0,0,49
SHERIFF,Write In  ,Halifax Twp--1st Precinct,1,0,0,0,1,49,0,0,0,49
SHERIFF,Write In  ,Halifax Twp--2nd Precinct,0,0,0,0,0,49,0,0,0,49
SHERIFF,Write In  ,Jackson Township,0,0,0,0,0,49,0,0,0,49
SHERIFF,Write In  ,Jefferson Township,0,0,0,0,0,49,0,0,0,49
SHERIFF,Write In  ,Londonderry Twp--1st Precinct,0,0,0,0,0,49,0,0,0,49
SHERIFF,Write In  ,Londonderry Twp--2nd Precinct,1,0,0,0,1,49,0,0,0,49
SHERIFF,Write In  ,Londonderry Twp--3rd Precinct,0,0,0,0,0,49,0,0,0,49
SHERIFF,Write In  ,Lower Paxton Twp--1st Precinct,1,0,0,0,1,49,0,0,0,49
SHERIFF,Write In  ,Lower Paxton Twp--2nd Precinct,2,0,0,0,2,49,0,0,0,49
SHERIFF,Write In  ,Lower Paxton Twp--3rd precinct,0,0,0,0,0,49,0,0,0,49
SHERIFF,Write In  ,Lower Paxton Twp--4th Precinct,0,0,0,0,0,49,0,0,0,49
SHERIFF,Write In  ,Lower Paxton Twp--5th Precinct,1,0,0,0,1,49,0,0,0,49
SHERIFF,Write In  ,Lower Paxton Twp--6th Precinct,0,0,0,0,0,49,0,0,0,49
SHERIFF,Write In  ,Lower Paxton Twp--7th Precinct,1,0,0,0,1,49,0,0,0,49
SHERIFF,Write In  ,Lower Paxton Twp--8th Precinct,0,0,0,0,0,49,0,0,0,49
SHERIFF,Write In  ,Lower Paxton Twp--9th Precinct,0,0,0,0,0,49,0,0,0,49
SHERIFF,Write In  ,Lower Paxton Twp--10th Precinct,1,0,0,0,1,49,0,0,0,49
SHERIFF,Write In  ,Lower Paxton Twp--11th Precinct,0,0,0,0,0,49,0,0,0,49
SHERIFF,Write In  ,Lower Paxton Twp--12th Precinct,1,0,0,0,1,49,0,0,0,49
SHERIFF,Write In  ,Lower Paxton Twp--13th Precinct,1,0,0,0,1,49,0,0,0,49
SHERIFF,Write In  ,Lower Paxton Twp--14th Precinct,0,0,0,0,0,49,0,0,0,49
SHERIFF,Write In  ,Lower Paxton Twp--15th Precinct,0,0,0,0,0,49,0,0,0,49
SHERIFF,Write In  ,Lower Paxton Twp--16th Precinct,0,0,0,0,0,49,0,0,0,49
SHERIFF,Write In  ,Lower Paxton Twp--17th Precinct,1,0,0,0,1,49,0,0,0,49
SHERIFF,Write In  ,Lower Paxton Twp--18th Precinct,0,0,0,0,0,49,0,0,0,49
SHERIFF,Write In  ,Lower Paxton Twp--19th Precinct,0,0,0,0,0,49,0,0,0,49
SHERIFF,Write In  ,Lower Paxton Twp--20th Precinct,0,0,0,0,0,49,0,0,0,49
SHERIFF,Write In  ,Lower Paxton Twp--21st Precinct,0,0,0,0,0,49,0,0,0,49
SHERIFF,Write In  ,Lower Paxton Twp--22nd Precinct,1,0,0,0,1,49,0,0,0,49
SHERIFF,Write In  ,Lower Paxton Twp--23rd Precinct,0,0,0,0,0,49,0,0,0,49
SHERIFF,Write In  ,Lower Paxton Twp--24th Precinct,0,0,0,0,0,49,0,0,0,49
SHERIFF,Write In  ,Lower Paxton Twp--25th Precinct,1,0,0,0,1,49,0,0,0,49
SHERIFF,Write In  ,Lower Paxton Twp--26th Precinct,0,0,0,0,0,49,0,0,0,49
SHERIFF,Write In  ,Lower Paxton Twp--27th Precinct,0,0,0,0,0,49,0,0,0,49
SHERIFF,Write In  ,Lower Swatara Twp--1st Precinct,0,0,0,0,0,49,0,0,0,49
SHERIFF,Write In  ,Lower Swatara Twp--2nd Precinct,0,0,0,0,0,49,0,0,0,49
SHERIFF,Write In  ,Lower Swatara Twp--3rd Precinct,0,0,0,0,0,49,0,0,0,49
SHERIFF,Write In  ,Lower Swatara Twp--4th Precinct,0,0,0,0,0,49,0,0,0,49
SHERIFF,Write In  ,Lykens Township,0,0,0,0,0,49,0,0,0,49
SHERIFF,Write In  ,Middle Paxton Twp--1st Precinct,0,0,0,0,0,49,0,0,0,49
SHERIFF,Write In  ,Middle Paxton Twp--2nd Precinct,0,0,0,0,0,49,0,0,0,49
SHERIFF,Write In  ,Middle Paxton Twp--3rd Precinct,0,0,0,0,0,49,0,0,0,49
SHERIFF,Write In  ,Mifflin Township,0,0,0,0,0,49,0,0,0,49
SHERIFF,Write In  ,Reed Township,0,0,0,0,0,49,0,0,0,49
SHERIFF,Write In  ,Rush Township,0,0,0,0,0,49,0,0,0,49
SHERIFF,Write In  ,South Hanover Twp--1st Precinct,1,0,0,0,1,49,0,0,0,49
SHERIFF,Write In  ,South Hanover Twp--2nd Precinct,0,0,0,0,0,49,0,0,0,49
SHERIFF,Write In  ,South Hanover Twp--3rd Precinct,0,0,0,0,0,49,0,0,0,49
SHERIFF,Write In  ,Susquehanna Twp--1st Ward,1,0,0,0,1,49,0,0,0,49
SHERIFF,Write In  ,Susquehanna Twp--2nd Ward,1,0,0,0,1,49,0,0,0,49
SHERIFF,Write In  ,Susquehanna Twp--3rd Ward,1,0,0,0,1,49,0,0,0,49
SHERIFF,Write In  ,Susquehanna Twp--4th Ward,2,0,0,0,2,49,0,0,0,49
SHERIFF,Write In  ,Susquehanna Twp--5th Ward,0,0,0,0,0,49,0,0,0,49
SHERIFF,Write In  ,Susquehanna Twp--6th Ward,0,0,0,0,0,49,0,0,0,49
SHERIFF,Write In  ,Susquehanna Twp--7th Ward,0,0,0,0,0,49,0,0,0,49
SHERIFF,Write In  ,Susquehanna Twp--8th Ward,0,0,0,0,0,49,0,0,0,49
SHERIFF,Write In  ,Susquehanna Twp--9th Ward,2,0,0,0,2,49,0,0,0,49
SHERIFF,Write In  ,Swatara Township--1st Ward,0,0,0,0,0,49,0,0,0,49
SHERIFF,Write In  ,Swatara Township--2nd Ward,1,0,0,0,1,49,0,0,0,49
SHERIFF,Write In  ,Swatara Township--3rd Ward,0,0,0,0,0,49,0,0,0,49
SHERIFF,Write In  ,Swatara Township--4th Ward,0,0,0,0,0,49,0,0,0,49
SHERIFF,Write In  ,Swatara Township--5th Ward,0,0,0,0,0,49,0,0,0,49
SHERIFF,Write In  ,Swatara Township--6th Ward,1,0,0,0,1,49,0,0,0,49
SHERIFF,Write In  ,Swatara Township--7th Ward,0,0,0,0,0,49,0,0,0,49
SHERIFF,Write In  ,Swatara Township--8th Ward,0,0,0,0,0,49,0,0,0,49
SHERIFF,Write In  ,Swatara Township--9th Ward,1,0,0,0,1,49,0,0,0,49
SHERIFF,Write In  ,Upper Paxton Twp--1st Precinct,0,0,0,0,0,49,0,0,0,49
SHERIFF,Write In  ,Upper Paxton Twp--2nd Precinct,0,0,0,0,0,49,0,0,0,49
SHERIFF,Write In  ,Washington Township,0,0,0,0,0,49,0,0,0,49
SHERIFF,Write In  ,Wayne Township,0,0,0,0,0,49,0,0,0,49
SHERIFF,Write In  ,West Hanover Twp--1st Precinct,0,0,0,0,0,49,0,0,0,49
SHERIFF,Write In  ,West Hanover Twp--2nd Precinct,1,0,0,0,1,49,0,0,0,49
SHERIFF,Write In  ,West Hanover Twp--3rd Precinct,2,0,0,0,2,49,0,0,0,49
SHERIFF,Write In  ,West Hanover Twp--4th Precinct,0,0,0,0,0,49,0,0,0,49
SHERIFF,Write In  ,Wiconisco Twp--1st Precinct,0,0,0,0,0,49,0,0,0,49
SHERIFF,Write In  ,Wiconisco Twp--2nd Precinct,0,0,0,0,0,49,0,0,0,49
SHERIFF,Write In  ,Williams Twp,0,0,0,0,0,49,0,0,0,49
SMITH-RIBNER RETENTION,  SMITH-RIBNER - NO,"City--1st Ward, 1st Precinct",42,3,0,0,45,22048,348,9,0,22405
SMITH-RIBNER RETENTION,  SMITH-RIBNER - NO,"City--1st Ward, 2nd Precinct",69,0,0,0,69,22048,348,9,0,22405
SMITH-RIBNER RETENTION,  SMITH-RIBNER - NO,"City--1st Ward, 3rd Precinct",27,0,0,0,27,22048,348,9,0,22405
SMITH-RIBNER RETENTION,  SMITH-RIBNER - NO,"City--2nd Ward, 1st Precinct",22,0,0,0,22,22048,348,9,0,22405
SMITH-RIBNER RETENTION,  SMITH-RIBNER - NO,"City--2nd Ward, 2nd Precinct",31,0,0,0,31,22048,348,9,0,22405
SMITH-RIBNER RETENTION,  SMITH-RIBNER - NO,City--3rd Ward,33,0,0,0,33,22048,348,9,0,22405
SMITH-RIBNER RETENTION,  SMITH-RIBNER - NO,City--4th Ward,75,1,0,0,76,22048,348,9,0,22405
SMITH-RIBNER RETENTION,  SMITH-RIBNER - NO,City--5th Ward,165,4,0,0,169,22048,348,9,0,22405
SMITH-RIBNER RETENTION,  SMITH-RIBNER - NO,City--6th Ward,91,1,0,0,92,22048,348,9,0,22405
SMITH-RIBNER RETENTION,  SMITH-RIBNER - NO,"City--7th Ward, 1st Precinct",26,2,0,0,28,22048,348,9,0,22405
SMITH-RIBNER RETENTION,  SMITH-RIBNER - NO,"City--7th Ward, 2nd Precinct",50,2,0,0,52,22048,348,9,0,22405
SMITH-RIBNER RETENTION,  SMITH-RIBNER - NO,City--8th Ward,50,1,0,0,51,22048,348,9,0,22405
SMITH-RIBNER RETENTION,  SMITH-RIBNER - NO,"City--9th Ward, 1st Precinct",25,0,0,0,25,22048,348,9,0,22405
SMITH-RIBNER RETENTION,  SMITH-RIBNER - NO,"City--9th Ward, 2nd Precinct",30,0,0,0,30,22048,348,9,0,22405
SMITH-RIBNER RETENTION,  SMITH-RIBNER - NO,"City--9th Ward, 3rd Precinct",89,0,0,0,89,22048,348,9,0,22405
SMITH-RIBNER RETENTION,  SMITH-RIBNER - NO,"City--9th Ward, 4th Precinct",110,3,0,0,113,22048,348,9,0,22405
SMITH-RIBNER RETENTION,  SMITH-RIBNER - NO,"City--9th Ward, 5th Precinct",53,3,0,0,56,22048,348,9,0,22405
SMITH-RIBNER RETENTION,  SMITH-RIBNER - NO,"City--10th Ward, 1st Precinct",121,2,0,0,123,22048,348,9,0,22405
SMITH-RIBNER RETENTION,  SMITH-RIBNER - NO,"City--10th Ward, 2nd Precinct",39,0,0,0,39,22048,348,9,0,22405
SMITH-RIBNER RETENTION,  SMITH-RIBNER - NO,"City--10th Ward, 3rd Precinct",57,1,0,0,58,22048,348,9,0,22405
SMITH-RIBNER RETENTION,  SMITH-RIBNER - NO,"City--10th Ward, 4th Precinct",37,0,0,0,37,22048,348,9,0,22405
SMITH-RIBNER RETENTION,  SMITH-RIBNER - NO,City--11th Ward,48,4,0,0,52,22048,348,9,0,22405
SMITH-RIBNER RETENTION,  SMITH-RIBNER - NO,City--12th Ward,134,5,0,0,139,22048,348,9,0,22405
SMITH-RIBNER RETENTION,  SMITH-RIBNER - NO,"City--13th Ward, 1st Precinct",68,0,0,0,68,22048,348,9,0,22405
SMITH-RIBNER RETENTION,  SMITH-RIBNER - NO,"City--13th Ward, 2nd Precinct",87,3,0,0,90,22048,348,9,0,22405
SMITH-RIBNER RETENTION,  SMITH-RIBNER - NO,"City--13th Ward, 3rd Precinct",99,2,0,0,101,22048,348,9,0,22405
SMITH-RIBNER RETENTION,  SMITH-RIBNER - NO,City--14th Ward,195,2,0,0,197,22048,348,9,0,22405
SMITH-RIBNER RETENTION,  SMITH-RIBNER - NO,City--15th Ward,36,0,0,0,36,22048,348,9,0,22405
SMITH-RIBNER RETENTION,  SMITH-RIBNER - NO,Berrysburg Borough,35,0,0,0,35,22048,348,9,0,22405
SMITH-RIBNER RETENTION,  SMITH-RIBNER - NO,Dauphin Borough,131,0,0,0,131,22048,348,9,0,22405
SMITH-RIBNER RETENTION,  SMITH-RIBNER - NO,Elizabethville Borough,112,2,0,0,114,22048,348,9,0,22405
SMITH-RIBNER RETENTION,  SMITH-RIBNER - NO,Gratz Borough,39,0,0,0,39,22048,348,9,0,22405
SMITH-RIBNER RETENTION,  SMITH-RIBNER - NO,Halifax Borough,64,1,0,0,65,22048,348,9,0,22405
SMITH-RIBNER RETENTION,  SMITH-RIBNER - NO,Highspire--1st Precinct,95,2,0,0,97,22048,348,9,0,22405
SMITH-RIBNER RETENTION,  SMITH-RIBNER - NO,Highspire--2nd Precinct,107,0,0,0,107,22048,348,9,0,22405
SMITH-RIBNER RETENTION,  SMITH-RIBNER - NO,Hummelstown--1st Precinct,117,5,0,0,122,22048,348,9,0,22405
SMITH-RIBNER RETENTION,  SMITH-RIBNER - NO,Hummelstown--2nd Precinct,251,3,0,0,254,22048,348,9,0,22405
SMITH-RIBNER RETENTION,  SMITH-RIBNER - NO,Lykens Borough--1st Ward,51,0,0,0,51,22048,348,9,0,22405
SMITH-RIBNER RETENTION,  SMITH-RIBNER - NO,Lykens Borough--2nd Ward,75,2,0,0,77,22048,348,9,0,22405
SMITH-RIBNER RETENTION,  SMITH-RIBNER - NO,"Middletown--1st Ward, 1st Precinct",54,0,0,0,54,22048,348,9,0,22405
SMITH-RIBNER RETENTION,  SMITH-RIBNER - NO,"Middletown--1st Ward, 2nd Precinct",96,1,1,0,98,22048,348,9,0,22405
SMITH-RIBNER RETENTION,  SMITH-RIBNER - NO,"Middletown--2nd Ward, 1st Precinct",115,2,0,0,117,22048,348,9,0,22405
SMITH-RIBNER RETENTION,  SMITH-RIBNER - NO,"Middletown--2nd Ward, 2nd Precinct",98,3,0,0,101,22048,348,9,0,22405
SMITH-RIBNER RETENTION,  SMITH-RIBNER - NO,"Middletown--3rd Ward, 1st Precinct",82,1,0,0,83,22048,348,9,0,22405
SMITH-RIBNER RETENTION,  SMITH-RIBNER - NO,"Middletown--3rd Ward, 2nd Precinct",141,0,0,0,141,22048,348,9,0,22405
SMITH-RIBNER RETENTION,  SMITH-RIBNER - NO,Millersburg--1st Ward,77,1,0,0,78,22048,348,9,0,22405
SMITH-RIBNER RETENTION,  SMITH-RIBNER - NO,Millersburg--2nd Ward,113,1,0,0,114,22048,348,9,0,22405
SMITH-RIBNER RETENTION,  SMITH-RIBNER - NO,Paxtang Borough,152,2,0,0,154,22048,348,9,0,22405
SMITH-RIBNER RETENTION,  SMITH-RIBNER - NO,Penbrook Borough--1st Ward,41,0,0,0,41,22048,348,9,0,22405
SMITH-RIBNER RETENTION,  SMITH-RIBNER - NO,Penbrook Borough--2nd Ward,44,1,0,0,45,22048,348,9,0,22405
SMITH-RIBNER RETENTION,  SMITH-RIBNER - NO,Penbrook Borough--3rd Ward,50,0,0,0,50,22048,348,9,0,22405
SMITH-RIBNER RETENTION,  SMITH-RIBNER - NO,Penbrook Borough--4th Ward,74,2,0,0,76,22048,348,9,0,22405
SMITH-RIBNER RETENTION,  SMITH-RIBNER - NO,Royalton Borough--1st Ward,26,0,0,0,26,22048,348,9,0,22405
SMITH-RIBNER RETENTION,  SMITH-RIBNER - NO,Royalton Borough--2nd Ward,46,0,0,0,46,22048,348,9,0,22405
SMITH-RIBNER RETENTION,  SMITH-RIBNER - NO,Steelton--1st Ward,80,4,0,0,84,22048,348,9,0,22405
SMITH-RIBNER RETENTION,  SMITH-RIBNER - NO,"Steelton--2nd Ward, 1st Precinct",51,0,0,0,51,22048,348,9,0,22405
SMITH-RIBNER RETENTION,  SMITH-RIBNER - NO,"Steelton--2nd Ward, 2nd Precinct",47,1,0,0,48,22048,348,9,0,22405
SMITH-RIBNER RETENTION,  SMITH-RIBNER - NO,"Steelton--3rd Ward, 1st Precinct",26,0,0,0,26,22048,348,9,0,22405
SMITH-RIBNER RETENTION,  SMITH-RIBNER - NO,"Steelton--3rd Ward, 2nd Precinct",51,0,0,0,51,22048,348,9,0,22405
SMITH-RIBNER RETENTION,  SMITH-RIBNER - NO,Steelton--4th Ward,45,1,0,0,46,22048,348,9,0,22405
SMITH-RIBNER RETENTION,  SMITH-RIBNER - NO,Pillow Borough,35,0,0,0,35,22048,348,9,0,22405
SMITH-RIBNER RETENTION,  SMITH-RIBNER - NO,Williamstown--1st Ward,53,1,0,0,54,22048,348,9,0,22405
SMITH-RIBNER RETENTION,  SMITH-RIBNER - NO,Williamstown--2nd Ward,44,0,0,0,44,22048,348,9,0,22405
SMITH-RIBNER RETENTION,  SMITH-RIBNER - NO,Conewago Twp--1st Precinct,161,0,0,0,161,22048,348,9,0,22405
SMITH-RIBNER RETENTION,  SMITH-RIBNER - NO,Conewago Twp--2nd Precinct,134,5,0,0,139,22048,348,9,0,22405
SMITH-RIBNER RETENTION,  SMITH-RIBNER - NO,Derry Township--1st Precinct,224,2,0,0,226,22048,348,9,0,22405
SMITH-RIBNER RETENTION,  SMITH-RIBNER - NO,Derry Township--2nd Precinct,168,3,0,0,171,22048,348,9,0,22405
SMITH-RIBNER RETENTION,  SMITH-RIBNER - NO,Derry Township--3rd Precinct,137,1,1,0,139,22048,348,9,0,22405
SMITH-RIBNER RETENTION,  SMITH-RIBNER - NO,Derry Township--4th Precinct,107,3,1,0,111,22048,348,9,0,22405
SMITH-RIBNER RETENTION,  SMITH-RIBNER - NO,Derry Township--5th Precinct,90,2,0,0,92,22048,348,9,0,22405
SMITH-RIBNER RETENTION,  SMITH-RIBNER - NO,Derry Township--6th Precinct,106,0,1,0,107,22048,348,9,0,22405
SMITH-RIBNER RETENTION,  SMITH-RIBNER - NO,Derry Township--7th Precinct,225,8,0,0,233,22048,348,9,0,22405
SMITH-RIBNER RETENTION,  SMITH-RIBNER - NO,Derry Township--8th Precinct,119,0,0,0,119,22048,348,9,0,22405
SMITH-RIBNER RETENTION,  SMITH-RIBNER - NO,Derry Township--9th Precinct,69,0,0,0,69,22048,348,9,0,22405
SMITH-RIBNER RETENTION,  SMITH-RIBNER - NO,Derry Township--10th Precinct,183,3,0,0,186,22048,348,9,0,22405
SMITH-RIBNER RETENTION,  SMITH-RIBNER - NO,Derry Township--11th Precinct,216,6,0,0,222,22048,348,9,0,22405
SMITH-RIBNER RETENTION,  SMITH-RIBNER - NO,Derry Township--12th Precinct,126,1,0,0,127,22048,348,9,0,22405
SMITH-RIBNER RETENTION,  SMITH-RIBNER - NO,Derry Township--13th Precinct,144,1,0,0,145,22048,348,9,0,22405
SMITH-RIBNER RETENTION,  SMITH-RIBNER - NO,Derry Township--14th Precinct,115,3,0,0,118,22048,348,9,0,22405
SMITH-RIBNER RETENTION,  SMITH-RIBNER - NO,Derry Township--15th Precinct,244,4,0,0,248,22048,348,9,0,22405
SMITH-RIBNER RETENTION,  SMITH-RIBNER - NO,East Hanover Township--1st Precinct,243,4,0,0,247,22048,348,9,0,22405
SMITH-RIBNER RETENTION,  SMITH-RIBNER - NO,East Hanover Township--2nd Precinct,265,4,0,0,269,22048,348,9,0,22405
SMITH-RIBNER RETENTION,  SMITH-RIBNER - NO,Halifax Twp--1st Precinct,212,2,0,0,214,22048,348,9,0,22405
SMITH-RIBNER RETENTION,  SMITH-RIBNER - NO,Halifax Twp--2nd Precinct,218,11,0,0,229,22048,348,9,0,22405
SMITH-RIBNER RETENTION,  SMITH-RIBNER - NO,Jackson Township,171,0,0,0,171,22048,348,9,0,22405
SMITH-RIBNER RETENTION,  SMITH-RIBNER - NO,Jefferson Township,51,0,0,0,51,22048,348,9,0,22405
SMITH-RIBNER RETENTION,  SMITH-RIBNER - NO,Londonderry Twp--1st Precinct,190,0,0,0,190,22048,348,9,0,22405
SMITH-RIBNER RETENTION,  SMITH-RIBNER - NO,Londonderry Twp--2nd Precinct,209,1,0,0,210,22048,348,9,0,22405
SMITH-RIBNER RETENTION,  SMITH-RIBNER - NO,Londonderry Twp--3rd Precinct,86,1,0,0,87,22048,348,9,0,22405
SMITH-RIBNER RETENTION,  SMITH-RIBNER - NO,Lower Paxton Twp--1st Precinct,132,1,0,0,133,22048,348,9,0,22405
SMITH-RIBNER RETENTION,  SMITH-RIBNER - NO,Lower Paxton Twp--2nd Precinct,149,5,0,0,154,22048,348,9,0,22405
SMITH-RIBNER RETENTION,  SMITH-RIBNER - NO,Lower Paxton Twp--3rd precinct,278,7,0,0,285,22048,348,9,0,22405
SMITH-RIBNER RETENTION,  SMITH-RIBNER - NO,Lower Paxton Twp--4th Precinct,215,3,0,0,218,22048,348,9,0,22405
SMITH-RIBNER RETENTION,  SMITH-RIBNER - NO,Lower Paxton Twp--5th Precinct,174,4,1,0,179,22048,348,9,0,22405
SMITH-RIBNER RETENTION,  SMITH-RIBNER - NO,Lower Paxton Twp--6th Precinct,128,0,0,0,128,22048,348,9,0,22405
SMITH-RIBNER RETENTION,  SMITH-RIBNER - NO,Lower Paxton Twp--7th Precinct,217,1,0,0,218,22048,348,9,0,22405
SMITH-RIBNER RETENTION,  SMITH-RIBNER - NO,Lower Paxton Twp--8th Precinct,106,1,0,0,107,22048,348,9,0,22405
SMITH-RIBNER RETENTION,  SMITH-RIBNER - NO,Lower Paxton Twp--9th Precinct,155,3,0,0,158,22048,348,9,0,22405
SMITH-RIBNER RETENTION,  SMITH-RIBNER - NO,Lower Paxton Twp--10th Precinct,83,2,0,0,85,22048,348,9,0,22405
SMITH-RIBNER RETENTION,  SMITH-RIBNER - NO,Lower Paxton Twp--11th Precinct,139,2,0,0,141,22048,348,9,0,22405
SMITH-RIBNER RETENTION,  SMITH-RIBNER - NO,Lower Paxton Twp--12th Precinct,176,5,1,0,182,22048,348,9,0,22405
SMITH-RIBNER RETENTION,  SMITH-RIBNER - NO,Lower Paxton Twp--13th Precinct,212,2,0,0,214,22048,348,9,0,22405
SMITH-RIBNER RETENTION,  SMITH-RIBNER - NO,Lower Paxton Twp--14th Precinct,105,1,0,0,106,22048,348,9,0,22405
SMITH-RIBNER RETENTION,  SMITH-RIBNER - NO,Lower Paxton Twp--15th Precinct,181,4,0,0,185,22048,348,9,0,22405
SMITH-RIBNER RETENTION,  SMITH-RIBNER - NO,Lower Paxton Twp--16th Precinct,277,3,0,0,280,22048,348,9,0,22405
SMITH-RIBNER RETENTION,  SMITH-RIBNER - NO,Lower Paxton Twp--17th Precinct,126,1,0,0,127,22048,348,9,0,22405
SMITH-RIBNER RETENTION,  SMITH-RIBNER - NO,Lower Paxton Twp--18th Precinct,125,2,0,0,127,22048,348,9,0,22405
SMITH-RIBNER RETENTION,  SMITH-RIBNER - NO,Lower Paxton Twp--19th Precinct,229,12,0,0,241,22048,348,9,0,22405
SMITH-RIBNER RETENTION,  SMITH-RIBNER - NO,Lower Paxton Twp--20th Precinct,166,3,0,0,169,22048,348,9,0,22405
SMITH-RIBNER RETENTION,  SMITH-RIBNER - NO,Lower Paxton Twp--21st Precinct,226,7,0,0,233,22048,348,9,0,22405
SMITH-RIBNER RETENTION,  SMITH-RIBNER - NO,Lower Paxton Twp--22nd Precinct,188,4,0,0,192,22048,348,9,0,22405
SMITH-RIBNER RETENTION,  SMITH-RIBNER - NO,Lower Paxton Twp--23rd Precinct,155,3,0,0,158,22048,348,9,0,22405
SMITH-RIBNER RETENTION,  SMITH-RIBNER - NO,Lower Paxton Twp--24th Precinct,180,5,0,0,185,22048,348,9,0,22405
SMITH-RIBNER RETENTION,  SMITH-RIBNER - NO,Lower Paxton Twp--25th Precinct,120,1,0,0,121,22048,348,9,0,22405
SMITH-RIBNER RETENTION,  SMITH-RIBNER - NO,Lower Paxton Twp--26th Precinct,167,5,0,0,172,22048,348,9,0,22405
SMITH-RIBNER RETENTION,  SMITH-RIBNER - NO,Lower Paxton Twp--27th Precinct,153,0,0,0,153,22048,348,9,0,22405
SMITH-RIBNER RETENTION,  SMITH-RIBNER - NO,Lower Swatara Twp--1st Precinct,249,2,0,0,251,22048,348,9,0,22405
SMITH-RIBNER RETENTION,  SMITH-RIBNER - NO,Lower Swatara Twp--2nd Precinct,194,5,0,0,199,22048,348,9,0,22405
SMITH-RIBNER RETENTION,  SMITH-RIBNER - NO,Lower Swatara Twp--3rd Precinct,159,3,0,0,162,22048,348,9,0,22405
SMITH-RIBNER RETENTION,  SMITH-RIBNER - NO,Lower Swatara Twp--4th Precinct,178,0,0,0,178,22048,348,9,0,22405
SMITH-RIBNER RETENTION,  SMITH-RIBNER - NO,Lykens Township,59,0,0,0,59,22048,348,9,0,22405
SMITH-RIBNER RETENTION,  SMITH-RIBNER - NO,Middle Paxton Twp--1st Precinct,300,2,0,0,302,22048,348,9,0,22405
SMITH-RIBNER RETENTION,  SMITH-RIBNER - NO,Middle Paxton Twp--2nd Precinct,211,2,0,0,213,22048,348,9,0,22405
SMITH-RIBNER RETENTION,  SMITH-RIBNER - NO,Middle Paxton Twp--3rd Precinct,292,0,0,0,292,22048,348,9,0,22405
SMITH-RIBNER RETENTION,  SMITH-RIBNER - NO,Mifflin Township,57,0,0,0,57,22048,348,9,0,22405
SMITH-RIBNER RETENTION,  SMITH-RIBNER - NO,Reed Township,31,0,0,0,31,22048,348,9,0,22405
SMITH-RIBNER RETENTION,  SMITH-RIBNER - NO,Rush Township,20,0,0,0,20,22048,348,9,0,22405
SMITH-RIBNER RETENTION,  SMITH-RIBNER - NO,South Hanover Twp--1st Precinct,203,3,0,0,206,22048,348,9,0,22405
SMITH-RIBNER RETENTION,  SMITH-RIBNER - NO,South Hanover Twp--2nd Precinct,249,5,0,0,254,22048,348,9,0,22405
SMITH-RIBNER RETENTION,  SMITH-RIBNER - NO,South Hanover Twp--3rd Precinct,170,0,0,0,170,22048,348,9,0,22405
SMITH-RIBNER RETENTION,  SMITH-RIBNER - NO,Susquehanna Twp--1st Ward,267,4,0,0,271,22048,348,9,0,22405
SMITH-RIBNER RETENTION,  SMITH-RIBNER - NO,Susquehanna Twp--2nd Ward,403,13,0,0,416,22048,348,9,0,22405
SMITH-RIBNER RETENTION,  SMITH-RIBNER - NO,Susquehanna Twp--3rd Ward,193,0,0,0,193,22048,348,9,0,22405
SMITH-RIBNER RETENTION,  SMITH-RIBNER - NO,Susquehanna Twp--4th Ward,216,3,0,0,219,22048,348,9,0,22405
SMITH-RIBNER RETENTION,  SMITH-RIBNER - NO,Susquehanna Twp--5th Ward,221,3,0,0,224,22048,348,9,0,22405
SMITH-RIBNER RETENTION,  SMITH-RIBNER - NO,Susquehanna Twp--6th Ward,255,7,0,0,262,22048,348,9,0,22405
SMITH-RIBNER RETENTION,  SMITH-RIBNER - NO,Susquehanna Twp--7th Ward,148,0,0,0,148,22048,348,9,0,22405
SMITH-RIBNER RETENTION,  SMITH-RIBNER - NO,Susquehanna Twp--8th Ward,308,11,0,0,319,22048,348,9,0,22405
SMITH-RIBNER RETENTION,  SMITH-RIBNER - NO,Susquehanna Twp--9th Ward,235,3,0,0,238,22048,348,9,0,22405
SMITH-RIBNER RETENTION,  SMITH-RIBNER - NO,Swatara Township--1st Ward,189,0,0,0,189,22048,348,9,0,22405
SMITH-RIBNER RETENTION,  SMITH-RIBNER - NO,Swatara Township--2nd Ward,114,4,0,0,118,22048,348,9,0,22405
SMITH-RIBNER RETENTION,  SMITH-RIBNER - NO,Swatara Township--3rd Ward,123,2,0,0,125,22048,348,9,0,22405
SMITH-RIBNER RETENTION,  SMITH-RIBNER - NO,Swatara Township--4th Ward,220,7,0,0,227,22048,348,9,0,22405
SMITH-RIBNER RETENTION,  SMITH-RIBNER - NO,Swatara Township--5th Ward,273,2,0,0,275,22048,348,9,0,22405
SMITH-RIBNER RETENTION,  SMITH-RIBNER - NO,Swatara Township--6th Ward,300,0,0,0,300,22048,348,9,0,22405
SMITH-RIBNER RETENTION,  SMITH-RIBNER - NO,Swatara Township--7th Ward,326,3,0,0,329,22048,348,9,0,22405
SMITH-RIBNER RETENTION,  SMITH-RIBNER - NO,Swatara Township--8th Ward,337,3,1,0,341,22048,348,9,0,22405
SMITH-RIBNER RETENTION,  SMITH-RIBNER - NO,Swatara Township--9th Ward,104,3,0,0,107,22048,348,9,0,22405
SMITH-RIBNER RETENTION,  SMITH-RIBNER - NO,Upper Paxton Twp--1st Precinct,184,2,0,0,186,22048,348,9,0,22405
SMITH-RIBNER RETENTION,  SMITH-RIBNER - NO,Upper Paxton Twp--2nd Precinct,139,1,0,0,140,22048,348,9,0,22405
SMITH-RIBNER RETENTION,  SMITH-RIBNER - NO,Washington Township,179,4,0,0,183,22048,348,9,0,22405
SMITH-RIBNER RETENTION,  SMITH-RIBNER - NO,Wayne Township,185,1,0,0,186,22048,348,9,0,22405
SMITH-RIBNER RETENTION,  SMITH-RIBNER - NO,West Hanover Twp--1st Precinct,230,4,0,0,234,22048,348,9,0,22405
SMITH-RIBNER RETENTION,  SMITH-RIBNER - NO,West Hanover Twp--2nd Precinct,202,3,0,0,205,22048,348,9,0,22405
SMITH-RIBNER RETENTION,  SMITH-RIBNER - NO,West Hanover Twp--3rd Precinct,489,12,2,0,503,22048,348,9,0,22405
SMITH-RIBNER RETENTION,  SMITH-RIBNER - NO,West Hanover Twp--4th Precinct,273,2,0,0,275,22048,348,9,0,22405
SMITH-RIBNER RETENTION,  SMITH-RIBNER - NO,Wiconisco Twp--1st Precinct,50,0,0,0,50,22048,348,9,0,22405
SMITH-RIBNER RETENTION,  SMITH-RIBNER - NO,Wiconisco Twp--2nd Precinct,33,1,0,0,34,22048,348,9,0,22405
SMITH-RIBNER RETENTION,  SMITH-RIBNER - NO,Williams Twp,78,1,0,0,79,22048,348,9,0,22405
SMITH-RIBNER RETENTION,  SMITH-RIBNER - YES,"City--1st Ward, 1st Precinct",53,1,0,0,54,14092,379,11,0,14482
SMITH-RIBNER RETENTION,  SMITH-RIBNER - YES,"City--1st Ward, 2nd Precinct",98,2,1,0,101,14092,379,11,0,14482
SMITH-RIBNER RETENTION,  SMITH-RIBNER - YES,"City--1st Ward, 3rd Precinct",33,0,0,0,33,14092,379,11,0,14482
SMITH-RIBNER RETENTION,  SMITH-RIBNER - YES,"City--2nd Ward, 1st Precinct",15,0,0,0,15,14092,379,11,0,14482
SMITH-RIBNER RETENTION,  SMITH-RIBNER - YES,"City--2nd Ward, 2nd Precinct",33,1,0,0,34,14092,379,11,0,14482
SMITH-RIBNER RETENTION,  SMITH-RIBNER - YES,City--3rd Ward,50,1,0,0,51,14092,379,11,0,14482
SMITH-RIBNER RETENTION,  SMITH-RIBNER - YES,City--4th Ward,81,4,0,0,85,14092,379,11,0,14482
SMITH-RIBNER RETENTION,  SMITH-RIBNER - YES,City--5th Ward,147,7,0,0,154,14092,379,11,0,14482
SMITH-RIBNER RETENTION,  SMITH-RIBNER - YES,City--6th Ward,67,1,3,0,71,14092,379,11,0,14482
SMITH-RIBNER RETENTION,  SMITH-RIBNER - YES,"City--7th Ward, 1st Precinct",34,0,0,0,34,14092,379,11,0,14482
SMITH-RIBNER RETENTION,  SMITH-RIBNER - YES,"City--7th Ward, 2nd Precinct",85,0,0,0,85,14092,379,11,0,14482
SMITH-RIBNER RETENTION,  SMITH-RIBNER - YES,City--8th Ward,67,0,0,0,67,14092,379,11,0,14482
SMITH-RIBNER RETENTION,  SMITH-RIBNER - YES,"City--9th Ward, 1st Precinct",25,2,0,0,27,14092,379,11,0,14482
SMITH-RIBNER RETENTION,  SMITH-RIBNER - YES,"City--9th Ward, 2nd Precinct",33,2,0,0,35,14092,379,11,0,14482
SMITH-RIBNER RETENTION,  SMITH-RIBNER - YES,"City--9th Ward, 3rd Precinct",79,1,0,0,80,14092,379,11,0,14482
SMITH-RIBNER RETENTION,  SMITH-RIBNER - YES,"City--9th Ward, 4th Precinct",89,3,0,0,92,14092,379,11,0,14482
SMITH-RIBNER RETENTION,  SMITH-RIBNER - YES,"City--9th Ward, 5th Precinct",61,1,0,0,62,14092,379,11,0,14482
SMITH-RIBNER RETENTION,  SMITH-RIBNER - YES,"City--10th Ward, 1st Precinct",100,4,0,0,104,14092,379,11,0,14482
SMITH-RIBNER RETENTION,  SMITH-RIBNER - YES,"City--10th Ward, 2nd Precinct",37,0,0,0,37,14092,379,11,0,14482
SMITH-RIBNER RETENTION,  SMITH-RIBNER - YES,"City--10th Ward, 3rd Precinct",54,0,0,0,54,14092,379,11,0,14482
SMITH-RIBNER RETENTION,  SMITH-RIBNER - YES,"City--10th Ward, 4th Precinct",108,0,0,0,108,14092,379,11,0,14482
SMITH-RIBNER RETENTION,  SMITH-RIBNER - YES,City--11th Ward,45,28,0,0,73,14092,379,11,0,14482
SMITH-RIBNER RETENTION,  SMITH-RIBNER - YES,City--12th Ward,124,4,0,0,128,14092,379,11,0,14482
SMITH-RIBNER RETENTION,  SMITH-RIBNER - YES,"City--13th Ward, 1st Precinct",52,0,0,0,52,14092,379,11,0,14482
SMITH-RIBNER RETENTION,  SMITH-RIBNER - YES,"City--13th Ward, 2nd Precinct",83,1,0,0,84,14092,379,11,0,14482
SMITH-RIBNER RETENTION,  SMITH-RIBNER - YES,"City--13th Ward, 3rd Precinct",92,0,0,0,92,14092,379,11,0,14482
SMITH-RIBNER RETENTION,  SMITH-RIBNER - YES,City--14th Ward,140,5,0,0,145,14092,379,11,0,14482
SMITH-RIBNER RETENTION,  SMITH-RIBNER - YES,City--15th Ward,36,1,0,0,37,14092,379,11,0,14482
SMITH-RIBNER RETENTION,  SMITH-RIBNER - YES,Berrysburg Borough,25,0,0,0,25,14092,379,11,0,14482
SMITH-RIBNER RETENTION,  SMITH-RIBNER - YES,Dauphin Borough,41,2,0,0,43,14092,379,11,0,14482
SMITH-RIBNER RETENTION,  SMITH-RIBNER - YES,Elizabethville Borough,54,1,0,0,55,14092,379,11,0,14482
SMITH-RIBNER RETENTION,  SMITH-RIBNER - YES,Gratz Borough,31,1,0,0,32,14092,379,11,0,14482
SMITH-RIBNER RETENTION,  SMITH-RIBNER - YES,Halifax Borough,29,2,0,0,31,14092,379,11,0,14482
SMITH-RIBNER RETENTION,  SMITH-RIBNER - YES,Highspire--1st Precinct,54,0,0,0,54,14092,379,11,0,14482
SMITH-RIBNER RETENTION,  SMITH-RIBNER - YES,Highspire--2nd Precinct,57,1,0,0,58,14092,379,11,0,14482
SMITH-RIBNER RETENTION,  SMITH-RIBNER - YES,Hummelstown--1st Precinct,82,0,0,0,82,14092,379,11,0,14482
SMITH-RIBNER RETENTION,  SMITH-RIBNER - YES,Hummelstown--2nd Precinct,160,4,0,0,164,14092,379,11,0,14482
SMITH-RIBNER RETENTION,  SMITH-RIBNER - YES,Lykens Borough--1st Ward,40,1,0,0,41,14092,379,11,0,14482
SMITH-RIBNER RETENTION,  SMITH-RIBNER - YES,Lykens Borough--2nd Ward,47,2,0,0,49,14092,379,11,0,14482
SMITH-RIBNER RETENTION,  SMITH-RIBNER - YES,"Middletown--1st Ward, 1st Precinct",41,0,0,0,41,14092,379,11,0,14482
SMITH-RIBNER RETENTION,  SMITH-RIBNER - YES,"Middletown--1st Ward, 2nd Precinct",69,5,0,0,74,14092,379,11,0,14482
SMITH-RIBNER RETENTION,  SMITH-RIBNER - YES,"Middletown--2nd Ward, 1st Precinct",55,0,0,0,55,14092,379,11,0,14482
SMITH-RIBNER RETENTION,  SMITH-RIBNER - YES,"Middletown--2nd Ward, 2nd Precinct",64,1,0,0,65,14092,379,11,0,14482
SMITH-RIBNER RETENTION,  SMITH-RIBNER - YES,"Middletown--3rd Ward, 1st Precinct",45,0,0,0,45,14092,379,11,0,14482
SMITH-RIBNER RETENTION,  SMITH-RIBNER - YES,"Middletown--3rd Ward, 2nd Precinct",82,0,0,0,82,14092,379,11,0,14482
SMITH-RIBNER RETENTION,  SMITH-RIBNER - YES,Millersburg--1st Ward,56,2,0,0,58,14092,379,11,0,14482
SMITH-RIBNER RETENTION,  SMITH-RIBNER - YES,Millersburg--2nd Ward,55,2,0,0,57,14092,379,11,0,14482
SMITH-RIBNER RETENTION,  SMITH-RIBNER - YES,Paxtang Borough,109,1,0,0,110,14092,379,11,0,14482
SMITH-RIBNER RETENTION,  SMITH-RIBNER - YES,Penbrook Borough--1st Ward,29,1,0,0,30,14092,379,11,0,14482
SMITH-RIBNER RETENTION,  SMITH-RIBNER - YES,Penbrook Borough--2nd Ward,35,0,0,0,35,14092,379,11,0,14482
SMITH-RIBNER RETENTION,  SMITH-RIBNER - YES,Penbrook Borough--3rd Ward,34,0,0,0,34,14092,379,11,0,14482
SMITH-RIBNER RETENTION,  SMITH-RIBNER - YES,Penbrook Borough--4th Ward,30,0,0,0,30,14092,379,11,0,14482
SMITH-RIBNER RETENTION,  SMITH-RIBNER - YES,Royalton Borough--1st Ward,19,0,0,0,19,14092,379,11,0,14482
SMITH-RIBNER RETENTION,  SMITH-RIBNER - YES,Royalton Borough--2nd Ward,28,0,0,0,28,14092,379,11,0,14482
SMITH-RIBNER RETENTION,  SMITH-RIBNER - YES,Steelton--1st Ward,63,2,0,0,65,14092,379,11,0,14482
SMITH-RIBNER RETENTION,  SMITH-RIBNER - YES,"Steelton--2nd Ward, 1st Precinct",50,1,0,0,51,14092,379,11,0,14482
SMITH-RIBNER RETENTION,  SMITH-RIBNER - YES,"Steelton--2nd Ward, 2nd Precinct",36,0,0,0,36,14092,379,11,0,14482
SMITH-RIBNER RETENTION,  SMITH-RIBNER - YES,"Steelton--3rd Ward, 1st Precinct",25,0,0,0,25,14092,379,11,0,14482
SMITH-RIBNER RETENTION,  SMITH-RIBNER - YES,"Steelton--3rd Ward, 2nd Precinct",41,0,0,0,41,14092,379,11,0,14482
SMITH-RIBNER RETENTION,  SMITH-RIBNER - YES,Steelton--4th Ward,38,1,1,0,40,14092,379,11,0,14482
SMITH-RIBNER RETENTION,  SMITH-RIBNER - YES,Pillow Borough,18,0,0,0,18,14092,379,11,0,14482
SMITH-RIBNER RETENTION,  SMITH-RIBNER - YES,Williamstown--1st Ward,40,0,0,0,40,14092,379,11,0,14482
SMITH-RIBNER RETENTION,  SMITH-RIBNER - YES,Williamstown--2nd Ward,23,0,0,0,23,14092,379,11,0,14482
SMITH-RIBNER RETENTION,  SMITH-RIBNER - YES,Conewago Twp--1st Precinct,79,1,0,0,80,14092,379,11,0,14482
SMITH-RIBNER RETENTION,  SMITH-RIBNER - YES,Conewago Twp--2nd Precinct,74,0,0,0,74,14092,379,11,0,14482
SMITH-RIBNER RETENTION,  SMITH-RIBNER - YES,Derry Township--1st Precinct,135,4,0,0,139,14092,379,11,0,14482
SMITH-RIBNER RETENTION,  SMITH-RIBNER - YES,Derry Township--2nd Precinct,101,3,0,0,104,14092,379,11,0,14482
SMITH-RIBNER RETENTION,  SMITH-RIBNER - YES,Derry Township--3rd Precinct,86,6,0,0,92,14092,379,11,0,14482
SMITH-RIBNER RETENTION,  SMITH-RIBNER - YES,Derry Township--4th Precinct,85,2,0,0,87,14092,379,11,0,14482
SMITH-RIBNER RETENTION,  SMITH-RIBNER - YES,Derry Township--5th Precinct,68,1,0,0,69,14092,379,11,0,14482
SMITH-RIBNER RETENTION,  SMITH-RIBNER - YES,Derry Township--6th Precinct,87,2,0,0,89,14092,379,11,0,14482
SMITH-RIBNER RETENTION,  SMITH-RIBNER - YES,Derry Township--7th Precinct,149,7,0,0,156,14092,379,11,0,14482
SMITH-RIBNER RETENTION,  SMITH-RIBNER - YES,Derry Township--8th Precinct,75,0,0,0,75,14092,379,11,0,14482
SMITH-RIBNER RETENTION,  SMITH-RIBNER - YES,Derry Township--9th Precinct,55,5,0,0,60,14092,379,11,0,14482
SMITH-RIBNER RETENTION,  SMITH-RIBNER - YES,Derry Township--10th Precinct,76,3,0,0,79,14092,379,11,0,14482
SMITH-RIBNER RETENTION,  SMITH-RIBNER - YES,Derry Township--11th Precinct,127,2,0,0,129,14092,379,11,0,14482
SMITH-RIBNER RETENTION,  SMITH-RIBNER - YES,Derry Township--12th Precinct,79,4,0,0,83,14092,379,11,0,14482
SMITH-RIBNER RETENTION,  SMITH-RIBNER - YES,Derry Township--13th Precinct,119,4,0,0,123,14092,379,11,0,14482
SMITH-RIBNER RETENTION,  SMITH-RIBNER - YES,Derry Township--14th Precinct,70,4,0,0,74,14092,379,11,0,14482
SMITH-RIBNER RETENTION,  SMITH-RIBNER - YES,Derry Township--15th Precinct,109,3,1,0,113,14092,379,11,0,14482
SMITH-RIBNER RETENTION,  SMITH-RIBNER - YES,East Hanover Township--1st Precinct,103,5,0,0,108,14092,379,11,0,14482
SMITH-RIBNER RETENTION,  SMITH-RIBNER - YES,East Hanover Township--2nd Precinct,124,2,0,0,126,14092,379,11,0,14482
SMITH-RIBNER RETENTION,  SMITH-RIBNER - YES,Halifax Twp--1st Precinct,97,2,0,0,99,14092,379,11,0,14482
SMITH-RIBNER RETENTION,  SMITH-RIBNER - YES,Halifax Twp--2nd Precinct,103,1,0,0,104,14092,379,11,0,14482
SMITH-RIBNER RETENTION,  SMITH-RIBNER - YES,Jackson Township,71,0,0,0,71,14092,379,11,0,14482
SMITH-RIBNER RETENTION,  SMITH-RIBNER - YES,Jefferson Township,17,0,0,0,17,14092,379,11,0,14482
SMITH-RIBNER RETENTION,  SMITH-RIBNER - YES,Londonderry Twp--1st Precinct,107,0,0,0,107,14092,379,11,0,14482
SMITH-RIBNER RETENTION,  SMITH-RIBNER - YES,Londonderry Twp--2nd Precinct,84,1,0,0,85,14092,379,11,0,14482
SMITH-RIBNER RETENTION,  SMITH-RIBNER - YES,Londonderry Twp--3rd Precinct,44,0,0,0,44,14092,379,11,0,14482
SMITH-RIBNER RETENTION,  SMITH-RIBNER - YES,Lower Paxton Twp--1st Precinct,94,2,0,0,96,14092,379,11,0,14482
SMITH-RIBNER RETENTION,  SMITH-RIBNER - YES,Lower Paxton Twp--2nd Precinct,90,6,0,0,96,14092,379,11,0,14482
SMITH-RIBNER RETENTION,  SMITH-RIBNER - YES,Lower Paxton Twp--3rd precinct,168,5,0,0,173,14092,379,11,0,14482
SMITH-RIBNER RETENTION,  SMITH-RIBNER - YES,Lower Paxton Twp--4th Precinct,114,0,0,0,114,14092,379,11,0,14482
SMITH-RIBNER RETENTION,  SMITH-RIBNER - YES,Lower Paxton Twp--5th Precinct,113,0,0,0,113,14092,379,11,0,14482
SMITH-RIBNER RETENTION,  SMITH-RIBNER - YES,Lower Paxton Twp--6th Precinct,89,4,0,0,93,14092,379,11,0,14482
SMITH-RIBNER RETENTION,  SMITH-RIBNER - YES,Lower Paxton Twp--7th Precinct,148,6,0,0,154,14092,379,11,0,14482
SMITH-RIBNER RETENTION,  SMITH-RIBNER - YES,Lower Paxton Twp--8th Precinct,83,2,0,0,85,14092,379,11,0,14482
SMITH-RIBNER RETENTION,  SMITH-RIBNER - YES,Lower Paxton Twp--9th Precinct,75,3,0,0,78,14092,379,11,0,14482
SMITH-RIBNER RETENTION,  SMITH-RIBNER - YES,Lower Paxton Twp--10th Precinct,72,3,0,0,75,14092,379,11,0,14482
SMITH-RIBNER RETENTION,  SMITH-RIBNER - YES,Lower Paxton Twp--11th Precinct,86,0,0,0,86,14092,379,11,0,14482
SMITH-RIBNER RETENTION,  SMITH-RIBNER - YES,Lower Paxton Twp--12th Precinct,168,2,0,0,170,14092,379,11,0,14482
SMITH-RIBNER RETENTION,  SMITH-RIBNER - YES,Lower Paxton Twp--13th Precinct,105,4,0,0,109,14092,379,11,0,14482
SMITH-RIBNER RETENTION,  SMITH-RIBNER - YES,Lower Paxton Twp--14th Precinct,86,1,3,0,90,14092,379,11,0,14482
SMITH-RIBNER RETENTION,  SMITH-RIBNER - YES,Lower Paxton Twp--15th Precinct,105,1,0,0,106,14092,379,11,0,14482
SMITH-RIBNER RETENTION,  SMITH-RIBNER - YES,Lower Paxton Twp--16th Precinct,184,6,0,0,190,14092,379,11,0,14482
SMITH-RIBNER RETENTION,  SMITH-RIBNER - YES,Lower Paxton Twp--17th Precinct,99,4,0,0,103,14092,379,11,0,14482
SMITH-RIBNER RETENTION,  SMITH-RIBNER - YES,Lower Paxton Twp--18th Precinct,97,0,0,0,97,14092,379,11,0,14482
SMITH-RIBNER RETENTION,  SMITH-RIBNER - YES,Lower Paxton Twp--19th Precinct,168,7,0,0,175,14092,379,11,0,14482
SMITH-RIBNER RETENTION,  SMITH-RIBNER - YES,Lower Paxton Twp--20th Precinct,116,3,0,0,119,14092,379,11,0,14482
SMITH-RIBNER RETENTION,  SMITH-RIBNER - YES,Lower Paxton Twp--21st Precinct,151,5,0,0,156,14092,379,11,0,14482
SMITH-RIBNER RETENTION,  SMITH-RIBNER - YES,Lower Paxton Twp--22nd Precinct,122,2,0,0,124,14092,379,11,0,14482
SMITH-RIBNER RETENTION,  SMITH-RIBNER - YES,Lower Paxton Twp--23rd Precinct,126,1,0,0,127,14092,379,11,0,14482
SMITH-RIBNER RETENTION,  SMITH-RIBNER - YES,Lower Paxton Twp--24th Precinct,125,2,0,0,127,14092,379,11,0,14482
SMITH-RIBNER RETENTION,  SMITH-RIBNER - YES,Lower Paxton Twp--25th Precinct,96,3,0,0,99,14092,379,11,0,14482
SMITH-RIBNER RETENTION,  SMITH-RIBNER - YES,Lower Paxton Twp--26th Precinct,134,3,0,0,137,14092,379,11,0,14482
SMITH-RIBNER RETENTION,  SMITH-RIBNER - YES,Lower Paxton Twp--27th Precinct,108,1,0,0,109,14092,379,11,0,14482
SMITH-RIBNER RETENTION,  SMITH-RIBNER - YES,Lower Swatara Twp--1st Precinct,135,3,0,0,138,14092,379,11,0,14482
SMITH-RIBNER RETENTION,  SMITH-RIBNER - YES,Lower Swatara Twp--2nd Precinct,128,3,0,0,131,14092,379,11,0,14482
SMITH-RIBNER RETENTION,  SMITH-RIBNER - YES,Lower Swatara Twp--3rd Precinct,120,17,0,0,137,14092,379,11,0,14482
SMITH-RIBNER RETENTION,  SMITH-RIBNER - YES,Lower Swatara Twp--4th Precinct,85,1,0,0,86,14092,379,11,0,14482
SMITH-RIBNER RETENTION,  SMITH-RIBNER - YES,Lykens Township,32,0,0,0,32,14092,379,11,0,14482
SMITH-RIBNER RETENTION,  SMITH-RIBNER - YES,Middle Paxton Twp--1st Precinct,69,0,0,0,69,14092,379,11,0,14482
SMITH-RIBNER RETENTION,  SMITH-RIBNER - YES,Middle Paxton Twp--2nd Precinct,100,0,0,0,100,14092,379,11,0,14482
SMITH-RIBNER RETENTION,  SMITH-RIBNER - YES,Middle Paxton Twp--3rd Precinct,92,2,0,0,94,14092,379,11,0,14482
SMITH-RIBNER RETENTION,  SMITH-RIBNER - YES,Mifflin Township,26,0,0,0,26,14092,379,11,0,14482
SMITH-RIBNER RETENTION,  SMITH-RIBNER - YES,Reed Township,14,0,0,0,14,14092,379,11,0,14482
SMITH-RIBNER RETENTION,  SMITH-RIBNER - YES,Rush Township,17,0,0,0,17,14092,379,11,0,14482
SMITH-RIBNER RETENTION,  SMITH-RIBNER - YES,South Hanover Twp--1st Precinct,86,2,0,0,88,14092,379,11,0,14482
SMITH-RIBNER RETENTION,  SMITH-RIBNER - YES,South Hanover Twp--2nd Precinct,151,5,0,0,156,14092,379,11,0,14482
SMITH-RIBNER RETENTION,  SMITH-RIBNER - YES,South Hanover Twp--3rd Precinct,80,0,0,0,80,14092,379,11,0,14482
SMITH-RIBNER RETENTION,  SMITH-RIBNER - YES,Susquehanna Twp--1st Ward,220,11,0,0,231,14092,379,11,0,14482
SMITH-RIBNER RETENTION,  SMITH-RIBNER - YES,Susquehanna Twp--2nd Ward,302,16,0,0,318,14092,379,11,0,14482
SMITH-RIBNER RETENTION,  SMITH-RIBNER - YES,Susquehanna Twp--3rd Ward,125,2,0,0,127,14092,379,11,0,14482
SMITH-RIBNER RETENTION,  SMITH-RIBNER - YES,Susquehanna Twp--4th Ward,131,0,0,0,131,14092,379,11,0,14482
SMITH-RIBNER RETENTION,  SMITH-RIBNER - YES,Susquehanna Twp--5th Ward,133,3,0,0,136,14092,379,11,0,14482
SMITH-RIBNER RETENTION,  SMITH-RIBNER - YES,Susquehanna Twp--6th Ward,152,2,0,0,154,14092,379,11,0,14482
SMITH-RIBNER RETENTION,  SMITH-RIBNER - YES,Susquehanna Twp--7th Ward,88,0,0,0,88,14092,379,11,0,14482
SMITH-RIBNER RETENTION,  SMITH-RIBNER - YES,Susquehanna Twp--8th Ward,275,9,0,0,284,14092,379,11,0,14482
SMITH-RIBNER RETENTION,  SMITH-RIBNER - YES,Susquehanna Twp--9th Ward,184,1,0,0,185,14092,379,11,0,14482
SMITH-RIBNER RETENTION,  SMITH-RIBNER - YES,Swatara Township--1st Ward,142,1,0,0,143,14092,379,11,0,14482
SMITH-RIBNER RETENTION,  SMITH-RIBNER - YES,Swatara Township--2nd Ward,91,17,0,0,108,14092,379,11,0,14482
SMITH-RIBNER RETENTION,  SMITH-RIBNER - YES,Swatara Township--3rd Ward,111,5,0,0,116,14092,379,11,0,14482
SMITH-RIBNER RETENTION,  SMITH-RIBNER - YES,Swatara Township--4th Ward,141,1,0,0,142,14092,379,11,0,14482
SMITH-RIBNER RETENTION,  SMITH-RIBNER - YES,Swatara Township--5th Ward,189,3,0,0,192,14092,379,11,0,14482
SMITH-RIBNER RETENTION,  SMITH-RIBNER - YES,Swatara Township--6th Ward,131,3,1,0,135,14092,379,11,0,14482
SMITH-RIBNER RETENTION,  SMITH-RIBNER - YES,Swatara Township--7th Ward,154,6,0,0,160,14092,379,11,0,14482
SMITH-RIBNER RETENTION,  SMITH-RIBNER - YES,Swatara Township--8th Ward,171,4,0,0,175,14092,379,11,0,14482
SMITH-RIBNER RETENTION,  SMITH-RIBNER - YES,Swatara Township--9th Ward,104,5,0,0,109,14092,379,11,0,14482
SMITH-RIBNER RETENTION,  SMITH-RIBNER - YES,Upper Paxton Twp--1st Precinct,112,1,0,0,113,14092,379,11,0,14482
SMITH-RIBNER RETENTION,  SMITH-RIBNER - YES,Upper Paxton Twp--2nd Precinct,57,2,0,0,59,14092,379,11,0,14482
SMITH-RIBNER RETENTION,  SMITH-RIBNER - YES,Washington Township,103,3,0,0,106,14092,379,11,0,14482
SMITH-RIBNER RETENTION,  SMITH-RIBNER - YES,Wayne Township,79,0,1,0,80,14092,379,11,0,14482
SMITH-RIBNER RETENTION,  SMITH-RIBNER - YES,West Hanover Twp--1st Precinct,92,2,0,0,94,14092,379,11,0,14482
SMITH-RIBNER RETENTION,  SMITH-RIBNER - YES,West Hanover Twp--2nd Precinct,108,3,0,0,111,14092,379,11,0,14482
SMITH-RIBNER RETENTION,  SMITH-RIBNER - YES,West Hanover Twp--3rd Precinct,224,7,0,0,231,14092,379,11,0,14482
SMITH-RIBNER RETENTION,  SMITH-RIBNER - YES,West Hanover Twp--4th Precinct,135,1,0,0,136,14092,379,11,0,14482
SMITH-RIBNER RETENTION,  SMITH-RIBNER - YES,Wiconisco Twp--1st Precinct,36,1,0,0,37,14092,379,11,0,14482
SMITH-RIBNER RETENTION,  SMITH-RIBNER - YES,Wiconisco Twp--2nd Precinct,29,0,0,0,29,14092,379,11,0,14482
SMITH-RIBNER RETENTION,  SMITH-RIBNER - YES,Williams Twp,66,0,0,0,66,14092,379,11,0,14482
STEVENS RETENTION,  STEVENS - NO,"City--1st Ward, 1st Precinct",54,3,0,0,57,21896,328,9,0,22233
STEVENS RETENTION,  STEVENS - NO,"City--1st Ward, 2nd Precinct",80,0,0,0,80,21896,328,9,0,22233
STEVENS RETENTION,  STEVENS - NO,"City--1st Ward, 3rd Precinct",34,0,0,0,34,21896,328,9,0,22233
STEVENS RETENTION,  STEVENS - NO,"City--2nd Ward, 1st Precinct",25,0,0,0,25,21896,328,9,0,22233
STEVENS RETENTION,  STEVENS - NO,"City--2nd Ward, 2nd Precinct",35,0,0,0,35,21896,328,9,0,22233
STEVENS RETENTION,  STEVENS - NO,City--3rd Ward,34,0,0,0,34,21896,328,9,0,22233
STEVENS RETENTION,  STEVENS - NO,City--4th Ward,78,1,0,0,79,21896,328,9,0,22233
STEVENS RETENTION,  STEVENS - NO,City--5th Ward,182,2,0,0,184,21896,328,9,0,22233
STEVENS RETENTION,  STEVENS - NO,City--6th Ward,96,1,0,0,97,21896,328,9,0,22233
STEVENS RETENTION,  STEVENS - NO,"City--7th Ward, 1st Precinct",29,2,0,0,31,21896,328,9,0,22233
STEVENS RETENTION,  STEVENS - NO,"City--7th Ward, 2nd Precinct",55,1,0,0,56,21896,328,9,0,22233
STEVENS RETENTION,  STEVENS - NO,City--8th Ward,57,1,0,0,58,21896,328,9,0,22233
STEVENS RETENTION,  STEVENS - NO,"City--9th Ward, 1st Precinct",27,1,0,0,28,21896,328,9,0,22233
STEVENS RETENTION,  STEVENS - NO,"City--9th Ward, 2nd Precinct",30,1,0,0,31,21896,328,9,0,22233
STEVENS RETENTION,  STEVENS - NO,"City--9th Ward, 3rd Precinct",92,0,0,0,92,21896,328,9,0,22233
STEVENS RETENTION,  STEVENS - NO,"City--9th Ward, 4th Precinct",117,3,0,0,120,21896,328,9,0,22233
STEVENS RETENTION,  STEVENS - NO,"City--9th Ward, 5th Precinct",55,3,0,0,58,21896,328,9,0,22233
STEVENS RETENTION,  STEVENS - NO,"City--10th Ward, 1st Precinct",133,0,0,0,133,21896,328,9,0,22233
STEVENS RETENTION,  STEVENS - NO,"City--10th Ward, 2nd Precinct",41,0,0,0,41,21896,328,9,0,22233
STEVENS RETENTION,  STEVENS - NO,"City--10th Ward, 3rd Precinct",57,0,0,0,57,21896,328,9,0,22233
STEVENS RETENTION,  STEVENS - NO,"City--10th Ward, 4th Precinct",54,0,0,0,54,21896,328,9,0,22233
STEVENS RETENTION,  STEVENS - NO,City--11th Ward,57,1,0,0,58,21896,328,9,0,22233
STEVENS RETENTION,  STEVENS - NO,City--12th Ward,152,4,0,0,156,21896,328,9,0,22233
STEVENS RETENTION,  STEVENS - NO,"City--13th Ward, 1st Precinct",74,0,0,0,74,21896,328,9,0,22233
STEVENS RETENTION,  STEVENS - NO,"City--13th Ward, 2nd Precinct",98,3,0,0,101,21896,328,9,0,22233
STEVENS RETENTION,  STEVENS - NO,"City--13th Ward, 3rd Precinct",110,2,0,0,112,21896,328,9,0,22233
STEVENS RETENTION,  STEVENS - NO,City--14th Ward,207,3,0,0,210,21896,328,9,0,22233
STEVENS RETENTION,  STEVENS - NO,City--15th Ward,44,1,0,0,45,21896,328,9,0,22233
STEVENS RETENTION,  STEVENS - NO,Berrysburg Borough,41,0,0,0,41,21896,328,9,0,22233
STEVENS RETENTION,  STEVENS - NO,Dauphin Borough,131,0,0,0,131,21896,328,9,0,22233
STEVENS RETENTION,  STEVENS - NO,Elizabethville Borough,116,2,0,0,118,21896,328,9,0,22233
STEVENS RETENTION,  STEVENS - NO,Gratz Borough,38,0,0,0,38,21896,328,9,0,22233
STEVENS RETENTION,  STEVENS - NO,Halifax Borough,60,0,0,0,60,21896,328,9,0,22233
STEVENS RETENTION,  STEVENS - NO,Highspire--1st Precinct,95,2,0,0,97,21896,328,9,0,22233
STEVENS RETENTION,  STEVENS - NO,Highspire--2nd Precinct,108,0,0,0,108,21896,328,9,0,22233
STEVENS RETENTION,  STEVENS - NO,Hummelstown--1st Precinct,128,5,0,0,133,21896,328,9,0,22233
STEVENS RETENTION,  STEVENS - NO,Hummelstown--2nd Precinct,254,3,0,0,257,21896,328,9,0,22233
STEVENS RETENTION,  STEVENS - NO,Lykens Borough--1st Ward,47,0,0,0,47,21896,328,9,0,22233
STEVENS RETENTION,  STEVENS - NO,Lykens Borough--2nd Ward,75,2,0,0,77,21896,328,9,0,22233
STEVENS RETENTION,  STEVENS - NO,"Middletown--1st Ward, 1st Precinct",56,0,0,0,56,21896,328,9,0,22233
STEVENS RETENTION,  STEVENS - NO,"Middletown--1st Ward, 2nd Precinct",98,1,1,0,100,21896,328,9,0,22233
STEVENS RETENTION,  STEVENS - NO,"Middletown--2nd Ward, 1st Precinct",116,2,0,0,118,21896,328,9,0,22233
STEVENS RETENTION,  STEVENS - NO,"Middletown--2nd Ward, 2nd Precinct",102,3,0,0,105,21896,328,9,0,22233
STEVENS RETENTION,  STEVENS - NO,"Middletown--3rd Ward, 1st Precinct",79,1,0,0,80,21896,328,9,0,22233
STEVENS RETENTION,  STEVENS - NO,"Middletown--3rd Ward, 2nd Precinct",141,0,0,0,141,21896,328,9,0,22233
STEVENS RETENTION,  STEVENS - NO,Millersburg--1st Ward,79,1,0,0,80,21896,328,9,0,22233
STEVENS RETENTION,  STEVENS - NO,Millersburg--2nd Ward,111,0,0,0,111,21896,328,9,0,22233
STEVENS RETENTION,  STEVENS - NO,Paxtang Borough,154,1,0,0,155,21896,328,9,0,22233
STEVENS RETENTION,  STEVENS - NO,Penbrook Borough--1st Ward,43,0,0,0,43,21896,328,9,0,22233
STEVENS RETENTION,  STEVENS - NO,Penbrook Borough--2nd Ward,42,0,0,0,42,21896,328,9,0,22233
STEVENS RETENTION,  STEVENS - NO,Penbrook Borough--3rd Ward,51,0,0,0,51,21896,328,9,0,22233
STEVENS RETENTION,  STEVENS - NO,Penbrook Borough--4th Ward,75,2,0,0,77,21896,328,9,0,22233
STEVENS RETENTION,  STEVENS - NO,Royalton Borough--1st Ward,29,0,0,0,29,21896,328,9,0,22233
STEVENS RETENTION,  STEVENS - NO,Royalton Borough--2nd Ward,46,0,0,0,46,21896,328,9,0,22233
STEVENS RETENTION,  STEVENS - NO,Steelton--1st Ward,84,4,0,0,88,21896,328,9,0,22233
STEVENS RETENTION,  STEVENS - NO,"Steelton--2nd Ward, 1st Precinct",57,0,0,0,57,21896,328,9,0,22233
STEVENS RETENTION,  STEVENS - NO,"Steelton--2nd Ward, 2nd Precinct",47,1,0,0,48,21896,328,9,0,22233
STEVENS RETENTION,  STEVENS - NO,"Steelton--3rd Ward, 1st Precinct",24,0,0,0,24,21896,328,9,0,22233
STEVENS RETENTION,  STEVENS - NO,"Steelton--3rd Ward, 2nd Precinct",51,0,0,0,51,21896,328,9,0,22233
STEVENS RETENTION,  STEVENS - NO,Steelton--4th Ward,47,1,0,0,48,21896,328,9,0,22233
STEVENS RETENTION,  STEVENS - NO,Pillow Borough,30,0,0,0,30,21896,328,9,0,22233
STEVENS RETENTION,  STEVENS - NO,Williamstown--1st Ward,55,1,0,0,56,21896,328,9,0,22233
STEVENS RETENTION,  STEVENS - NO,Williamstown--2nd Ward,42,0,0,0,42,21896,328,9,0,22233
STEVENS RETENTION,  STEVENS - NO,Conewago Twp--1st Precinct,150,0,0,0,150,21896,328,9,0,22233
STEVENS RETENTION,  STEVENS - NO,Conewago Twp--2nd Precinct,130,5,0,0,135,21896,328,9,0,22233
STEVENS RETENTION,  STEVENS - NO,Derry Township--1st Precinct,222,2,0,0,224,21896,328,9,0,22233
STEVENS RETENTION,  STEVENS - NO,Derry Township--2nd Precinct,152,2,0,0,154,21896,328,9,0,22233
STEVENS RETENTION,  STEVENS - NO,Derry Township--3rd Precinct,136,1,1,0,138,21896,328,9,0,22233
STEVENS RETENTION,  STEVENS - NO,Derry Township--4th Precinct,110,3,1,0,114,21896,328,9,0,22233
STEVENS RETENTION,  STEVENS - NO,Derry Township--5th Precinct,95,3,0,0,98,21896,328,9,0,22233
STEVENS RETENTION,  STEVENS - NO,Derry Township--6th Precinct,107,0,1,0,108,21896,328,9,0,22233
STEVENS RETENTION,  STEVENS - NO,Derry Township--7th Precinct,220,6,0,0,226,21896,328,9,0,22233
STEVENS RETENTION,  STEVENS - NO,Derry Township--8th Precinct,120,0,0,0,120,21896,328,9,0,22233
STEVENS RETENTION,  STEVENS - NO,Derry Township--9th Precinct,70,2,0,0,72,21896,328,9,0,22233
STEVENS RETENTION,  STEVENS - NO,Derry Township--10th Precinct,162,3,0,0,165,21896,328,9,0,22233
STEVENS RETENTION,  STEVENS - NO,Derry Township--11th Precinct,206,6,0,0,212,21896,328,9,0,22233
STEVENS RETENTION,  STEVENS - NO,Derry Township--12th Precinct,118,5,0,0,123,21896,328,9,0,22233
STEVENS RETENTION,  STEVENS - NO,Derry Township--13th Precinct,144,1,0,0,145,21896,328,9,0,22233
STEVENS RETENTION,  STEVENS - NO,Derry Township--14th Precinct,105,2,0,0,107,21896,328,9,0,22233
STEVENS RETENTION,  STEVENS - NO,Derry Township--15th Precinct,221,4,0,0,225,21896,328,9,0,22233
STEVENS RETENTION,  STEVENS - NO,East Hanover Township--1st Precinct,232,4,0,0,236,21896,328,9,0,22233
STEVENS RETENTION,  STEVENS - NO,East Hanover Township--2nd Precinct,260,3,0,0,263,21896,328,9,0,22233
STEVENS RETENTION,  STEVENS - NO,Halifax Twp--1st Precinct,210,2,0,0,212,21896,328,9,0,22233
STEVENS RETENTION,  STEVENS - NO,Halifax Twp--2nd Precinct,189,11,0,0,200,21896,328,9,0,22233
STEVENS RETENTION,  STEVENS - NO,Jackson Township,170,0,0,0,170,21896,328,9,0,22233
STEVENS RETENTION,  STEVENS - NO,Jefferson Township,47,0,0,0,47,21896,328,9,0,22233
STEVENS RETENTION,  STEVENS - NO,Londonderry Twp--1st Precinct,184,0,0,0,184,21896,328,9,0,22233
STEVENS RETENTION,  STEVENS - NO,Londonderry Twp--2nd Precinct,191,1,0,0,192,21896,328,9,0,22233
STEVENS RETENTION,  STEVENS - NO,Londonderry Twp--3rd Precinct,81,1,0,0,82,21896,328,9,0,22233
STEVENS RETENTION,  STEVENS - NO,Lower Paxton Twp--1st Precinct,129,1,0,0,130,21896,328,9,0,22233
STEVENS RETENTION,  STEVENS - NO,Lower Paxton Twp--2nd Precinct,145,5,0,0,150,21896,328,9,0,22233
STEVENS RETENTION,  STEVENS - NO,Lower Paxton Twp--3rd precinct,259,7,0,0,266,21896,328,9,0,22233
STEVENS RETENTION,  STEVENS - NO,Lower Paxton Twp--4th Precinct,198,1,0,0,199,21896,328,9,0,22233
STEVENS RETENTION,  STEVENS - NO,Lower Paxton Twp--5th Precinct,173,4,1,0,178,21896,328,9,0,22233
STEVENS RETENTION,  STEVENS - NO,Lower Paxton Twp--6th Precinct,132,1,0,0,133,21896,328,9,0,22233
STEVENS RETENTION,  STEVENS - NO,Lower Paxton Twp--7th Precinct,214,1,0,0,215,21896,328,9,0,22233
STEVENS RETENTION,  STEVENS - NO,Lower Paxton Twp--8th Precinct,115,1,0,0,116,21896,328,9,0,22233
STEVENS RETENTION,  STEVENS - NO,Lower Paxton Twp--9th Precinct,154,3,0,0,157,21896,328,9,0,22233
STEVENS RETENTION,  STEVENS - NO,Lower Paxton Twp--10th Precinct,84,3,0,0,87,21896,328,9,0,22233
STEVENS RETENTION,  STEVENS - NO,Lower Paxton Twp--11th Precinct,139,2,0,0,141,21896,328,9,0,22233
STEVENS RETENTION,  STEVENS - NO,Lower Paxton Twp--12th Precinct,179,3,1,0,183,21896,328,9,0,22233
STEVENS RETENTION,  STEVENS - NO,Lower Paxton Twp--13th Precinct,198,3,0,0,201,21896,328,9,0,22233
STEVENS RETENTION,  STEVENS - NO,Lower Paxton Twp--14th Precinct,108,1,0,0,109,21896,328,9,0,22233
STEVENS RETENTION,  STEVENS - NO,Lower Paxton Twp--15th Precinct,167,4,0,0,171,21896,328,9,0,22233
STEVENS RETENTION,  STEVENS - NO,Lower Paxton Twp--16th Precinct,280,3,0,0,283,21896,328,9,0,22233
STEVENS RETENTION,  STEVENS - NO,Lower Paxton Twp--17th Precinct,127,0,0,0,127,21896,328,9,0,22233
STEVENS RETENTION,  STEVENS - NO,Lower Paxton Twp--18th Precinct,119,1,0,0,120,21896,328,9,0,22233
STEVENS RETENTION,  STEVENS - NO,Lower Paxton Twp--19th Precinct,221,14,0,0,235,21896,328,9,0,22233
STEVENS RETENTION,  STEVENS - NO,Lower Paxton Twp--20th Precinct,166,3,0,0,169,21896,328,9,0,22233
STEVENS RETENTION,  STEVENS - NO,Lower Paxton Twp--21st Precinct,223,4,0,0,227,21896,328,9,0,22233
STEVENS RETENTION,  STEVENS - NO,Lower Paxton Twp--22nd Precinct,184,4,0,0,188,21896,328,9,0,22233
STEVENS RETENTION,  STEVENS - NO,Lower Paxton Twp--23rd Precinct,160,3,0,0,163,21896,328,9,0,22233
STEVENS RETENTION,  STEVENS - NO,Lower Paxton Twp--24th Precinct,164,5,0,0,169,21896,328,9,0,22233
STEVENS RETENTION,  STEVENS - NO,Lower Paxton Twp--25th Precinct,127,1,0,0,128,21896,328,9,0,22233
STEVENS RETENTION,  STEVENS - NO,Lower Paxton Twp--26th Precinct,168,5,0,0,173,21896,328,9,0,22233
STEVENS RETENTION,  STEVENS - NO,Lower Paxton Twp--27th Precinct,141,0,0,0,141,21896,328,9,0,22233
STEVENS RETENTION,  STEVENS - NO,Lower Swatara Twp--1st Precinct,237,1,0,0,238,21896,328,9,0,22233
STEVENS RETENTION,  STEVENS - NO,Lower Swatara Twp--2nd Precinct,182,5,0,0,187,21896,328,9,0,22233
STEVENS RETENTION,  STEVENS - NO,Lower Swatara Twp--3rd Precinct,160,4,0,0,164,21896,328,9,0,22233
STEVENS RETENTION,  STEVENS - NO,Lower Swatara Twp--4th Precinct,174,0,0,0,174,21896,328,9,0,22233
STEVENS RETENTION,  STEVENS - NO,Lykens Township,64,0,0,0,64,21896,328,9,0,22233
STEVENS RETENTION,  STEVENS - NO,Middle Paxton Twp--1st Precinct,291,2,0,0,293,21896,328,9,0,22233
STEVENS RETENTION,  STEVENS - NO,Middle Paxton Twp--2nd Precinct,198,2,0,0,200,21896,328,9,0,22233
STEVENS RETENTION,  STEVENS - NO,Middle Paxton Twp--3rd Precinct,286,0,0,0,286,21896,328,9,0,22233
STEVENS RETENTION,  STEVENS - NO,Mifflin Township,58,0,0,0,58,21896,328,9,0,22233
STEVENS RETENTION,  STEVENS - NO,Reed Township,30,0,0,0,30,21896,328,9,0,22233
STEVENS RETENTION,  STEVENS - NO,Rush Township,21,0,0,0,21,21896,328,9,0,22233
STEVENS RETENTION,  STEVENS - NO,South Hanover Twp--1st Precinct,186,4,0,0,190,21896,328,9,0,22233
STEVENS RETENTION,  STEVENS - NO,South Hanover Twp--2nd Precinct,236,6,0,0,242,21896,328,9,0,22233
STEVENS RETENTION,  STEVENS - NO,South Hanover Twp--3rd Precinct,162,0,0,0,162,21896,328,9,0,22233
STEVENS RETENTION,  STEVENS - NO,Susquehanna Twp--1st Ward,286,5,0,0,291,21896,328,9,0,22233
STEVENS RETENTION,  STEVENS - NO,Susquehanna Twp--2nd Ward,426,13,0,0,439,21896,328,9,0,22233
STEVENS RETENTION,  STEVENS - NO,Susquehanna Twp--3rd Ward,187,0,0,0,187,21896,328,9,0,22233
STEVENS RETENTION,  STEVENS - NO,Susquehanna Twp--4th Ward,211,2,0,0,213,21896,328,9,0,22233
STEVENS RETENTION,  STEVENS - NO,Susquehanna Twp--5th Ward,210,3,0,0,213,21896,328,9,0,22233
STEVENS RETENTION,  STEVENS - NO,Susquehanna Twp--6th Ward,255,6,0,0,261,21896,328,9,0,22233
STEVENS RETENTION,  STEVENS - NO,Susquehanna Twp--7th Ward,144,0,0,0,144,21896,328,9,0,22233
STEVENS RETENTION,  STEVENS - NO,Susquehanna Twp--8th Ward,329,12,0,0,341,21896,328,9,0,22233
STEVENS RETENTION,  STEVENS - NO,Susquehanna Twp--9th Ward,248,2,0,0,250,21896,328,9,0,22233
STEVENS RETENTION,  STEVENS - NO,Swatara Township--1st Ward,192,0,0,0,192,21896,328,9,0,22233
STEVENS RETENTION,  STEVENS - NO,Swatara Township--2nd Ward,119,2,0,0,121,21896,328,9,0,22233
STEVENS RETENTION,  STEVENS - NO,Swatara Township--3rd Ward,131,2,0,0,133,21896,328,9,0,22233
STEVENS RETENTION,  STEVENS - NO,Swatara Township--4th Ward,212,5,0,0,217,21896,328,9,0,22233
STEVENS RETENTION,  STEVENS - NO,Swatara Township--5th Ward,278,3,0,0,281,21896,328,9,0,22233
STEVENS RETENTION,  STEVENS - NO,Swatara Township--6th Ward,282,0,0,0,282,21896,328,9,0,22233
STEVENS RETENTION,  STEVENS - NO,Swatara Township--7th Ward,325,2,0,0,327,21896,328,9,0,22233
STEVENS RETENTION,  STEVENS - NO,Swatara Township--8th Ward,327,4,1,0,332,21896,328,9,0,22233
STEVENS RETENTION,  STEVENS - NO,Swatara Township--9th Ward,111,2,0,0,113,21896,328,9,0,22233
STEVENS RETENTION,  STEVENS - NO,Upper Paxton Twp--1st Precinct,180,2,0,0,182,21896,328,9,0,22233
STEVENS RETENTION,  STEVENS - NO,Upper Paxton Twp--2nd Precinct,129,1,0,0,130,21896,328,9,0,22233
STEVENS RETENTION,  STEVENS - NO,Washington Township,171,4,0,0,175,21896,328,9,0,22233
STEVENS RETENTION,  STEVENS - NO,Wayne Township,176,1,0,0,177,21896,328,9,0,22233
STEVENS RETENTION,  STEVENS - NO,West Hanover Twp--1st Precinct,227,4,0,0,231,21896,328,9,0,22233
STEVENS RETENTION,  STEVENS - NO,West Hanover Twp--2nd Precinct,199,2,0,0,201,21896,328,9,0,22233
STEVENS RETENTION,  STEVENS - NO,West Hanover Twp--3rd Precinct,468,9,2,0,479,21896,328,9,0,22233
STEVENS RETENTION,  STEVENS - NO,West Hanover Twp--4th Precinct,266,1,0,0,267,21896,328,9,0,22233
STEVENS RETENTION,  STEVENS - NO,Wiconisco Twp--1st Precinct,54,0,0,0,54,21896,328,9,0,22233
STEVENS RETENTION,  STEVENS - NO,Wiconisco Twp--2nd Precinct,32,1,0,0,33,21896,328,9,0,22233
STEVENS RETENTION,  STEVENS - NO,Williams Twp,71,1,0,0,72,21896,328,9,0,22233
STEVENS RETENTION,  STEVENS - YES,"City--1st Ward, 1st Precinct",40,1,0,0,41,14235,397,11,0,14643
STEVENS RETENTION,  STEVENS - YES,"City--1st Ward, 2nd Precinct",81,2,1,0,84,14235,397,11,0,14643
STEVENS RETENTION,  STEVENS - YES,"City--1st Ward, 3rd Precinct",26,1,0,0,27,14235,397,11,0,14643
STEVENS RETENTION,  STEVENS - YES,"City--2nd Ward, 1st Precinct",13,0,0,0,13,14235,397,11,0,14643
STEVENS RETENTION,  STEVENS - YES,"City--2nd Ward, 2nd Precinct",16,1,0,0,17,14235,397,11,0,14643
STEVENS RETENTION,  STEVENS - YES,City--3rd Ward,47,1,0,0,48,14235,397,11,0,14643
STEVENS RETENTION,  STEVENS - YES,City--4th Ward,74,4,0,0,78,14235,397,11,0,14643
STEVENS RETENTION,  STEVENS - YES,City--5th Ward,127,9,0,0,136,14235,397,11,0,14643
STEVENS RETENTION,  STEVENS - YES,City--6th Ward,63,1,3,0,67,14235,397,11,0,14643
STEVENS RETENTION,  STEVENS - YES,"City--7th Ward, 1st Precinct",27,0,0,0,27,14235,397,11,0,14643
STEVENS RETENTION,  STEVENS - YES,"City--7th Ward, 2nd Precinct",65,1,0,0,66,14235,397,11,0,14643
STEVENS RETENTION,  STEVENS - YES,City--8th Ward,50,0,0,0,50,14235,397,11,0,14643
STEVENS RETENTION,  STEVENS - YES,"City--9th Ward, 1st Precinct",22,1,0,0,23,14235,397,11,0,14643
STEVENS RETENTION,  STEVENS - YES,"City--9th Ward, 2nd Precinct",31,1,0,0,32,14235,397,11,0,14643
STEVENS RETENTION,  STEVENS - YES,"City--9th Ward, 3rd Precinct",76,1,0,0,77,14235,397,11,0,14643
STEVENS RETENTION,  STEVENS - YES,"City--9th Ward, 4th Precinct",76,3,0,0,79,14235,397,11,0,14643
STEVENS RETENTION,  STEVENS - YES,"City--9th Ward, 5th Precinct",53,1,0,0,54,14235,397,11,0,14643
STEVENS RETENTION,  STEVENS - YES,"City--10th Ward, 1st Precinct",81,5,0,0,86,14235,397,11,0,14643
STEVENS RETENTION,  STEVENS - YES,"City--10th Ward, 2nd Precinct",31,0,0,0,31,14235,397,11,0,14643
STEVENS RETENTION,  STEVENS - YES,"City--10th Ward, 3rd Precinct",50,1,0,0,51,14235,397,11,0,14643
STEVENS RETENTION,  STEVENS - YES,"City--10th Ward, 4th Precinct",49,0,0,0,49,14235,397,11,0,14643
STEVENS RETENTION,  STEVENS - YES,City--11th Ward,36,31,0,0,67,14235,397,11,0,14643
STEVENS RETENTION,  STEVENS - YES,City--12th Ward,100,5,0,0,105,14235,397,11,0,14643
STEVENS RETENTION,  STEVENS - YES,"City--13th Ward, 1st Precinct",42,0,0,0,42,14235,397,11,0,14643
STEVENS RETENTION,  STEVENS - YES,"City--13th Ward, 2nd Precinct",73,1,0,0,74,14235,397,11,0,14643
STEVENS RETENTION,  STEVENS - YES,"City--13th Ward, 3rd Precinct",80,0,0,0,80,14235,397,11,0,14643
STEVENS RETENTION,  STEVENS - YES,City--14th Ward,122,3,0,0,125,14235,397,11,0,14643
STEVENS RETENTION,  STEVENS - YES,City--15th Ward,27,0,0,0,27,14235,397,11,0,14643
STEVENS RETENTION,  STEVENS - YES,Berrysburg Borough,19,0,0,0,19,14235,397,11,0,14643
STEVENS RETENTION,  STEVENS - YES,Dauphin Borough,42,2,0,0,44,14235,397,11,0,14643
STEVENS RETENTION,  STEVENS - YES,Elizabethville Borough,57,1,0,0,58,14235,397,11,0,14643
STEVENS RETENTION,  STEVENS - YES,Gratz Borough,33,1,0,0,34,14235,397,11,0,14643
STEVENS RETENTION,  STEVENS - YES,Halifax Borough,29,3,0,0,32,14235,397,11,0,14643
STEVENS RETENTION,  STEVENS - YES,Highspire--1st Precinct,52,0,0,0,52,14235,397,11,0,14643
STEVENS RETENTION,  STEVENS - YES,Highspire--2nd Precinct,60,1,0,0,61,14235,397,11,0,14643
STEVENS RETENTION,  STEVENS - YES,Hummelstown--1st Precinct,70,1,0,0,71,14235,397,11,0,14643
STEVENS RETENTION,  STEVENS - YES,Hummelstown--2nd Precinct,155,4,0,0,159,14235,397,11,0,14643
STEVENS RETENTION,  STEVENS - YES,Lykens Borough--1st Ward,46,1,0,0,47,14235,397,11,0,14643
STEVENS RETENTION,  STEVENS - YES,Lykens Borough--2nd Ward,46,2,0,0,48,14235,397,11,0,14643
STEVENS RETENTION,  STEVENS - YES,"Middletown--1st Ward, 1st Precinct",42,0,0,0,42,14235,397,11,0,14643
STEVENS RETENTION,  STEVENS - YES,"Middletown--1st Ward, 2nd Precinct",67,4,0,0,71,14235,397,11,0,14643
STEVENS RETENTION,  STEVENS - YES,"Middletown--2nd Ward, 1st Precinct",51,1,0,0,52,14235,397,11,0,14643
STEVENS RETENTION,  STEVENS - YES,"Middletown--2nd Ward, 2nd Precinct",60,1,0,0,61,14235,397,11,0,14643
STEVENS RETENTION,  STEVENS - YES,"Middletown--3rd Ward, 1st Precinct",44,0,0,0,44,14235,397,11,0,14643
STEVENS RETENTION,  STEVENS - YES,"Middletown--3rd Ward, 2nd Precinct",85,0,0,0,85,14235,397,11,0,14643
STEVENS RETENTION,  STEVENS - YES,Millersburg--1st Ward,58,2,0,0,60,14235,397,11,0,14643
STEVENS RETENTION,  STEVENS - YES,Millersburg--2nd Ward,58,3,0,0,61,14235,397,11,0,14643
STEVENS RETENTION,  STEVENS - YES,Paxtang Borough,111,2,0,0,113,14235,397,11,0,14643
STEVENS RETENTION,  STEVENS - YES,Penbrook Borough--1st Ward,26,1,0,0,27,14235,397,11,0,14643
STEVENS RETENTION,  STEVENS - YES,Penbrook Borough--2nd Ward,37,1,0,0,38,14235,397,11,0,14643
STEVENS RETENTION,  STEVENS - YES,Penbrook Borough--3rd Ward,32,0,0,0,32,14235,397,11,0,14643
STEVENS RETENTION,  STEVENS - YES,Penbrook Borough--4th Ward,28,0,0,0,28,14235,397,11,0,14643
STEVENS RETENTION,  STEVENS - YES,Royalton Borough--1st Ward,15,0,0,0,15,14235,397,11,0,14643
STEVENS RETENTION,  STEVENS - YES,Royalton Borough--2nd Ward,28,0,0,0,28,14235,397,11,0,14643
STEVENS RETENTION,  STEVENS - YES,Steelton--1st Ward,60,2,0,0,62,14235,397,11,0,14643
STEVENS RETENTION,  STEVENS - YES,"Steelton--2nd Ward, 1st Precinct",43,1,0,0,44,14235,397,11,0,14643
STEVENS RETENTION,  STEVENS - YES,"Steelton--2nd Ward, 2nd Precinct",36,0,0,0,36,14235,397,11,0,14643
STEVENS RETENTION,  STEVENS - YES,"Steelton--3rd Ward, 1st Precinct",26,0,0,0,26,14235,397,11,0,14643
STEVENS RETENTION,  STEVENS - YES,"Steelton--3rd Ward, 2nd Precinct",35,0,0,0,35,14235,397,11,0,14643
STEVENS RETENTION,  STEVENS - YES,Steelton--4th Ward,38,1,1,0,40,14235,397,11,0,14643
STEVENS RETENTION,  STEVENS - YES,Pillow Borough,24,0,0,0,24,14235,397,11,0,14643
STEVENS RETENTION,  STEVENS - YES,Williamstown--1st Ward,36,0,0,0,36,14235,397,11,0,14643
STEVENS RETENTION,  STEVENS - YES,Williamstown--2nd Ward,22,0,0,0,22,14235,397,11,0,14643
STEVENS RETENTION,  STEVENS - YES,Conewago Twp--1st Precinct,100,1,0,0,101,14235,397,11,0,14643
STEVENS RETENTION,  STEVENS - YES,Conewago Twp--2nd Precinct,75,0,0,0,75,14235,397,11,0,14643
STEVENS RETENTION,  STEVENS - YES,Derry Township--1st Precinct,139,4,0,0,143,14235,397,11,0,14643
STEVENS RETENTION,  STEVENS - YES,Derry Township--2nd Precinct,117,3,0,0,120,14235,397,11,0,14643
STEVENS RETENTION,  STEVENS - YES,Derry Township--3rd Precinct,84,6,0,0,90,14235,397,11,0,14643
STEVENS RETENTION,  STEVENS - YES,Derry Township--4th Precinct,83,3,0,0,86,14235,397,11,0,14643
STEVENS RETENTION,  STEVENS - YES,Derry Township--5th Precinct,57,0,0,0,57,14235,397,11,0,14643
STEVENS RETENTION,  STEVENS - YES,Derry Township--6th Precinct,86,2,0,0,88,14235,397,11,0,14643
STEVENS RETENTION,  STEVENS - YES,Derry Township--7th Precinct,161,9,0,0,170,14235,397,11,0,14643
STEVENS RETENTION,  STEVENS - YES,Derry Township--8th Precinct,82,0,0,0,82,14235,397,11,0,14643
STEVENS RETENTION,  STEVENS - YES,Derry Township--9th Precinct,58,3,0,0,61,14235,397,11,0,14643
STEVENS RETENTION,  STEVENS - YES,Derry Township--10th Precinct,96,3,0,0,99,14235,397,11,0,14643
STEVENS RETENTION,  STEVENS - YES,Derry Township--11th Precinct,138,3,0,0,141,14235,397,11,0,14643
STEVENS RETENTION,  STEVENS - YES,Derry Township--12th Precinct,86,0,0,0,86,14235,397,11,0,14643
STEVENS RETENTION,  STEVENS - YES,Derry Township--13th Precinct,119,4,0,0,123,14235,397,11,0,14643
STEVENS RETENTION,  STEVENS - YES,Derry Township--14th Precinct,78,5,0,0,83,14235,397,11,0,14643
STEVENS RETENTION,  STEVENS - YES,Derry Township--15th Precinct,133,3,1,0,137,14235,397,11,0,14643
STEVENS RETENTION,  STEVENS - YES,East Hanover Township--1st Precinct,114,5,0,0,119,14235,397,11,0,14643
STEVENS RETENTION,  STEVENS - YES,East Hanover Township--2nd Precinct,143,2,0,0,145,14235,397,11,0,14643
STEVENS RETENTION,  STEVENS - YES,Halifax Twp--1st Precinct,99,2,0,0,101,14235,397,11,0,14643
STEVENS RETENTION,  STEVENS - YES,Halifax Twp--2nd Precinct,139,1,0,0,140,14235,397,11,0,14643
STEVENS RETENTION,  STEVENS - YES,Jackson Township,76,0,0,0,76,14235,397,11,0,14643
STEVENS RETENTION,  STEVENS - YES,Jefferson Township,20,0,0,0,20,14235,397,11,0,14643
STEVENS RETENTION,  STEVENS - YES,Londonderry Twp--1st Precinct,116,0,0,0,116,14235,397,11,0,14643
STEVENS RETENTION,  STEVENS - YES,Londonderry Twp--2nd Precinct,103,1,0,0,104,14235,397,11,0,14643
STEVENS RETENTION,  STEVENS - YES,Londonderry Twp--3rd Precinct,49,0,0,0,49,14235,397,11,0,14643
STEVENS RETENTION,  STEVENS - YES,Lower Paxton Twp--1st Precinct,89,2,0,0,91,14235,397,11,0,14643
STEVENS RETENTION,  STEVENS - YES,Lower Paxton Twp--2nd Precinct,96,6,0,0,102,14235,397,11,0,14643
STEVENS RETENTION,  STEVENS - YES,Lower Paxton Twp--3rd precinct,186,5,0,0,191,14235,397,11,0,14643
STEVENS RETENTION,  STEVENS - YES,Lower Paxton Twp--4th Precinct,133,2,0,0,135,14235,397,11,0,14643
STEVENS RETENTION,  STEVENS - YES,Lower Paxton Twp--5th Precinct,114,0,0,0,114,14235,397,11,0,14643
STEVENS RETENTION,  STEVENS - YES,Lower Paxton Twp--6th Precinct,88,4,0,0,92,14235,397,11,0,14643
STEVENS RETENTION,  STEVENS - YES,Lower Paxton Twp--7th Precinct,154,6,0,0,160,14235,397,11,0,14643
STEVENS RETENTION,  STEVENS - YES,Lower Paxton Twp--8th Precinct,74,2,0,0,76,14235,397,11,0,14643
STEVENS RETENTION,  STEVENS - YES,Lower Paxton Twp--9th Precinct,76,3,0,0,79,14235,397,11,0,14643
STEVENS RETENTION,  STEVENS - YES,Lower Paxton Twp--10th Precinct,73,2,0,0,75,14235,397,11,0,14643
STEVENS RETENTION,  STEVENS - YES,Lower Paxton Twp--11th Precinct,90,0,0,0,90,14235,397,11,0,14643
STEVENS RETENTION,  STEVENS - YES,Lower Paxton Twp--12th Precinct,169,4,0,0,173,14235,397,11,0,14643
STEVENS RETENTION,  STEVENS - YES,Lower Paxton Twp--13th Precinct,123,2,0,0,125,14235,397,11,0,14643
STEVENS RETENTION,  STEVENS - YES,Lower Paxton Twp--14th Precinct,85,1,3,0,89,14235,397,11,0,14643
STEVENS RETENTION,  STEVENS - YES,Lower Paxton Twp--15th Precinct,120,1,0,0,121,14235,397,11,0,14643
STEVENS RETENTION,  STEVENS - YES,Lower Paxton Twp--16th Precinct,193,7,0,0,200,14235,397,11,0,14643
STEVENS RETENTION,  STEVENS - YES,Lower Paxton Twp--17th Precinct,102,5,0,0,107,14235,397,11,0,14643
STEVENS RETENTION,  STEVENS - YES,Lower Paxton Twp--18th Precinct,102,1,0,0,103,14235,397,11,0,14643
STEVENS RETENTION,  STEVENS - YES,Lower Paxton Twp--19th Precinct,178,4,0,0,182,14235,397,11,0,14643
STEVENS RETENTION,  STEVENS - YES,Lower Paxton Twp--20th Precinct,123,2,0,0,125,14235,397,11,0,14643
STEVENS RETENTION,  STEVENS - YES,Lower Paxton Twp--21st Precinct,162,7,0,0,169,14235,397,11,0,14643
STEVENS RETENTION,  STEVENS - YES,Lower Paxton Twp--22nd Precinct,134,2,0,0,136,14235,397,11,0,14643
STEVENS RETENTION,  STEVENS - YES,Lower Paxton Twp--23rd Precinct,121,1,0,0,122,14235,397,11,0,14643
STEVENS RETENTION,  STEVENS - YES,Lower Paxton Twp--24th Precinct,138,2,0,0,140,14235,397,11,0,14643
STEVENS RETENTION,  STEVENS - YES,Lower Paxton Twp--25th Precinct,83,3,0,0,86,14235,397,11,0,14643
STEVENS RETENTION,  STEVENS - YES,Lower Paxton Twp--26th Precinct,135,3,0,0,138,14235,397,11,0,14643
STEVENS RETENTION,  STEVENS - YES,Lower Paxton Twp--27th Precinct,123,1,0,0,124,14235,397,11,0,14643
STEVENS RETENTION,  STEVENS - YES,Lower Swatara Twp--1st Precinct,151,4,0,0,155,14235,397,11,0,14643
STEVENS RETENTION,  STEVENS - YES,Lower Swatara Twp--2nd Precinct,138,3,0,0,141,14235,397,11,0,14643
STEVENS RETENTION,  STEVENS - YES,Lower Swatara Twp--3rd Precinct,121,16,0,0,137,14235,397,11,0,14643
STEVENS RETENTION,  STEVENS - YES,Lower Swatara Twp--4th Precinct,91,1,0,0,92,14235,397,11,0,14643
STEVENS RETENTION,  STEVENS - YES,Lykens Township,30,0,0,0,30,14235,397,11,0,14643
STEVENS RETENTION,  STEVENS - YES,Middle Paxton Twp--1st Precinct,81,0,0,0,81,14235,397,11,0,14643
STEVENS RETENTION,  STEVENS - YES,Middle Paxton Twp--2nd Precinct,105,0,0,0,105,14235,397,11,0,14643
STEVENS RETENTION,  STEVENS - YES,Middle Paxton Twp--3rd Precinct,104,2,0,0,106,14235,397,11,0,14643
STEVENS RETENTION,  STEVENS - YES,Mifflin Township,31,0,0,0,31,14235,397,11,0,14643
STEVENS RETENTION,  STEVENS - YES,Reed Township,15,0,0,0,15,14235,397,11,0,14643
STEVENS RETENTION,  STEVENS - YES,Rush Township,17,0,0,0,17,14235,397,11,0,14643
STEVENS RETENTION,  STEVENS - YES,South Hanover Twp--1st Precinct,112,1,0,0,113,14235,397,11,0,14643
STEVENS RETENTION,  STEVENS - YES,South Hanover Twp--2nd Precinct,171,4,0,0,175,14235,397,11,0,14643
STEVENS RETENTION,  STEVENS - YES,South Hanover Twp--3rd Precinct,90,0,0,0,90,14235,397,11,0,14643
STEVENS RETENTION,  STEVENS - YES,Susquehanna Twp--1st Ward,196,11,0,0,207,14235,397,11,0,14643
STEVENS RETENTION,  STEVENS - YES,Susquehanna Twp--2nd Ward,275,13,0,0,288,14235,397,11,0,14643
STEVENS RETENTION,  STEVENS - YES,Susquehanna Twp--3rd Ward,128,2,0,0,130,14235,397,11,0,14643
STEVENS RETENTION,  STEVENS - YES,Susquehanna Twp--4th Ward,137,1,0,0,138,14235,397,11,0,14643
STEVENS RETENTION,  STEVENS - YES,Susquehanna Twp--5th Ward,143,3,0,0,146,14235,397,11,0,14643
STEVENS RETENTION,  STEVENS - YES,Susquehanna Twp--6th Ward,151,3,0,0,154,14235,397,11,0,14643
STEVENS RETENTION,  STEVENS - YES,Susquehanna Twp--7th Ward,93,0,0,0,93,14235,397,11,0,14643
STEVENS RETENTION,  STEVENS - YES,Susquehanna Twp--8th Ward,241,10,0,0,251,14235,397,11,0,14643
STEVENS RETENTION,  STEVENS - YES,Susquehanna Twp--9th Ward,163,3,0,0,166,14235,397,11,0,14643
STEVENS RETENTION,  STEVENS - YES,Swatara Township--1st Ward,144,1,0,0,145,14235,397,11,0,14643
STEVENS RETENTION,  STEVENS - YES,Swatara Township--2nd Ward,93,18,0,0,111,14235,397,11,0,14643
STEVENS RETENTION,  STEVENS - YES,Swatara Township--3rd Ward,101,5,0,0,106,14235,397,11,0,14643
STEVENS RETENTION,  STEVENS - YES,Swatara Township--4th Ward,147,3,0,0,150,14235,397,11,0,14643
STEVENS RETENTION,  STEVENS - YES,Swatara Township--5th Ward,182,2,0,0,184,14235,397,11,0,14643
STEVENS RETENTION,  STEVENS - YES,Swatara Township--6th Ward,152,3,1,0,156,14235,397,11,0,14643
STEVENS RETENTION,  STEVENS - YES,Swatara Township--7th Ward,154,7,0,0,161,14235,397,11,0,14643
STEVENS RETENTION,  STEVENS - YES,Swatara Township--8th Ward,184,3,0,0,187,14235,397,11,0,14643
STEVENS RETENTION,  STEVENS - YES,Swatara Township--9th Ward,95,6,0,0,101,14235,397,11,0,14643
STEVENS RETENTION,  STEVENS - YES,Upper Paxton Twp--1st Precinct,121,1,0,0,122,14235,397,11,0,14643
STEVENS RETENTION,  STEVENS - YES,Upper Paxton Twp--2nd Precinct,67,2,0,0,69,14235,397,11,0,14643
STEVENS RETENTION,  STEVENS - YES,Washington Township,114,3,0,0,117,14235,397,11,0,14643
STEVENS RETENTION,  STEVENS - YES,Wayne Township,90,0,1,0,91,14235,397,11,0,14643
STEVENS RETENTION,  STEVENS - YES,West Hanover Twp--1st Precinct,101,2,0,0,103,14235,397,11,0,14643
STEVENS RETENTION,  STEVENS - YES,West Hanover Twp--2nd Precinct,114,4,0,0,118,14235,397,11,0,14643
STEVENS RETENTION,  STEVENS - YES,West Hanover Twp--3rd Precinct,247,10,0,0,257,14235,397,11,0,14643
STEVENS RETENTION,  STEVENS - YES,West Hanover Twp--4th Precinct,144,2,0,0,146,14235,397,11,0,14643
STEVENS RETENTION,  STEVENS - YES,Wiconisco Twp--1st Precinct,28,1,0,0,29,14235,397,11,0,14643
STEVENS RETENTION,  STEVENS - YES,Wiconisco Twp--2nd Precinct,35,0,0,0,35,14235,397,11,0,14643
STEVENS RETENTION,  STEVENS - YES,Williams Twp,74,0,0,0,74,14235,397,11,0,14643
SUPERVISOR  JACKSON,Bruce  HARMAN,Jackson Township,183,1,0,0,184,183,1,0,0,184
SUPERVISOR  JACKSON,Write In  ,Jackson Township,61,0,0,0,61,61,0,0,0,61
SUPERVISOR 2YR RUSH,Ronald  KOPPENHAVER,Rush Township,39,0,0,0,39,39,0,0,0,39
SUPERVISOR 2YR RUSH,Write In  ,Rush Township,0,0,0,0,0,0,0,0,0,0
SUPERVISOR 4YR REED,Write In  ,Reed Township,6,0,0,0,6,6,0,0,0,6
SUPERVISOR 4YR WEST HANOVER,Adam G. KLEIN,West Hanover Twp--1st Precinct,167,4,0,0,171,1067,25,0,0,1092
SUPERVISOR 4YR WEST HANOVER,Adam G. KLEIN,West Hanover Twp--2nd Precinct,170,6,0,0,176,1067,25,0,0,1092
SUPERVISOR 4YR WEST HANOVER,Adam G. KLEIN,West Hanover Twp--3rd Precinct,448,12,0,0,460,1067,25,0,0,1092
SUPERVISOR 4YR WEST HANOVER,Adam G. KLEIN,West Hanover Twp--4th Precinct,282,3,0,0,285,1067,25,0,0,1092
SUPERVISOR 4YR WEST HANOVER,William P. OSTERMAYER,West Hanover Twp--1st Precinct,230,3,1,0,234,983,10,1,0,994
SUPERVISOR 4YR WEST HANOVER,William P. OSTERMAYER,West Hanover Twp--2nd Precinct,211,2,0,0,213,983,10,1,0,994
SUPERVISOR 4YR WEST HANOVER,William P. OSTERMAYER,West Hanover Twp--3rd Precinct,349,5,0,0,354,983,10,1,0,994
SUPERVISOR 4YR WEST HANOVER,William P. OSTERMAYER,West Hanover Twp--4th Precinct,193,0,0,0,193,983,10,1,0,994
SUPERVISOR 4YR WEST HANOVER,Write In  ,West Hanover Twp--1st Precinct,2,0,0,0,2,7,0,0,0,7
SUPERVISOR 4YR WEST HANOVER,Write In  ,West Hanover Twp--2nd Precinct,3,0,0,0,3,7,0,0,0,7
SUPERVISOR 4YR WEST HANOVER,Write In  ,West Hanover Twp--3rd Precinct,1,0,0,0,1,7,0,0,0,7
SUPERVISOR 4YR WEST HANOVER,Write In  ,West Hanover Twp--4th Precinct,1,0,0,0,1,7,0,0,0,7
SUPERVISOR 4YR WILLIAMS,Lynn A. ZELLER,Williams Twp,151,1,0,0,152,151,1,0,0,152
SUPERVISOR 4YR WILLIAMS,Write In  ,Williams Twp,0,0,0,0,0,0,0,0,0,0
SUPERVISOR 6YR RUSH,Ann  SHOMPER,Rush Township,38,0,0,0,38,38,0,0,0,38
SUPERVISOR 6YR RUSH,Write In  ,Rush Township,0,0,0,0,0,0,0,0,0,0
SUPERVISOR 6YR WEST HANOVER,Deborah Essis CURCILLO,West Hanover Twp--1st Precinct,161,5,0,0,166,1103,28,0,0,1131
SUPERVISOR 6YR WEST HANOVER,Deborah Essis CURCILLO,West Hanover Twp--2nd Precinct,153,7,0,0,160,1103,28,0,0,1131
SUPERVISOR 6YR WEST HANOVER,Deborah Essis CURCILLO,West Hanover Twp--3rd Precinct,505,14,0,0,519,1103,28,0,0,1131
SUPERVISOR 6YR WEST HANOVER,Deborah Essis CURCILLO,West Hanover Twp--4th Precinct,284,2,0,0,286,1103,28,0,0,1131
SUPERVISOR 6YR WEST HANOVER,Jay P. MEGONNELL,West Hanover Twp--1st Precinct,235,1,1,0,237,957,8,1,0,966
SUPERVISOR 6YR WEST HANOVER,Jay P. MEGONNELL,West Hanover Twp--2nd Precinct,225,0,0,0,225,957,8,1,0,966
SUPERVISOR 6YR WEST HANOVER,Jay P. MEGONNELL,West Hanover Twp--3rd Precinct,311,6,0,0,317,957,8,1,0,966
SUPERVISOR 6YR WEST HANOVER,Jay P. MEGONNELL,West Hanover Twp--4th Precinct,186,1,0,0,187,957,8,1,0,966
SUPERVISOR 6YR WEST HANOVER,Write In  ,West Hanover Twp--1st Precinct,2,0,0,0,2,9,0,0,0,9
SUPERVISOR 6YR WEST HANOVER,Write In  ,West Hanover Twp--2nd Precinct,4,0,0,0,4,9,0,0,0,9
SUPERVISOR 6YR WEST HANOVER,Write In  ,West Hanover Twp--3rd Precinct,2,0,0,0,2,9,0,0,0,9
SUPERVISOR 6YR WEST HANOVER,Write In  ,West Hanover Twp--4th Precinct,1,0,0,0,1,9,0,0,0,9
SUPERVISOR 6YR WILLIAMS,Harold L. SMITH,Williams Twp,148,1,0,0,149,148,1,0,0,149
SUPERVISOR 6YR WILLIAMS,Write In  ,Williams Twp,0,0,0,0,0,0,0,0,0,0
SUPERVISOR CONEWAGO,Jay M. BRANDT,Conewago Twp--1st Precinct,233,1,0,0,234,382,8,0,0,390
SUPERVISOR CONEWAGO,Jay M. BRANDT,Conewago Twp--2nd Precinct,149,7,0,0,156,382,8,0,0,390
SUPERVISOR CONEWAGO,Joel  BUCKLEY,Conewago Twp--1st Precinct,85,1,0,0,86,182,1,0,0,183
SUPERVISOR CONEWAGO,Joel  BUCKLEY,Conewago Twp--2nd Precinct,97,0,0,0,97,182,1,0,0,183
SUPERVISOR CONEWAGO,Write In  ,Conewago Twp--1st Precinct,2,0,0,0,2,2,0,0,0,2
SUPERVISOR CONEWAGO,Write In  ,Conewago Twp--2nd Precinct,0,0,0,0,0,2,0,0,0,2
SUPERVISOR DERRY,Chris  ABRUZZO,Derry Township--1st Precinct,303,4,0,0,307,3043,50,2,0,3095
SUPERVISOR DERRY,Chris  ABRUZZO,Derry Township--2nd Precinct,223,3,0,0,226,3043,50,2,0,3095
SUPERVISOR DERRY,Chris  ABRUZZO,Derry Township--3rd Precinct,206,3,0,0,209,3043,50,2,0,3095
SUPERVISOR DERRY,Chris  ABRUZZO,Derry Township--4th Precinct,138,2,0,0,140,3043,50,2,0,3095
SUPERVISOR DERRY,Chris  ABRUZZO,Derry Township--5th Precinct,111,2,0,0,113,3043,50,2,0,3095
SUPERVISOR DERRY,Chris  ABRUZZO,Derry Township--6th Precinct,142,1,1,0,144,3043,50,2,0,3095
SUPERVISOR DERRY,Chris  ABRUZZO,Derry Township--7th Precinct,337,9,0,0,346,3043,50,2,0,3095
SUPERVISOR DERRY,Chris  ABRUZZO,Derry Township--8th Precinct,167,0,0,0,167,3043,50,2,0,3095
SUPERVISOR DERRY,Chris  ABRUZZO,Derry Township--9th Precinct,112,0,0,0,112,3043,50,2,0,3095
SUPERVISOR DERRY,Chris  ABRUZZO,Derry Township--10th Precinct,198,3,0,0,201,3043,50,2,0,3095
SUPERVISOR DERRY,Chris  ABRUZZO,Derry Township--11th Precinct,274,8,0,0,282,3043,50,2,0,3095
SUPERVISOR DERRY,Chris  ABRUZZO,Derry Township--12th Precinct,160,3,0,0,163,3043,50,2,0,3095
SUPERVISOR DERRY,Chris  ABRUZZO,Derry Township--13th Precinct,222,2,0,0,224,3043,50,2,0,3095
SUPERVISOR DERRY,Chris  ABRUZZO,Derry Township--14th Precinct,158,5,0,0,163,3043,50,2,0,3095
SUPERVISOR DERRY,Chris  ABRUZZO,Derry Township--15th Precinct,292,5,1,0,298,3043,50,2,0,3095
SUPERVISOR DERRY,Kelly  FEDELI,Derry Township--1st Precinct,280,5,0,0,285,2856,42,2,0,2900
SUPERVISOR DERRY,Kelly  FEDELI,Derry Township--2nd Precinct,220,4,0,0,224,2856,42,2,0,2900
SUPERVISOR DERRY,Kelly  FEDELI,Derry Township--3rd Precinct,189,2,0,0,191,2856,42,2,0,2900
SUPERVISOR DERRY,Kelly  FEDELI,Derry Township--4th Precinct,152,3,0,0,155,2856,42,2,0,2900
SUPERVISOR DERRY,Kelly  FEDELI,Derry Township--5th Precinct,85,0,0,0,85,2856,42,2,0,2900
SUPERVISOR DERRY,Kelly  FEDELI,Derry Township--6th Precinct,145,1,1,0,147,2856,42,2,0,2900
SUPERVISOR DERRY,Kelly  FEDELI,Derry Township--7th Precinct,291,8,0,0,299,2856,42,2,0,2900
SUPERVISOR DERRY,Kelly  FEDELI,Derry Township--8th Precinct,145,0,0,0,145,2856,42,2,0,2900
SUPERVISOR DERRY,Kelly  FEDELI,Derry Township--9th Precinct,102,1,0,0,103,2856,42,2,0,2900
SUPERVISOR DERRY,Kelly  FEDELI,Derry Township--10th Precinct,201,4,0,0,205,2856,42,2,0,2900
SUPERVISOR DERRY,Kelly  FEDELI,Derry Township--11th Precinct,278,1,0,0,279,2856,42,2,0,2900
SUPERVISOR DERRY,Kelly  FEDELI,Derry Township--12th Precinct,148,1,0,0,149,2856,42,2,0,2900
SUPERVISOR DERRY,Kelly  FEDELI,Derry Township--13th Precinct,212,6,0,0,218,2856,42,2,0,2900
SUPERVISOR DERRY,Kelly  FEDELI,Derry Township--14th Precinct,144,3,0,0,147,2856,42,2,0,2900
SUPERVISOR DERRY,Kelly  FEDELI,Derry Township--15th Precinct,264,3,1,0,268,2856,42,2,0,2900
SUPERVISOR DERRY,Sandra  BALLARD,Derry Township--1st Precinct,217,2,0,0,219,2225,72,0,0,2297
SUPERVISOR DERRY,Sandra  BALLARD,Derry Township--2nd Precinct,204,5,0,0,209,2225,72,0,0,2297
SUPERVISOR DERRY,Sandra  BALLARD,Derry Township--3rd Precinct,129,7,0,0,136,2225,72,0,0,2297
SUPERVISOR DERRY,Sandra  BALLARD,Derry Township--4th Precinct,111,4,0,0,115,2225,72,0,0,2297
SUPERVISOR DERRY,Sandra  BALLARD,Derry Township--5th Precinct,138,3,0,0,141,2225,72,0,0,2297
SUPERVISOR DERRY,Sandra  BALLARD,Derry Township--6th Precinct,111,1,0,0,112,2225,72,0,0,2297
SUPERVISOR DERRY,Sandra  BALLARD,Derry Township--7th Precinct,199,15,0,0,214,2225,72,0,0,2297
SUPERVISOR DERRY,Sandra  BALLARD,Derry Township--8th Precinct,120,0,0,0,120,2225,72,0,0,2297
SUPERVISOR DERRY,Sandra  BALLARD,Derry Township--9th Precinct,63,4,0,0,67,2225,72,0,0,2297
SUPERVISOR DERRY,Sandra  BALLARD,Derry Township--10th Precinct,140,3,0,0,143,2225,72,0,0,2297
SUPERVISOR DERRY,Sandra  BALLARD,Derry Township--11th Precinct,215,9,0,0,224,2225,72,0,0,2297
SUPERVISOR DERRY,Sandra  BALLARD,Derry Township--12th Precinct,121,5,0,0,126,2225,72,0,0,2297
SUPERVISOR DERRY,Sandra  BALLARD,Derry Township--13th Precinct,171,8,0,0,179,2225,72,0,0,2297
SUPERVISOR DERRY,Sandra  BALLARD,Derry Township--14th Precinct,99,3,0,0,102,2225,72,0,0,2297
SUPERVISOR DERRY,Sandra  BALLARD,Derry Township--15th Precinct,187,3,0,0,190,2225,72,0,0,2297
SUPERVISOR DERRY,Write In  ,Derry Township--1st Precinct,0,0,0,0,0,9,0,0,0,9
SUPERVISOR DERRY,Write In  ,Derry Township--2nd Precinct,1,0,0,0,1,9,0,0,0,9
SUPERVISOR DERRY,Write In  ,Derry Township--3rd Precinct,2,0,0,0,2,9,0,0,0,9
SUPERVISOR DERRY,Write In  ,Derry Township--4th Precinct,0,0,0,0,0,9,0,0,0,9
SUPERVISOR DERRY,Write In  ,Derry Township--5th Precinct,0,0,0,0,0,9,0,0,0,9
SUPERVISOR DERRY,Write In  ,Derry Township--6th Precinct,0,0,0,0,0,9,0,0,0,9
SUPERVISOR DERRY,Write In  ,Derry Township--7th Precinct,0,0,0,0,0,9,0,0,0,9
SUPERVISOR DERRY,Write In  ,Derry Township--8th Precinct,1,0,0,0,1,9,0,0,0,9
SUPERVISOR DERRY,Write In  ,Derry Township--9th Precinct,0,0,0,0,0,9,0,0,0,9
SUPERVISOR DERRY,Write In  ,Derry Township--10th Precinct,0,0,0,0,0,9,0,0,0,9
SUPERVISOR DERRY,Write In  ,Derry Township--11th Precinct,2,0,0,0,2,9,0,0,0,9
SUPERVISOR DERRY,Write In  ,Derry Township--12th Precinct,0,0,0,0,0,9,0,0,0,9
SUPERVISOR DERRY,Write In  ,Derry Township--13th Precinct,1,0,0,0,1,9,0,0,0,9
SUPERVISOR DERRY,Write In  ,Derry Township--14th Precinct,0,0,0,0,0,9,0,0,0,9
SUPERVISOR DERRY,Write In  ,Derry Township--15th Precinct,2,0,0,0,2,9,0,0,0,9
SUPERVISOR EAST HANOVER,Larry L. SPITLER,East Hanover Township--1st Precinct,344,8,0,0,352,759,14,0,0,773
SUPERVISOR EAST HANOVER,Larry L. SPITLER,East Hanover Township--2nd Precinct,415,6,0,0,421,759,14,0,0,773
SUPERVISOR EAST HANOVER,Write In  ,East Hanover Township--1st Precinct,5,0,0,0,5,11,0,0,0,11
SUPERVISOR EAST HANOVER,Write In  ,East Hanover Township--2nd Precinct,6,0,0,0,6,11,0,0,0,11
SUPERVISOR HALIFAX TWP,Gary  SHULTZ,Halifax Twp--1st Precinct,160,3,0,0,163,385,12,0,0,397
SUPERVISOR HALIFAX TWP,Gary  SHULTZ,Halifax Twp--2nd Precinct,225,9,0,0,234,385,12,0,0,397
SUPERVISOR HALIFAX TWP,James A. EPPLEY,Halifax Twp--1st Precinct,124,1,0,0,125,316,7,0,0,323
SUPERVISOR HALIFAX TWP,James A. EPPLEY,Halifax Twp--2nd Precinct,192,6,0,0,198,316,7,0,0,323
SUPERVISOR HALIFAX TWP,Kenneth E. HOOVER,Halifax Twp--1st Precinct,190,4,0,0,194,354,8,0,0,362
SUPERVISOR HALIFAX TWP,Kenneth E. HOOVER,Halifax Twp--2nd Precinct,164,4,0,0,168,354,8,0,0,362
SUPERVISOR HALIFAX TWP,Pat  KAUFFMAN,Halifax Twp--1st Precinct,183,2,0,0,185,336,7,0,0,343
SUPERVISOR HALIFAX TWP,Pat  KAUFFMAN,Halifax Twp--2nd Precinct,153,5,0,0,158,336,7,0,0,343
SUPERVISOR HALIFAX TWP,Write In  ,Halifax Twp--1st Precinct,0,0,0,0,0,0,0,0,0,0
SUPERVISOR HALIFAX TWP,Write In  ,Halifax Twp--2nd Precinct,0,0,0,0,0,0,0,0,0,0
SUPERVISOR JEFFERSON,Write In  ,Jefferson Township,37,0,0,0,37,37,0,0,0,37
SUPERVISOR LONDONDERRY,Andy  DOHERTY,Londonderry Twp--1st Precinct,309,0,0,0,309,734,4,0,0,738
SUPERVISOR LONDONDERRY,Andy  DOHERTY,Londonderry Twp--2nd Precinct,298,3,0,0,301,734,4,0,0,738
SUPERVISOR LONDONDERRY,Andy  DOHERTY,Londonderry Twp--3rd Precinct,127,1,0,0,128,734,4,0,0,738
SUPERVISOR LONDONDERRY,Anna J. DALE,Londonderry Twp--1st Precinct,303,0,0,0,303,738,4,0,0,742
SUPERVISOR LONDONDERRY,Anna J. DALE,Londonderry Twp--2nd Precinct,304,3,0,0,307,738,4,0,0,742
SUPERVISOR LONDONDERRY,Anna J. DALE,Londonderry Twp--3rd Precinct,131,1,0,0,132,738,4,0,0,742
SUPERVISOR LONDONDERRY,Write In  ,Londonderry Twp--1st Precinct,0,0,0,0,0,4,0,0,0,4
SUPERVISOR LONDONDERRY,Write In  ,Londonderry Twp--2nd Precinct,3,0,0,0,3,4,0,0,0,4
SUPERVISOR LONDONDERRY,Write In  ,Londonderry Twp--3rd Precinct,1,0,0,0,1,4,0,0,0,4
SUPERVISOR LOW PAXTON,David B. BLAIN,Lower Paxton Twp--1st Precinct,163,2,0,0,165,5189,128,5,0,5322
SUPERVISOR LOW PAXTON,David B. BLAIN,Lower Paxton Twp--2nd Precinct,154,5,0,0,159,5189,128,5,0,5322
SUPERVISOR LOW PAXTON,David B. BLAIN,Lower Paxton Twp--3rd precinct,320,11,0,0,331,5189,128,5,0,5322
SUPERVISOR LOW PAXTON,David B. BLAIN,Lower Paxton Twp--4th Precinct,220,3,0,0,223,5189,128,5,0,5322
SUPERVISOR LOW PAXTON,David B. BLAIN,Lower Paxton Twp--5th Precinct,171,3,1,0,175,5189,128,5,0,5322
SUPERVISOR LOW PAXTON,David B. BLAIN,Lower Paxton Twp--6th Precinct,144,4,0,0,148,5189,128,5,0,5322
SUPERVISOR LOW PAXTON,David B. BLAIN,Lower Paxton Twp--7th Precinct,284,5,0,0,289,5189,128,5,0,5322
SUPERVISOR LOW PAXTON,David B. BLAIN,Lower Paxton Twp--8th Precinct,115,2,0,0,117,5189,128,5,0,5322
SUPERVISOR LOW PAXTON,David B. BLAIN,Lower Paxton Twp--9th Precinct,162,4,0,0,166,5189,128,5,0,5322
SUPERVISOR LOW PAXTON,David B. BLAIN,Lower Paxton Twp--10th Precinct,79,4,0,0,83,5189,128,5,0,5322
SUPERVISOR LOW PAXTON,David B. BLAIN,Lower Paxton Twp--11th Precinct,160,2,1,0,163,5189,128,5,0,5322
SUPERVISOR LOW PAXTON,David B. BLAIN,Lower Paxton Twp--12th Precinct,242,8,1,0,251,5189,128,5,0,5322
SUPERVISOR LOW PAXTON,David B. BLAIN,Lower Paxton Twp--13th Precinct,213,4,0,0,217,5189,128,5,0,5322
SUPERVISOR LOW PAXTON,David B. BLAIN,Lower Paxton Twp--14th Precinct,124,4,2,0,130,5189,128,5,0,5322
SUPERVISOR LOW PAXTON,David B. BLAIN,Lower Paxton Twp--15th Precinct,201,5,0,0,206,5189,128,5,0,5322
SUPERVISOR LOW PAXTON,David B. BLAIN,Lower Paxton Twp--16th Precinct,308,9,0,0,317,5189,128,5,0,5322
SUPERVISOR LOW PAXTON,David B. BLAIN,Lower Paxton Twp--17th Precinct,151,5,0,0,156,5189,128,5,0,5322
SUPERVISOR LOW PAXTON,David B. BLAIN,Lower Paxton Twp--18th Precinct,130,2,0,0,132,5189,128,5,0,5322
SUPERVISOR LOW PAXTON,David B. BLAIN,Lower Paxton Twp--19th Precinct,253,16,0,0,269,5189,128,5,0,5322
SUPERVISOR LOW PAXTON,David B. BLAIN,Lower Paxton Twp--20th Precinct,214,5,0,0,219,5189,128,5,0,5322
SUPERVISOR LOW PAXTON,David B. BLAIN,Lower Paxton Twp--21st Precinct,255,3,0,0,258,5189,128,5,0,5322
SUPERVISOR LOW PAXTON,David B. BLAIN,Lower Paxton Twp--22nd Precinct,240,4,0,0,244,5189,128,5,0,5322
SUPERVISOR LOW PAXTON,David B. BLAIN,Lower Paxton Twp--23rd Precinct,212,4,0,0,216,5189,128,5,0,5322
SUPERVISOR LOW PAXTON,David B. BLAIN,Lower Paxton Twp--24th Precinct,189,7,0,0,196,5189,128,5,0,5322
SUPERVISOR LOW PAXTON,David B. BLAIN,Lower Paxton Twp--25th Precinct,125,3,0,0,128,5189,128,5,0,5322
SUPERVISOR LOW PAXTON,David B. BLAIN,Lower Paxton Twp--26th Precinct,203,4,0,0,207,5189,128,5,0,5322
SUPERVISOR LOW PAXTON,David B. BLAIN,Lower Paxton Twp--27th Precinct,157,0,0,0,157,5189,128,5,0,5322
SUPERVISOR LOW PAXTON,Jay  PURDY,Lower Paxton Twp--1st Precinct,89,1,0,0,90,3238,56,1,0,3295
SUPERVISOR LOW PAXTON,Jay  PURDY,Lower Paxton Twp--2nd Precinct,107,6,0,0,113,3238,56,1,0,3295
SUPERVISOR LOW PAXTON,Jay  PURDY,Lower Paxton Twp--3rd precinct,151,2,0,0,153,3238,56,1,0,3295
SUPERVISOR LOW PAXTON,Jay  PURDY,Lower Paxton Twp--4th Precinct,125,1,0,0,126,3238,56,1,0,3295
SUPERVISOR LOW PAXTON,Jay  PURDY,Lower Paxton Twp--5th Precinct,129,1,0,0,130,3238,56,1,0,3295
SUPERVISOR LOW PAXTON,Jay  PURDY,Lower Paxton Twp--6th Precinct,99,1,0,0,100,3238,56,1,0,3295
SUPERVISOR LOW PAXTON,Jay  PURDY,Lower Paxton Twp--7th Precinct,134,2,0,0,136,3238,56,1,0,3295
SUPERVISOR LOW PAXTON,Jay  PURDY,Lower Paxton Twp--8th Precinct,98,2,0,0,100,3238,56,1,0,3295
SUPERVISOR LOW PAXTON,Jay  PURDY,Lower Paxton Twp--9th Precinct,80,3,0,0,83,3238,56,1,0,3295
SUPERVISOR LOW PAXTON,Jay  PURDY,Lower Paxton Twp--10th Precinct,102,4,0,0,106,3238,56,1,0,3295
SUPERVISOR LOW PAXTON,Jay  PURDY,Lower Paxton Twp--11th Precinct,89,2,0,0,91,3238,56,1,0,3295
SUPERVISOR LOW PAXTON,Jay  PURDY,Lower Paxton Twp--12th Precinct,122,0,0,0,122,3238,56,1,0,3295
SUPERVISOR LOW PAXTON,Jay  PURDY,Lower Paxton Twp--13th Precinct,120,2,0,0,122,3238,56,1,0,3295
SUPERVISOR LOW PAXTON,Jay  PURDY,Lower Paxton Twp--14th Precinct,84,1,1,0,86,3238,56,1,0,3295
SUPERVISOR LOW PAXTON,Jay  PURDY,Lower Paxton Twp--15th Precinct,116,1,0,0,117,3238,56,1,0,3295
SUPERVISOR LOW PAXTON,Jay  PURDY,Lower Paxton Twp--16th Precinct,205,1,0,0,206,3238,56,1,0,3295
SUPERVISOR LOW PAXTON,Jay  PURDY,Lower Paxton Twp--17th Precinct,114,2,0,0,116,3238,56,1,0,3295
SUPERVISOR LOW PAXTON,Jay  PURDY,Lower Paxton Twp--18th Precinct,115,0,0,0,115,3238,56,1,0,3295
SUPERVISOR LOW PAXTON,Jay  PURDY,Lower Paxton Twp--19th Precinct,183,1,0,0,184,3238,56,1,0,3295
SUPERVISOR LOW PAXTON,Jay  PURDY,Lower Paxton Twp--20th Precinct,107,1,0,0,108,3238,56,1,0,3295
SUPERVISOR LOW PAXTON,Jay  PURDY,Lower Paxton Twp--21st Precinct,180,10,0,0,190,3238,56,1,0,3295
SUPERVISOR LOW PAXTON,Jay  PURDY,Lower Paxton Twp--22nd Precinct,115,3,0,0,118,3238,56,1,0,3295
SUPERVISOR LOW PAXTON,Jay  PURDY,Lower Paxton Twp--23rd Precinct,89,0,0,0,89,3238,56,1,0,3295
SUPERVISOR LOW PAXTON,Jay  PURDY,Lower Paxton Twp--24th Precinct,129,2,0,0,131,3238,56,1,0,3295
SUPERVISOR LOW PAXTON,Jay  PURDY,Lower Paxton Twp--25th Precinct,97,1,0,0,98,3238,56,1,0,3295
SUPERVISOR LOW PAXTON,Jay  PURDY,Lower Paxton Twp--26th Precinct,132,4,0,0,136,3238,56,1,0,3295
SUPERVISOR LOW PAXTON,Jay  PURDY,Lower Paxton Twp--27th Precinct,127,2,0,0,129,3238,56,1,0,3295
SUPERVISOR LOW PAXTON,Write In  ,Lower Paxton Twp--1st Precinct,0,0,0,0,0,58,0,0,0,58
SUPERVISOR LOW PAXTON,Write In  ,Lower Paxton Twp--2nd Precinct,0,0,0,0,0,58,0,0,0,58
SUPERVISOR LOW PAXTON,Write In  ,Lower Paxton Twp--3rd precinct,7,0,0,0,7,58,0,0,0,58
SUPERVISOR LOW PAXTON,Write In  ,Lower Paxton Twp--4th Precinct,4,0,0,0,4,58,0,0,0,58
SUPERVISOR LOW PAXTON,Write In  ,Lower Paxton Twp--5th Precinct,6,0,0,0,6,58,0,0,0,58
SUPERVISOR LOW PAXTON,Write In  ,Lower Paxton Twp--6th Precinct,2,0,0,0,2,58,0,0,0,58
SUPERVISOR LOW PAXTON,Write In  ,Lower Paxton Twp--7th Precinct,0,0,0,0,0,58,0,0,0,58
SUPERVISOR LOW PAXTON,Write In  ,Lower Paxton Twp--8th Precinct,4,0,0,0,4,58,0,0,0,58
SUPERVISOR LOW PAXTON,Write In  ,Lower Paxton Twp--9th Precinct,3,0,0,0,3,58,0,0,0,58
SUPERVISOR LOW PAXTON,Write In  ,Lower Paxton Twp--10th Precinct,1,0,0,0,1,58,0,0,0,58
SUPERVISOR LOW PAXTON,Write In  ,Lower Paxton Twp--11th Precinct,0,0,0,0,0,58,0,0,0,58
SUPERVISOR LOW PAXTON,Write In  ,Lower Paxton Twp--12th Precinct,2,0,0,0,2,58,0,0,0,58
SUPERVISOR LOW PAXTON,Write In  ,Lower Paxton Twp--13th Precinct,6,0,0,0,6,58,0,0,0,58
SUPERVISOR LOW PAXTON,Write In  ,Lower Paxton Twp--14th Precinct,0,0,0,0,0,58,0,0,0,58
SUPERVISOR LOW PAXTON,Write In  ,Lower Paxton Twp--15th Precinct,4,0,0,0,4,58,0,0,0,58
SUPERVISOR LOW PAXTON,Write In  ,Lower Paxton Twp--16th Precinct,3,0,0,0,3,58,0,0,0,58
SUPERVISOR LOW PAXTON,Write In  ,Lower Paxton Twp--17th Precinct,0,0,0,0,0,58,0,0,0,58
SUPERVISOR LOW PAXTON,Write In  ,Lower Paxton Twp--18th Precinct,0,0,0,0,0,58,0,0,0,58
SUPERVISOR LOW PAXTON,Write In  ,Lower Paxton Twp--19th Precinct,0,0,0,0,0,58,0,0,0,58
SUPERVISOR LOW PAXTON,Write In  ,Lower Paxton Twp--20th Precinct,8,0,0,0,8,58,0,0,0,58
SUPERVISOR LOW PAXTON,Write In  ,Lower Paxton Twp--21st Precinct,3,0,0,0,3,58,0,0,0,58
SUPERVISOR LOW PAXTON,Write In  ,Lower Paxton Twp--22nd Precinct,1,0,0,0,1,58,0,0,0,58
SUPERVISOR LOW PAXTON,Write In  ,Lower Paxton Twp--23rd Precinct,0,0,0,0,0,58,0,0,0,58
SUPERVISOR LOW PAXTON,Write In  ,Lower Paxton Twp--24th Precinct,4,0,0,0,4,58,0,0,0,58
SUPERVISOR LOW PAXTON,Write In  ,Lower Paxton Twp--25th Precinct,0,0,0,0,0,58,0,0,0,58
SUPERVISOR LOW PAXTON,Write In  ,Lower Paxton Twp--26th Precinct,0,0,0,0,0,58,0,0,0,58
SUPERVISOR LOW PAXTON,Write In  ,Lower Paxton Twp--27th Precinct,0,0,0,0,0,58,0,0,0,58
SUPERVISOR LYKENS,Albert N. MORGAN,Lykens Township,100,0,0,0,100,100,0,0,0,100
SUPERVISOR LYKENS,Write In  ,Lykens Township,0,0,0,0,0,0,0,0,0,0
SUPERVISOR MID PAX,J. Thomas  Van WAGNER,Middle Paxton Twp--1st Precinct,279,1,0,0,280,842,5,0,0,847
SUPERVISOR MID PAX,J. Thomas  Van WAGNER,Middle Paxton Twp--2nd Precinct,241,2,0,0,243,842,5,0,0,847
SUPERVISOR MID PAX,J. Thomas  Van WAGNER,Middle Paxton Twp--3rd Precinct,322,2,0,0,324,842,5,0,0,847
SUPERVISOR MID PAX,Mary Jane  DAVIS,Middle Paxton Twp--1st Precinct,298,1,0,0,299,889,4,0,0,893
SUPERVISOR MID PAX,Mary Jane  DAVIS,Middle Paxton Twp--2nd Precinct,245,1,0,0,246,889,4,0,0,893
SUPERVISOR MID PAX,Mary Jane  DAVIS,Middle Paxton Twp--3rd Precinct,346,2,0,0,348,889,4,0,0,893
SUPERVISOR MID PAX,Write In  ,Middle Paxton Twp--1st Precinct,4,0,0,0,4,6,0,0,0,6
SUPERVISOR MID PAX,Write In  ,Middle Paxton Twp--2nd Precinct,0,0,0,0,0,6,0,0,0,6
SUPERVISOR MID PAX,Write In  ,Middle Paxton Twp--3rd Precinct,2,0,0,0,2,6,0,0,0,6
SUPERVISOR MIFFLIN,Ronald  KOLVA,Mifflin Township,89,0,0,0,89,89,0,0,0,89
SUPERVISOR MIFFLIN,Write In  ,Mifflin Township,0,0,0,0,0,0,0,0,0,0
SUPERVISOR SOU HANOVER,Dan  COLLINS,South Hanover Twp--1st Precinct,316,5,0,0,321,991,15,0,0,1006
SUPERVISOR SOU HANOVER,Dan  COLLINS,South Hanover Twp--2nd Precinct,429,8,0,0,437,991,15,0,0,1006
SUPERVISOR SOU HANOVER,Dan  COLLINS,South Hanover Twp--3rd Precinct,246,2,0,0,248,991,15,0,0,1006
SUPERVISOR SOU HANOVER,Write In  ,South Hanover Twp--1st Precinct,8,0,0,0,8,10,0,0,0,10
SUPERVISOR SOU HANOVER,Write In  ,South Hanover Twp--2nd Precinct,0,0,0,0,0,10,0,0,0,10
SUPERVISOR SOU HANOVER,Write In  ,South Hanover Twp--3rd Precinct,2,0,0,0,2,10,0,0,0,10
SUPERVISOR UPP PAX,Ronald E. HEPNER,Upper Paxton Twp--1st Precinct,308,2,0,0,310,519,4,0,0,523
SUPERVISOR UPP PAX,Ronald E. HEPNER,Upper Paxton Twp--2nd Precinct,211,2,0,0,213,519,4,0,0,523
SUPERVISOR UPP PAX,Write In  ,Upper Paxton Twp--1st Precinct,0,0,0,0,0,0,0,0,0,0
SUPERVISOR UPP PAX,Write In  ,Upper Paxton Twp--2nd Precinct,0,0,0,0,0,0,0,0,0,0
SUPERVISOR WASHINGTON,Dewey E. WILBERT,Washington Township,252,4,0,0,256,252,4,0,0,256
SUPERVISOR WASHINGTON,Write In  ,Washington Township,0,0,0,0,0,0,0,0,0,0
SUPERVISOR WAYNE,Gary E. MILLER,Wayne Township,236,0,0,0,236,236,0,0,0,236
SUPERVISOR WAYNE,Write In  ,Wayne Township,1,0,0,0,1,1,0,0,0,1
SUPERVISOR WICONISCO,John H.G. COLES,Wiconisco Twp--1st Precinct,95,1,0,0,96,172,2,0,0,174
SUPERVISOR WICONISCO,John H.G. COLES,Wiconisco Twp--2nd Precinct,77,1,0,0,78,172,2,0,0,174
SUPERVISOR WICONISCO,Write In  ,Wiconisco Twp--1st Precinct,0,0,0,0,0,0,0,0,0,0
SUPERVISOR WICONISCO,Write In  ,Wiconisco Twp--2nd Precinct,0,0,0,0,0,0,0,0,0,0
SUPERVSIOR 6YR REED,Write In  ,Reed Township,10,0,0,0,10,10,0,0,0,10
TAX COLL 2 YR LOW PAX,Diane K. BAIR,Lower Paxton Twp--1st Precinct,225,3,0,0,228,7463,158,5,0,7626
TAX COLL 2 YR LOW PAX,Diane K. BAIR,Lower Paxton Twp--2nd Precinct,246,11,0,0,257,7463,158,5,0,7626
TAX COLL 2 YR LOW PAX,Diane K. BAIR,Lower Paxton Twp--3rd precinct,422,10,0,0,432,7463,158,5,0,7626
TAX COLL 2 YR LOW PAX,Diane K. BAIR,Lower Paxton Twp--4th Precinct,326,3,0,0,329,7463,158,5,0,7626
TAX COLL 2 YR LOW PAX,Diane K. BAIR,Lower Paxton Twp--5th Precinct,268,4,1,0,273,7463,158,5,0,7626
TAX COLL 2 YR LOW PAX,Diane K. BAIR,Lower Paxton Twp--6th Precinct,214,4,0,0,218,7463,158,5,0,7626
TAX COLL 2 YR LOW PAX,Diane K. BAIR,Lower Paxton Twp--7th Precinct,367,7,0,0,374,7463,158,5,0,7626
TAX COLL 2 YR LOW PAX,Diane K. BAIR,Lower Paxton Twp--8th Precinct,183,2,0,0,185,7463,158,5,0,7626
TAX COLL 2 YR LOW PAX,Diane K. BAIR,Lower Paxton Twp--9th Precinct,219,7,0,0,226,7463,158,5,0,7626
TAX COLL 2 YR LOW PAX,Diane K. BAIR,Lower Paxton Twp--10th Precinct,168,6,0,0,174,7463,158,5,0,7626
TAX COLL 2 YR LOW PAX,Diane K. BAIR,Lower Paxton Twp--11th Precinct,222,4,1,0,227,7463,158,5,0,7626
TAX COLL 2 YR LOW PAX,Diane K. BAIR,Lower Paxton Twp--12th Precinct,313,8,0,0,321,7463,158,5,0,7626
TAX COLL 2 YR LOW PAX,Diane K. BAIR,Lower Paxton Twp--13th Precinct,304,6,0,0,310,7463,158,5,0,7626
TAX COLL 2 YR LOW PAX,Diane K. BAIR,Lower Paxton Twp--14th Precinct,177,3,3,0,183,7463,158,5,0,7626
TAX COLL 2 YR LOW PAX,Diane K. BAIR,Lower Paxton Twp--15th Precinct,282,4,0,0,286,7463,158,5,0,7626
TAX COLL 2 YR LOW PAX,Diane K. BAIR,Lower Paxton Twp--16th Precinct,454,9,0,0,463,7463,158,5,0,7626
TAX COLL 2 YR LOW PAX,Diane K. BAIR,Lower Paxton Twp--17th Precinct,236,7,0,0,243,7463,158,5,0,7626
TAX COLL 2 YR LOW PAX,Diane K. BAIR,Lower Paxton Twp--18th Precinct,222,2,0,0,224,7463,158,5,0,7626
TAX COLL 2 YR LOW PAX,Diane K. BAIR,Lower Paxton Twp--19th Precinct,382,14,0,0,396,7463,158,5,0,7626
TAX COLL 2 YR LOW PAX,Diane K. BAIR,Lower Paxton Twp--20th Precinct,294,5,0,0,299,7463,158,5,0,7626
TAX COLL 2 YR LOW PAX,Diane K. BAIR,Lower Paxton Twp--21st Precinct,367,9,0,0,376,7463,158,5,0,7626
TAX COLL 2 YR LOW PAX,Diane K. BAIR,Lower Paxton Twp--22nd Precinct,290,5,0,0,295,7463,158,5,0,7626
TAX COLL 2 YR LOW PAX,Diane K. BAIR,Lower Paxton Twp--23rd Precinct,267,4,0,0,271,7463,158,5,0,7626
TAX COLL 2 YR LOW PAX,Diane K. BAIR,Lower Paxton Twp--24th Precinct,291,8,0,0,299,7463,158,5,0,7626
TAX COLL 2 YR LOW PAX,Diane K. BAIR,Lower Paxton Twp--25th Precinct,181,4,0,0,185,7463,158,5,0,7626
TAX COLL 2 YR LOW PAX,Diane K. BAIR,Lower Paxton Twp--26th Precinct,288,7,0,0,295,7463,158,5,0,7626
TAX COLL 2 YR LOW PAX,Diane K. BAIR,Lower Paxton Twp--27th Precinct,255,2,0,0,257,7463,158,5,0,7626
TAX COLL 2 YR LOW PAX,Write In  ,Lower Paxton Twp--1st Precinct,0,0,0,0,0,56,0,0,0,56
TAX COLL 2 YR LOW PAX,Write In  ,Lower Paxton Twp--2nd Precinct,1,0,0,0,1,56,0,0,0,56
TAX COLL 2 YR LOW PAX,Write In  ,Lower Paxton Twp--3rd precinct,6,0,0,0,6,56,0,0,0,56
TAX COLL 2 YR LOW PAX,Write In  ,Lower Paxton Twp--4th Precinct,0,0,0,0,0,56,0,0,0,56
TAX COLL 2 YR LOW PAX,Write In  ,Lower Paxton Twp--5th Precinct,8,0,0,0,8,56,0,0,0,56
TAX COLL 2 YR LOW PAX,Write In  ,Lower Paxton Twp--6th Precinct,2,0,0,0,2,56,0,0,0,56
TAX COLL 2 YR LOW PAX,Write In  ,Lower Paxton Twp--7th Precinct,3,0,0,0,3,56,0,0,0,56
TAX COLL 2 YR LOW PAX,Write In  ,Lower Paxton Twp--8th Precinct,0,0,0,0,0,56,0,0,0,56
TAX COLL 2 YR LOW PAX,Write In  ,Lower Paxton Twp--9th Precinct,3,0,0,0,3,56,0,0,0,56
TAX COLL 2 YR LOW PAX,Write In  ,Lower Paxton Twp--10th Precinct,1,0,0,0,1,56,0,0,0,56
TAX COLL 2 YR LOW PAX,Write In  ,Lower Paxton Twp--11th Precinct,1,0,0,0,1,56,0,0,0,56
TAX COLL 2 YR LOW PAX,Write In  ,Lower Paxton Twp--12th Precinct,1,0,0,0,1,56,0,0,0,56
TAX COLL 2 YR LOW PAX,Write In  ,Lower Paxton Twp--13th Precinct,2,0,0,0,2,56,0,0,0,56
TAX COLL 2 YR LOW PAX,Write In  ,Lower Paxton Twp--14th Precinct,1,0,0,0,1,56,0,0,0,56
TAX COLL 2 YR LOW PAX,Write In  ,Lower Paxton Twp--15th Precinct,2,0,0,0,2,56,0,0,0,56
TAX COLL 2 YR LOW PAX,Write In  ,Lower Paxton Twp--16th Precinct,2,0,0,0,2,56,0,0,0,56
TAX COLL 2 YR LOW PAX,Write In  ,Lower Paxton Twp--17th Precinct,2,0,0,0,2,56,0,0,0,56
TAX COLL 2 YR LOW PAX,Write In  ,Lower Paxton Twp--18th Precinct,0,0,0,0,0,56,0,0,0,56
TAX COLL 2 YR LOW PAX,Write In  ,Lower Paxton Twp--19th Precinct,0,0,0,0,0,56,0,0,0,56
TAX COLL 2 YR LOW PAX,Write In  ,Lower Paxton Twp--20th Precinct,2,0,0,0,2,56,0,0,0,56
TAX COLL 2 YR LOW PAX,Write In  ,Lower Paxton Twp--21st Precinct,1,0,0,0,1,56,0,0,0,56
TAX COLL 2 YR LOW PAX,Write In  ,Lower Paxton Twp--22nd Precinct,4,0,0,0,4,56,0,0,0,56
TAX COLL 2 YR LOW PAX,Write In  ,Lower Paxton Twp--23rd Precinct,5,0,0,0,5,56,0,0,0,56
TAX COLL 2 YR LOW PAX,Write In  ,Lower Paxton Twp--24th Precinct,1,0,0,0,1,56,0,0,0,56
TAX COLL 2 YR LOW PAX,Write In  ,Lower Paxton Twp--25th Precinct,2,0,0,0,2,56,0,0,0,56
TAX COLL 2 YR LOW PAX,Write In  ,Lower Paxton Twp--26th Precinct,2,0,0,0,2,56,0,0,0,56
TAX COLL 2 YR LOW PAX,Write In  ,Lower Paxton Twp--27th Precinct,4,0,0,0,4,56,0,0,0,56
TAX COLL 2YR CONEWAGO,Write In  ,Conewago Twp--1st Precinct,21,0,0,0,21,29,0,0,0,29
TAX COLL 2YR CONEWAGO,Write In  ,Conewago Twp--2nd Precinct,8,0,0,0,8,29,0,0,0,29
TAX COLL 2YR EAST HAN,Loria  SMITH,East Hanover Township--1st Precinct,340,9,0,0,349,730,14,0,0,744
TAX COLL 2YR EAST HAN,Loria  SMITH,East Hanover Township--2nd Precinct,390,5,0,0,395,730,14,0,0,744
TAX COLL 2YR EAST HAN,Write In  ,East Hanover Township--1st Precinct,0,0,0,0,0,0,0,0,0,0
TAX COLL 2YR EAST HAN,Write In  ,East Hanover Township--2nd Precinct,0,0,0,0,0,0,0,0,0,0
TAX COLL 2YR MIDDLE PAX,Tanya  POMEROY,Middle Paxton Twp--1st Precinct,329,1,0,0,330,942,5,0,0,947
TAX COLL 2YR MIDDLE PAX,Tanya  POMEROY,Middle Paxton Twp--2nd Precinct,255,2,0,0,257,942,5,0,0,947
TAX COLL 2YR MIDDLE PAX,Tanya  POMEROY,Middle Paxton Twp--3rd Precinct,358,2,0,0,360,942,5,0,0,947
TAX COLL 2YR MIDDLE PAX,Write In  ,Middle Paxton Twp--1st Precinct,1,0,0,0,1,1,0,0,0,1
TAX COLL 2YR MIDDLE PAX,Write In  ,Middle Paxton Twp--2nd Precinct,0,0,0,0,0,1,0,0,0,1
TAX COLL 2YR MIDDLE PAX,Write In  ,Middle Paxton Twp--3rd Precinct,0,0,0,0,0,1,0,0,0,1
TAX COLL 2YR PILLOW,William  MILLER,Pillow Borough,53,0,0,0,53,53,0,0,0,53
TAX COLL 2YR PILLOW,Write In  ,Pillow Borough,0,0,0,0,0,0,0,0,0,0
TWP COMM  LOWER SWAT,Frank  LINN,Lower Swatara Twp--1st Precinct,329,4,0,0,333,1063,32,0,0,1095
TWP COMM  LOWER SWAT,Frank  LINN,Lower Swatara Twp--2nd Precinct,273,4,0,0,277,1063,32,0,0,1095
TWP COMM  LOWER SWAT,Frank  LINN,Lower Swatara Twp--3rd Precinct,238,23,0,0,261,1063,32,0,0,1095
TWP COMM  LOWER SWAT,Frank  LINN,Lower Swatara Twp--4th Precinct,223,1,0,0,224,1063,32,0,0,1095
TWP COMM  LOWER SWAT,Robert  LOYCH,Lower Swatara Twp--1st Precinct,320,3,0,0,323,1013,24,0,0,1037
TWP COMM  LOWER SWAT,Robert  LOYCH,Lower Swatara Twp--2nd Precinct,265,2,0,0,267,1013,24,0,0,1037
TWP COMM  LOWER SWAT,Robert  LOYCH,Lower Swatara Twp--3rd Precinct,218,19,0,0,237,1013,24,0,0,1037
TWP COMM  LOWER SWAT,Robert  LOYCH,Lower Swatara Twp--4th Precinct,210,0,0,0,210,1013,24,0,0,1037
TWP COMM  LOWER SWAT,Thomas R. CLARK,Lower Swatara Twp--1st Precinct,299,2,0,0,301,984,25,0,0,1009
TWP COMM  LOWER SWAT,Thomas R. CLARK,Lower Swatara Twp--2nd Precinct,252,2,0,0,254,984,25,0,0,1009
TWP COMM  LOWER SWAT,Thomas R. CLARK,Lower Swatara Twp--3rd Precinct,221,21,0,0,242,984,25,0,0,1009
TWP COMM  LOWER SWAT,Thomas R. CLARK,Lower Swatara Twp--4th Precinct,212,0,0,0,212,984,25,0,0,1009
TWP COMM  LOWER SWAT,Write In  ,Lower Swatara Twp--1st Precinct,3,0,0,0,3,4,0,0,0,4
TWP COMM  LOWER SWAT,Write In  ,Lower Swatara Twp--2nd Precinct,0,0,0,0,0,4,0,0,0,4
TWP COMM  LOWER SWAT,Write In  ,Lower Swatara Twp--3rd Precinct,1,0,0,0,1,4,0,0,0,4
TWP COMM  LOWER SWAT,Write In  ,Lower Swatara Twp--4th Precinct,0,0,0,0,0,4,0,0,0,4
TWP COMM SUSQ 1,Donald E. HOUSER,Susquehanna Twp--1st Ward,343,11,0,0,354,343,11,0,0,354
TWP COMM SUSQ 1,Joe  REBARCHAK,Susquehanna Twp--1st Ward,285,8,0,0,293,285,8,0,0,293
TWP COMM SUSQ 1,Write In  ,Susquehanna Twp--1st Ward,1,0,0,0,1,1,0,0,0,1
TWP COMM SUSQ 3,David L. PUGH,Susquehanna Twp--3rd Ward,306,4,0,0,310,306,4,0,0,310
TWP COMM SUSQ 3,Write In  ,Susquehanna Twp--3rd Ward,5,0,0,0,5,5,0,0,0,5
TWP COMM SUSQ 5,Gregory M. PETERS,Susquehanna Twp--5th Ward,118,4,0,0,122,118,4,0,0,122
TWP COMM SUSQ 5,Jacquelyn  PATTON,Susquehanna Twp--5th Ward,309,5,0,0,314,309,5,0,0,314
TWP COMM SUSQ 5,Write In  ,Susquehanna Twp--5th Ward,1,0,0,0,1,1,0,0,0,1
TWP COMM SUSQ 7,Donald  STEINMEIER,Susquehanna Twp--7th Ward,102,0,0,0,102,102,0,0,0,102
TWP COMM SUSQ 7,Fred  ENGLE,Susquehanna Twp--7th Ward,166,0,0,0,166,166,0,0,0,166
TWP COMM SUSQ 7,Write In  ,Susquehanna Twp--7th Ward,0,0,0,0,0,0,0,0,0,0
TWP COMM SUSQ 9,Anthony G. STEELE,Susquehanna Twp--9th Ward,244,5,0,0,249,244,5,0,0,249
TWP COMM SUSQ 9,Travis  WATERS,Susquehanna Twp--9th Ward,275,0,0,0,275,275,0,0,0,275
TWP COMM SUSQ 9,Write In  ,Susquehanna Twp--9th Ward,0,0,0,0,0,0,0,0,0,0
TWP COMM SWATARA 1,Charles Jim  LANG,Swatara Township--1st Ward,174,3,0,0,177,174,3,0,0,177
TWP COMM SWATARA 1,Cyndie  ZALEK,Swatara Township--1st Ward,279,1,0,0,280,279,1,0,0,280
TWP COMM SWATARA 1,Write In  ,Swatara Township--1st Ward,0,0,0,0,0,0,0,0,0,0
TWP COMM SWATARA 3,Robert A. SPANDLER,Swatara Township--3rd Ward,171,3,0,0,174,171,3,0,0,174
TWP COMM SWATARA 3,"Ronald E. FOLK,II",Swatara Township--3rd Ward,117,3,0,0,120,117,3,0,0,120
TWP COMM SWATARA 3,Write In  ,Swatara Township--3rd Ward,0,0,0,0,0,0,0,0,0,0
TWP COMM SWATARA 5,"John M. DESANTO, JR.",Swatara Township--5th Ward,240,1,0,0,241,240,1,0,0,241
TWP COMM SWATARA 5,Tim  BERARD,Swatara Township--5th Ward,328,4,0,0,332,328,4,0,0,332
TWP COMM SWATARA 5,Write In  ,Swatara Township--5th Ward,0,0,0,0,0,0,0,0,0,0
TWP COMM SWATARA 7,Tony  SPAGNOLO,Swatara Township--7th Ward,505,12,0,0,517,505,12,0,0,517
TWP COMM SWATARA 7,Write In  ,Swatara Township--7th Ward,5,0,0,0,5,5,0,0,0,5
TWP COMM SWATARA 9,Charles W. BOWSER,Swatara Township--9th Ward,98,1,0,0,99,98,1,0,0,99
TWP COMM SWATARA 9,Richard H. BOUDER,Swatara Township--9th Ward,173,9,0,0,182,173,9,0,0,182
TWP COMM SWATARA 9,Write In  ,Swatara Township--9th Ward,1,0,0,0,1,1,0,0,0,1

